dteday,yr,mnth,hr,weekday,season,weathersit,cnt,registered,casual
2011-01-01,2011,January,0,Saturday,Spring,Clear,16,13,3
2011-01-01,2011,January,1,Saturday,Spring,Clear,40,32,8
2011-01-01,2011,January,2,Saturday,Spring,Clear,32,27,5
2011-01-01,2011,January,3,Saturday,Spring,Clear,13,10,3
2011-01-01,2011,January,4,Saturday,Spring,Clear,1,1,0
2011-01-01,2011,January,5,Saturday,Spring,Cloudy,1,1,0
2011-01-01,2011,January,6,Saturday,Spring,Clear,2,0,2
2011-01-01,2011,January,7,Saturday,Spring,Clear,3,2,1
2011-01-01,2011,January,8,Saturday,Spring,Clear,8,7,1
2011-01-01,2011,January,9,Saturday,Spring,Clear,14,6,8
2011-01-01,2011,January,10,Saturday,Spring,Clear,36,24,12
2011-01-01,2011,January,11,Saturday,Spring,Clear,56,30,26
2011-01-01,2011,January,12,Saturday,Spring,Clear,84,55,29
2011-01-01,2011,January,13,Saturday,Spring,Cloudy,94,47,47
2011-01-01,2011,January,14,Saturday,Spring,Cloudy,106,71,35
2011-01-01,2011,January,15,Saturday,Spring,Cloudy,110,70,40
2011-01-01,2011,January,16,Saturday,Spring,Cloudy,93,52,41
2011-01-01,2011,January,17,Saturday,Spring,Cloudy,67,52,15
2011-01-01,2011,January,18,Saturday,Spring,Light Snow/Rain,35,26,9
2011-01-01,2011,January,19,Saturday,Spring,Light Snow/Rain,37,31,6
2011-01-01,2011,January,20,Saturday,Spring,Cloudy,36,25,11
2011-01-01,2011,January,21,Saturday,Spring,Cloudy,34,31,3
2011-01-01,2011,January,22,Saturday,Spring,Cloudy,28,17,11
2011-01-01,2011,January,23,Saturday,Spring,Cloudy,39,24,15
2011-01-02,2011,January,0,Sunday,Spring,Cloudy,17,13,4
2011-01-02,2011,January,1,Sunday,Spring,Cloudy,17,16,1
2011-01-02,2011,January,2,Sunday,Spring,Cloudy,9,8,1
2011-01-02,2011,January,3,Sunday,Spring,Cloudy,6,4,2
2011-01-02,2011,January,4,Sunday,Spring,Cloudy,3,1,2
2011-01-02,2011,January,6,Sunday,Spring,Light Snow/Rain,2,2,0
2011-01-02,2011,January,7,Sunday,Spring,Cloudy,1,1,0
2011-01-02,2011,January,8,Sunday,Spring,Light Snow/Rain,8,8,0
2011-01-02,2011,January,9,Sunday,Spring,Cloudy,20,19,1
2011-01-02,2011,January,10,Sunday,Spring,Cloudy,53,46,7
2011-01-02,2011,January,11,Sunday,Spring,Cloudy,70,54,16
2011-01-02,2011,January,12,Sunday,Spring,Cloudy,93,73,20
2011-01-02,2011,January,13,Sunday,Spring,Cloudy,75,64,11
2011-01-02,2011,January,14,Sunday,Spring,Light Snow/Rain,59,55,4
2011-01-02,2011,January,15,Sunday,Spring,Light Snow/Rain,74,55,19
2011-01-02,2011,January,16,Sunday,Spring,Light Snow/Rain,76,67,9
2011-01-02,2011,January,17,Sunday,Spring,Clear,65,58,7
2011-01-02,2011,January,18,Sunday,Spring,Cloudy,53,43,10
2011-01-02,2011,January,19,Sunday,Spring,Clear,30,29,1
2011-01-02,2011,January,20,Sunday,Spring,Clear,22,17,5
2011-01-02,2011,January,21,Sunday,Spring,Clear,31,20,11
2011-01-02,2011,January,22,Sunday,Spring,Clear,9,9,0
2011-01-02,2011,January,23,Sunday,Spring,Clear,8,8,0
2011-01-03,2011,January,0,Monday,Spring,Clear,5,5,0
2011-01-03,2011,January,1,Monday,Spring,Clear,2,2,0
2011-01-03,2011,January,4,Monday,Spring,Clear,1,1,0
2011-01-03,2011,January,5,Monday,Spring,Clear,3,3,0
2011-01-03,2011,January,6,Monday,Spring,Clear,30,30,0
2011-01-03,2011,January,7,Monday,Spring,Clear,64,63,1
2011-01-03,2011,January,8,Monday,Spring,Clear,154,153,1
2011-01-03,2011,January,9,Monday,Spring,Clear,88,81,7
2011-01-03,2011,January,10,Monday,Spring,Clear,44,33,11
2011-01-03,2011,January,11,Monday,Spring,Clear,51,41,10
2011-01-03,2011,January,12,Monday,Spring,Clear,61,48,13
2011-01-03,2011,January,13,Monday,Spring,Clear,61,53,8
2011-01-03,2011,January,14,Monday,Spring,Clear,77,66,11
2011-01-03,2011,January,15,Monday,Spring,Clear,72,58,14
2011-01-03,2011,January,16,Monday,Spring,Clear,76,67,9
2011-01-03,2011,January,17,Monday,Spring,Clear,157,146,11
2011-01-03,2011,January,18,Monday,Spring,Clear,157,148,9
2011-01-03,2011,January,19,Monday,Spring,Clear,110,102,8
2011-01-03,2011,January,20,Monday,Spring,Clear,52,49,3
2011-01-03,2011,January,21,Monday,Spring,Clear,52,49,3
2011-01-03,2011,January,22,Monday,Spring,Clear,20,20,0
2011-01-03,2011,January,23,Monday,Spring,Clear,12,11,1
2011-01-04,2011,January,0,Tuesday,Spring,Clear,5,5,0
2011-01-04,2011,January,1,Tuesday,Spring,Clear,2,2,0
2011-01-04,2011,January,2,Tuesday,Spring,Clear,1,1,0
2011-01-04,2011,January,4,Tuesday,Spring,Clear,2,2,0
2011-01-04,2011,January,5,Tuesday,Spring,Clear,4,4,0
2011-01-04,2011,January,6,Tuesday,Spring,Clear,36,36,0
2011-01-04,2011,January,7,Tuesday,Spring,Clear,94,92,2
2011-01-04,2011,January,8,Tuesday,Spring,Clear,179,177,2
2011-01-04,2011,January,9,Tuesday,Spring,Clear,100,98,2
2011-01-04,2011,January,10,Tuesday,Spring,Cloudy,42,37,5
2011-01-04,2011,January,11,Tuesday,Spring,Clear,57,50,7
2011-01-04,2011,January,12,Tuesday,Spring,Clear,78,66,12
2011-01-04,2011,January,13,Tuesday,Spring,Clear,97,79,18
2011-01-04,2011,January,14,Tuesday,Spring,Clear,63,54,9
2011-01-04,2011,January,15,Tuesday,Spring,Clear,65,48,17
2011-01-04,2011,January,16,Tuesday,Spring,Clear,83,68,15
2011-01-04,2011,January,17,Tuesday,Spring,Clear,212,202,10
2011-01-04,2011,January,18,Tuesday,Spring,Clear,182,179,3
2011-01-04,2011,January,19,Tuesday,Spring,Clear,112,110,2
2011-01-04,2011,January,20,Tuesday,Spring,Clear,54,53,1
2011-01-04,2011,January,21,Tuesday,Spring,Clear,48,48,0
2011-01-04,2011,January,22,Tuesday,Spring,Clear,35,34,1
2011-01-04,2011,January,23,Tuesday,Spring,Clear,11,9,2
2011-01-05,2011,January,0,Wednesday,Spring,Clear,6,6,0
2011-01-05,2011,January,1,Wednesday,Spring,Clear,6,6,0
2011-01-05,2011,January,2,Wednesday,Spring,Clear,2,2,0
2011-01-05,2011,January,4,Wednesday,Spring,Clear,2,2,0
2011-01-05,2011,January,5,Wednesday,Spring,Clear,3,3,0
2011-01-05,2011,January,6,Wednesday,Spring,Clear,33,33,0
2011-01-05,2011,January,7,Wednesday,Spring,Clear,88,87,1
2011-01-05,2011,January,8,Wednesday,Spring,Clear,195,192,3
2011-01-05,2011,January,9,Wednesday,Spring,Clear,115,109,6
2011-01-05,2011,January,10,Wednesday,Spring,Clear,57,53,4
2011-01-05,2011,January,11,Wednesday,Spring,Clear,46,34,12
2011-01-05,2011,January,12,Wednesday,Spring,Clear,79,74,5
2011-01-05,2011,January,13,Wednesday,Spring,Clear,71,65,6
2011-01-05,2011,January,14,Wednesday,Spring,Clear,62,52,10
2011-01-05,2011,January,15,Wednesday,Spring,Clear,62,55,7
2011-01-05,2011,January,16,Wednesday,Spring,Clear,89,85,4
2011-01-05,2011,January,17,Wednesday,Spring,Clear,190,186,4
2011-01-05,2011,January,18,Wednesday,Spring,Clear,169,166,3
2011-01-05,2011,January,19,Wednesday,Spring,Clear,132,127,5
2011-01-05,2011,January,20,Wednesday,Spring,Clear,89,82,7
2011-01-05,2011,January,21,Wednesday,Spring,Clear,43,40,3
2011-01-05,2011,January,22,Wednesday,Spring,Clear,42,41,1
2011-01-05,2011,January,23,Wednesday,Spring,Clear,19,18,1
2011-01-06,2011,January,0,Thursday,Spring,Clear,11,11,0
2011-01-06,2011,January,1,Thursday,Spring,Clear,4,4,0
2011-01-06,2011,January,2,Thursday,Spring,Clear,2,2,0
2011-01-06,2011,January,4,Thursday,Spring,Cloudy,1,1,0
2011-01-06,2011,January,5,Thursday,Spring,Cloudy,4,4,0
2011-01-06,2011,January,6,Thursday,Spring,Cloudy,36,36,0
2011-01-06,2011,January,7,Thursday,Spring,Cloudy,95,95,0
2011-01-06,2011,January,8,Thursday,Spring,Clear,219,216,3
2011-01-06,2011,January,9,Thursday,Spring,Cloudy,122,116,6
2011-01-06,2011,January,10,Thursday,Spring,Clear,45,42,3
2011-01-06,2011,January,11,Thursday,Spring,Clear,59,57,2
2011-01-06,2011,January,12,Thursday,Spring,Clear,84,78,6
2011-01-06,2011,January,13,Thursday,Spring,Clear,67,55,12
2011-01-06,2011,January,14,Thursday,Spring,Clear,70,59,11
2011-01-06,2011,January,15,Thursday,Spring,Clear,62,54,8
2011-01-06,2011,January,16,Thursday,Spring,Clear,86,74,12
2011-01-06,2011,January,17,Thursday,Spring,Clear,172,163,9
2011-01-06,2011,January,18,Thursday,Spring,Clear,163,158,5
2011-01-06,2011,January,19,Thursday,Spring,Clear,112,109,3
2011-01-06,2011,January,20,Thursday,Spring,Clear,69,66,3
2011-01-06,2011,January,21,Thursday,Spring,Cloudy,48,48,0
2011-01-06,2011,January,22,Thursday,Spring,Cloudy,52,51,1
2011-01-06,2011,January,23,Thursday,Spring,Cloudy,23,19,4
2011-01-07,2011,January,0,Friday,Spring,Cloudy,17,13,4
2011-01-07,2011,January,1,Friday,Spring,Cloudy,7,5,2
2011-01-07,2011,January,2,Friday,Spring,Cloudy,1,1,0
2011-01-07,2011,January,4,Friday,Spring,Cloudy,1,1,0
2011-01-07,2011,January,5,Friday,Spring,Light Snow/Rain,5,5,0
2011-01-07,2011,January,6,Friday,Spring,Cloudy,34,26,8
2011-01-07,2011,January,7,Friday,Spring,Clear,84,76,8
2011-01-07,2011,January,8,Friday,Spring,Clear,210,190,20
2011-01-07,2011,January,9,Friday,Spring,Clear,134,125,9
2011-01-07,2011,January,10,Friday,Spring,Clear,63,47,16
2011-01-07,2011,January,11,Friday,Spring,Cloudy,67,48,19
2011-01-07,2011,January,12,Friday,Spring,Cloudy,59,50,9
2011-01-07,2011,January,13,Friday,Spring,Cloudy,73,64,9
2011-01-07,2011,January,14,Friday,Spring,Cloudy,50,43,7
2011-01-07,2011,January,15,Friday,Spring,Cloudy,72,63,9
2011-01-07,2011,January,16,Friday,Spring,Cloudy,87,82,5
2011-01-07,2011,January,17,Friday,Spring,Cloudy,187,178,9
2011-01-07,2011,January,18,Friday,Spring,Clear,123,116,7
2011-01-07,2011,January,19,Friday,Spring,Clear,95,92,3
2011-01-07,2011,January,20,Friday,Spring,Clear,51,50,1
2011-01-07,2011,January,21,Friday,Spring,Clear,39,39,0
2011-01-07,2011,January,22,Friday,Spring,Cloudy,36,34,2
2011-01-07,2011,January,23,Friday,Spring,Cloudy,15,14,1
2011-01-08,2011,January,0,Saturday,Spring,Cloudy,25,24,1
2011-01-08,2011,January,1,Saturday,Spring,Cloudy,16,15,1
2011-01-08,2011,January,2,Saturday,Spring,Cloudy,16,13,3
2011-01-08,2011,January,3,Saturday,Spring,Light Snow/Rain,7,7,0
2011-01-08,2011,January,4,Saturday,Spring,Light Snow/Rain,1,1,0
2011-01-08,2011,January,5,Saturday,Spring,Cloudy,5,5,0
2011-01-08,2011,January,6,Saturday,Spring,Cloudy,2,2,0
2011-01-08,2011,January,7,Saturday,Spring,Cloudy,9,8,1
2011-01-08,2011,January,8,Saturday,Spring,Light Snow/Rain,15,15,0
2011-01-08,2011,January,9,Saturday,Spring,Light Snow/Rain,20,20,0
2011-01-08,2011,January,10,Saturday,Spring,Cloudy,61,56,5
2011-01-08,2011,January,11,Saturday,Spring,Cloudy,62,60,2
2011-01-08,2011,January,12,Saturday,Spring,Cloudy,98,90,8
2011-01-08,2011,January,13,Saturday,Spring,Clear,102,95,7
2011-01-08,2011,January,14,Saturday,Spring,Clear,95,83,12
2011-01-08,2011,January,15,Saturday,Spring,Clear,74,69,5
2011-01-08,2011,January,16,Saturday,Spring,Clear,76,68,8
2011-01-08,2011,January,17,Saturday,Spring,Clear,69,64,5
2011-01-08,2011,January,18,Saturday,Spring,Clear,55,52,3
2011-01-08,2011,January,19,Saturday,Spring,Clear,30,26,4
2011-01-08,2011,January,20,Saturday,Spring,Clear,28,28,0
2011-01-08,2011,January,21,Saturday,Spring,Clear,37,35,2
2011-01-08,2011,January,22,Saturday,Spring,Clear,34,33,1
2011-01-08,2011,January,23,Saturday,Spring,Clear,22,22,0
2011-01-09,2011,January,0,Sunday,Spring,Clear,25,24,1
2011-01-09,2011,January,1,Sunday,Spring,Clear,12,12,0
2011-01-09,2011,January,2,Sunday,Spring,Clear,11,11,0
2011-01-09,2011,January,3,Sunday,Spring,Clear,4,4,0
2011-01-09,2011,January,4,Sunday,Spring,Clear,1,1,0
2011-01-09,2011,January,5,Sunday,Spring,Clear,1,1,0
2011-01-09,2011,January,6,Sunday,Spring,Clear,1,1,0
2011-01-09,2011,January,7,Sunday,Spring,Clear,6,5,1
2011-01-09,2011,January,8,Sunday,Spring,Clear,10,10,0
2011-01-09,2011,January,9,Sunday,Spring,Clear,19,19,0
2011-01-09,2011,January,10,Sunday,Spring,Clear,49,49,0
2011-01-09,2011,January,11,Sunday,Spring,Clear,49,47,2
2011-01-09,2011,January,12,Sunday,Spring,Clear,83,79,4
2011-01-09,2011,January,13,Sunday,Spring,Clear,75,69,6
2011-01-09,2011,January,14,Sunday,Spring,Clear,72,64,8
2011-01-09,2011,January,15,Sunday,Spring,Clear,82,77,5
2011-01-09,2011,January,16,Sunday,Spring,Clear,92,79,13
2011-01-09,2011,January,17,Sunday,Spring,Clear,62,59,3
2011-01-09,2011,January,18,Sunday,Spring,Clear,48,44,4
2011-01-09,2011,January,19,Sunday,Spring,Clear,41,40,1
2011-01-09,2011,January,20,Sunday,Spring,Clear,38,38,0
2011-01-09,2011,January,21,Sunday,Spring,Clear,20,19,1
2011-01-09,2011,January,22,Sunday,Spring,Clear,15,10,5
2011-01-09,2011,January,23,Sunday,Spring,Clear,6,6,0
2011-01-10,2011,January,0,Monday,Spring,Clear,5,3,2
2011-01-10,2011,January,1,Monday,Spring,Clear,1,0,1
2011-01-10,2011,January,2,Monday,Spring,Clear,3,3,0
2011-01-10,2011,January,3,Monday,Spring,Clear,1,1,0
2011-01-10,2011,January,4,Monday,Spring,Clear,3,2,1
2011-01-10,2011,January,5,Monday,Spring,Clear,3,3,0
2011-01-10,2011,January,6,Monday,Spring,Clear,31,31,0
2011-01-10,2011,January,7,Monday,Spring,Clear,77,75,2
2011-01-10,2011,January,8,Monday,Spring,Cloudy,188,184,4
2011-01-10,2011,January,9,Monday,Spring,Cloudy,94,92,2
2011-01-10,2011,January,10,Monday,Spring,Cloudy,31,31,0
2011-01-10,2011,January,11,Monday,Spring,Cloudy,30,28,2
2011-01-10,2011,January,12,Monday,Spring,Cloudy,52,47,5
2011-01-10,2011,January,13,Monday,Spring,Cloudy,54,50,4
2011-01-10,2011,January,14,Monday,Spring,Cloudy,47,47,0
2011-01-10,2011,January,15,Monday,Spring,Cloudy,45,43,2
2011-01-10,2011,January,16,Monday,Spring,Clear,74,70,4
2011-01-10,2011,January,17,Monday,Spring,Clear,178,174,4
2011-01-10,2011,January,18,Monday,Spring,Clear,155,154,1
2011-01-10,2011,January,19,Monday,Spring,Clear,95,92,3
2011-01-10,2011,January,20,Monday,Spring,Clear,74,73,1
2011-01-10,2011,January,21,Monday,Spring,Clear,38,37,1
2011-01-10,2011,January,22,Monday,Spring,Clear,24,22,2
2011-01-10,2011,January,23,Monday,Spring,Clear,18,18,0
2011-01-11,2011,January,0,Tuesday,Spring,Clear,12,10,2
2011-01-11,2011,January,1,Tuesday,Spring,Clear,3,3,0
2011-01-11,2011,January,2,Tuesday,Spring,Cloudy,3,3,0
2011-01-11,2011,January,5,Tuesday,Spring,Cloudy,6,6,0
2011-01-11,2011,January,6,Tuesday,Spring,Cloudy,27,27,0
2011-01-11,2011,January,7,Tuesday,Spring,Cloudy,99,97,2
2011-01-11,2011,January,8,Tuesday,Spring,Cloudy,217,214,3
2011-01-11,2011,January,9,Tuesday,Spring,Cloudy,130,127,3
2011-01-11,2011,January,10,Tuesday,Spring,Cloudy,54,51,3
2011-01-11,2011,January,11,Tuesday,Spring,Cloudy,35,31,4
2011-01-11,2011,January,12,Tuesday,Spring,Cloudy,57,55,2
2011-01-11,2011,January,13,Tuesday,Spring,Cloudy,52,46,6
2011-01-11,2011,January,14,Tuesday,Spring,Cloudy,63,60,3
2011-01-11,2011,January,15,Tuesday,Spring,Cloudy,47,45,2
2011-01-11,2011,January,16,Tuesday,Spring,Cloudy,76,72,4
2011-01-11,2011,January,17,Tuesday,Spring,Cloudy,136,130,6
2011-01-11,2011,January,18,Tuesday,Spring,Light Snow/Rain,95,94,1
2011-01-11,2011,January,19,Tuesday,Spring,Light Snow/Rain,51,51,0
2011-01-11,2011,January,20,Tuesday,Spring,Light Snow/Rain,32,32,0
2011-01-11,2011,January,21,Tuesday,Spring,Light Snow/Rain,20,20,0
2011-01-11,2011,January,22,Tuesday,Spring,Light Snow/Rain,29,28,1
2011-01-11,2011,January,23,Tuesday,Spring,Light Snow/Rain,19,18,1
2011-01-12,2011,January,0,Wednesday,Spring,Cloudy,7,7,0
2011-01-12,2011,January,1,Wednesday,Spring,Cloudy,6,6,0
2011-01-12,2011,January,2,Wednesday,Spring,Clear,1,1,0
2011-01-12,2011,January,5,Wednesday,Spring,Clear,5,5,0
2011-01-12,2011,January,6,Wednesday,Spring,Clear,16,16,0
2011-01-12,2011,January,7,Wednesday,Spring,Clear,54,54,0
2011-01-12,2011,January,8,Wednesday,Spring,Clear,128,125,3
2011-01-12,2011,January,9,Wednesday,Spring,Clear,81,78,3
2011-01-12,2011,January,10,Wednesday,Spring,Clear,39,39,0
2011-01-12,2011,January,11,Wednesday,Spring,Clear,35,32,3
2011-01-12,2011,January,12,Wednesday,Spring,Clear,55,52,3
2011-01-12,2011,January,13,Wednesday,Spring,Clear,49,49,0
2011-01-12,2011,January,14,Wednesday,Spring,Clear,44,44,0
2011-01-12,2011,January,15,Wednesday,Spring,Clear,49,48,1
2011-01-12,2011,January,16,Wednesday,Spring,Clear,68,63,5
2011-01-12,2011,January,17,Wednesday,Spring,Clear,139,139,0
2011-01-12,2011,January,18,Wednesday,Spring,Clear,137,135,2
2011-01-12,2011,January,19,Wednesday,Spring,Clear,83,82,1
2011-01-12,2011,January,20,Wednesday,Spring,Clear,56,54,2
2011-01-12,2011,January,21,Wednesday,Spring,Clear,57,57,0
2011-01-12,2011,January,22,Wednesday,Spring,Clear,33,32,1
2011-01-12,2011,January,23,Wednesday,Spring,Clear,20,19,1
2011-01-13,2011,January,0,Thursday,Spring,Clear,7,6,1
2011-01-13,2011,January,1,Thursday,Spring,Clear,2,2,0
2011-01-13,2011,January,2,Thursday,Spring,Clear,2,2,0
2011-01-13,2011,January,3,Thursday,Spring,Clear,3,3,0
2011-01-13,2011,January,4,Thursday,Spring,Clear,4,4,0
2011-01-13,2011,January,5,Thursday,Spring,Clear,3,3,0
2011-01-13,2011,January,6,Thursday,Spring,Clear,28,28,0
2011-01-13,2011,January,7,Thursday,Spring,Clear,72,72,0
2011-01-13,2011,January,8,Thursday,Spring,Clear,202,197,5
2011-01-13,2011,January,9,Thursday,Spring,Clear,139,137,2
2011-01-13,2011,January,10,Thursday,Spring,Cloudy,38,36,2
2011-01-13,2011,January,11,Thursday,Spring,Cloudy,37,33,4
2011-01-13,2011,January,12,Thursday,Spring,Clear,52,49,3
2011-01-13,2011,January,13,Thursday,Spring,Clear,83,81,2
2011-01-13,2011,January,14,Thursday,Spring,Clear,42,39,3
2011-01-13,2011,January,15,Thursday,Spring,Clear,60,55,5
2011-01-13,2011,January,16,Thursday,Spring,Clear,78,76,2
2011-01-13,2011,January,17,Thursday,Spring,Clear,162,158,4
2011-01-13,2011,January,18,Thursday,Spring,Clear,144,141,3
2011-01-13,2011,January,19,Thursday,Spring,Clear,99,98,1
2011-01-13,2011,January,20,Thursday,Spring,Clear,64,64,0
2011-01-13,2011,January,21,Thursday,Spring,Clear,40,40,0
2011-01-13,2011,January,22,Thursday,Spring,Clear,30,30,0
2011-01-13,2011,January,23,Thursday,Spring,Clear,15,14,1
2011-01-14,2011,January,0,Friday,Spring,Clear,14,14,0
2011-01-14,2011,January,1,Friday,Spring,Clear,5,5,0
2011-01-14,2011,January,2,Friday,Spring,Clear,1,1,0
2011-01-14,2011,January,3,Friday,Spring,Clear,1,1,0
2011-01-14,2011,January,5,Friday,Spring,Clear,8,8,0
2011-01-14,2011,January,6,Friday,Spring,Clear,17,17,0
2011-01-14,2011,January,7,Friday,Spring,Clear,70,70,0
2011-01-14,2011,January,8,Friday,Spring,Clear,158,156,2
2011-01-14,2011,January,9,Friday,Spring,Clear,117,117,0
2011-01-14,2011,January,10,Friday,Spring,Clear,44,40,4
2011-01-14,2011,January,11,Friday,Spring,Clear,53,47,6
2011-01-14,2011,January,12,Friday,Spring,Clear,61,59,2
2011-01-14,2011,January,13,Friday,Spring,Clear,77,73,4
2011-01-14,2011,January,14,Friday,Spring,Clear,64,59,5
2011-01-14,2011,January,15,Friday,Spring,Clear,68,59,9
2011-01-14,2011,January,16,Friday,Spring,Clear,90,87,3
2011-01-14,2011,January,17,Friday,Spring,Clear,159,155,4
2011-01-14,2011,January,18,Friday,Spring,Clear,139,134,5
2011-01-14,2011,January,19,Friday,Spring,Clear,92,89,3
2011-01-14,2011,January,20,Friday,Spring,Clear,68,68,0
2011-01-14,2011,January,21,Friday,Spring,Clear,52,48,4
2011-01-14,2011,January,22,Friday,Spring,Cloudy,36,34,2
2011-01-14,2011,January,23,Friday,Spring,Cloudy,27,26,1
2011-01-15,2011,January,0,Saturday,Spring,Clear,28,25,3
2011-01-15,2011,January,1,Saturday,Spring,Cloudy,20,18,2
2011-01-15,2011,January,2,Saturday,Spring,Cloudy,12,12,0
2011-01-15,2011,January,3,Saturday,Spring,Cloudy,8,7,1
2011-01-15,2011,January,4,Saturday,Spring,Cloudy,5,5,0
2011-01-15,2011,January,5,Saturday,Spring,Clear,1,1,0
2011-01-15,2011,January,6,Saturday,Spring,Clear,3,2,1
2011-01-15,2011,January,7,Saturday,Spring,Clear,10,9,1
2011-01-15,2011,January,8,Saturday,Spring,Clear,23,22,1
2011-01-15,2011,January,9,Saturday,Spring,Clear,33,31,2
2011-01-15,2011,January,10,Saturday,Spring,Clear,59,57,2
2011-01-15,2011,January,11,Saturday,Spring,Clear,72,54,18
2011-01-15,2011,January,12,Saturday,Spring,Clear,89,74,15
2011-01-15,2011,January,13,Saturday,Spring,Clear,101,80,21
2011-01-15,2011,January,14,Saturday,Spring,Clear,118,92,26
2011-01-15,2011,January,15,Saturday,Spring,Cloudy,129,108,21
2011-01-15,2011,January,16,Saturday,Spring,Cloudy,128,95,33
2011-01-15,2011,January,17,Saturday,Spring,Cloudy,83,54,29
2011-01-15,2011,January,18,Saturday,Spring,Cloudy,84,69,15
2011-01-15,2011,January,19,Saturday,Spring,Cloudy,74,60,14
2011-01-15,2011,January,20,Saturday,Spring,Cloudy,41,35,6
2011-01-15,2011,January,21,Saturday,Spring,Cloudy,57,51,6
2011-01-15,2011,January,22,Saturday,Spring,Cloudy,26,26,0
2011-01-15,2011,January,23,Saturday,Spring,Clear,44,39,5
2011-01-16,2011,January,0,Sunday,Spring,Clear,39,33,6
2011-01-16,2011,January,1,Sunday,Spring,Clear,23,19,4
2011-01-16,2011,January,2,Sunday,Spring,Clear,16,13,3
2011-01-16,2011,January,3,Sunday,Spring,Clear,15,6,9
2011-01-16,2011,January,4,Sunday,Spring,Clear,1,1,0
2011-01-16,2011,January,5,Sunday,Spring,Cloudy,2,1,1
2011-01-16,2011,January,6,Sunday,Spring,Cloudy,1,1,0
2011-01-16,2011,January,7,Sunday,Spring,Cloudy,3,3,0
2011-01-16,2011,January,8,Sunday,Spring,Clear,18,18,0
2011-01-16,2011,January,9,Sunday,Spring,Clear,32,29,3
2011-01-16,2011,January,10,Sunday,Spring,Clear,79,71,8
2011-01-16,2011,January,11,Sunday,Spring,Clear,93,70,23
2011-01-16,2011,January,12,Sunday,Spring,Clear,104,75,29
2011-01-16,2011,January,13,Sunday,Spring,Clear,118,95,23
2011-01-16,2011,January,14,Sunday,Spring,Clear,91,69,22
2011-01-16,2011,January,15,Sunday,Spring,Clear,113,78,35
2011-01-16,2011,January,16,Sunday,Spring,Clear,99,77,22
2011-01-16,2011,January,17,Sunday,Spring,Clear,105,82,23
2011-01-16,2011,January,18,Sunday,Spring,Clear,67,56,11
2011-01-16,2011,January,19,Sunday,Spring,Clear,61,47,14
2011-01-16,2011,January,20,Sunday,Spring,Clear,57,50,7
2011-01-16,2011,January,21,Sunday,Spring,Clear,28,22,6
2011-01-16,2011,January,22,Sunday,Spring,Cloudy,21,19,2
2011-01-16,2011,January,23,Sunday,Spring,Cloudy,18,18,0
2011-01-17,2011,January,0,Monday,Spring,Cloudy,17,16,1
2011-01-17,2011,January,1,Monday,Spring,Cloudy,16,15,1
2011-01-17,2011,January,2,Monday,Spring,Cloudy,8,8,0
2011-01-17,2011,January,3,Monday,Spring,Cloudy,2,2,0
2011-01-17,2011,January,4,Monday,Spring,Cloudy,3,2,1
2011-01-17,2011,January,5,Monday,Spring,Cloudy,1,1,0
2011-01-17,2011,January,6,Monday,Spring,Cloudy,5,5,0
2011-01-17,2011,January,7,Monday,Spring,Cloudy,13,9,4
2011-01-17,2011,January,8,Monday,Spring,Cloudy,33,30,3
2011-01-17,2011,January,9,Monday,Spring,Cloudy,47,39,8
2011-01-17,2011,January,10,Monday,Spring,Cloudy,57,50,7
2011-01-17,2011,January,11,Monday,Spring,Cloudy,64,55,9
2011-01-17,2011,January,12,Monday,Spring,Cloudy,80,70,10
2011-01-17,2011,January,13,Monday,Spring,Cloudy,93,80,13
2011-01-17,2011,January,14,Monday,Spring,Cloudy,86,74,12
2011-01-17,2011,January,15,Monday,Spring,Cloudy,93,72,21
2011-01-17,2011,January,16,Monday,Spring,Cloudy,82,76,6
2011-01-17,2011,January,17,Monday,Spring,Clear,71,67,4
2011-01-17,2011,January,18,Monday,Spring,Cloudy,92,85,7
2011-01-17,2011,January,19,Monday,Spring,Light Snow/Rain,60,58,2
2011-01-17,2011,January,20,Monday,Spring,Light Snow/Rain,33,29,4
2011-01-17,2011,January,21,Monday,Spring,Light Snow/Rain,27,24,3
2011-01-17,2011,January,22,Monday,Spring,Light Snow/Rain,13,13,0
2011-01-17,2011,January,23,Monday,Spring,Light Snow/Rain,4,3,1
2011-01-18,2011,January,12,Tuesday,Spring,Cloudy,3,3,0
2011-01-18,2011,January,13,Tuesday,Spring,Cloudy,22,22,0
2011-01-18,2011,January,14,Tuesday,Spring,Cloudy,28,26,2
2011-01-18,2011,January,15,Tuesday,Spring,Cloudy,35,32,3
2011-01-18,2011,January,16,Tuesday,Spring,Cloudy,61,61,0
2011-01-18,2011,January,17,Tuesday,Spring,Cloudy,125,124,1
2011-01-18,2011,January,18,Tuesday,Spring,Cloudy,133,132,1
2011-01-18,2011,January,19,Tuesday,Spring,Cloudy,99,98,1
2011-01-18,2011,January,20,Tuesday,Spring,Cloudy,83,83,0
2011-01-18,2011,January,21,Tuesday,Spring,Cloudy,41,41,0
2011-01-18,2011,January,22,Tuesday,Spring,Cloudy,33,33,0
2011-01-18,2011,January,23,Tuesday,Spring,Cloudy,20,19,1
2011-01-19,2011,January,0,Wednesday,Spring,Cloudy,3,3,0
2011-01-19,2011,January,1,Wednesday,Spring,Light Snow/Rain,7,6,1
2011-01-19,2011,January,2,Wednesday,Spring,Light Snow/Rain,3,3,0
2011-01-19,2011,January,4,Wednesday,Spring,Light Snow/Rain,2,1,1
2011-01-19,2011,January,5,Wednesday,Spring,Cloudy,7,7,0
2011-01-19,2011,January,6,Wednesday,Spring,Cloudy,32,32,0
2011-01-19,2011,January,7,Wednesday,Spring,Cloudy,90,89,1
2011-01-19,2011,January,8,Wednesday,Spring,Cloudy,197,196,1
2011-01-19,2011,January,9,Wednesday,Spring,Cloudy,109,107,2
2011-01-19,2011,January,10,Wednesday,Spring,Cloudy,47,46,1
2011-01-19,2011,January,11,Wednesday,Spring,Cloudy,52,47,5
2011-01-19,2011,January,12,Wednesday,Spring,Cloudy,70,65,5
2011-01-19,2011,January,13,Wednesday,Spring,Clear,78,67,11
2011-01-19,2011,January,14,Wednesday,Spring,Clear,75,68,7
2011-01-19,2011,January,15,Wednesday,Spring,Clear,82,78,4
2011-01-19,2011,January,16,Wednesday,Spring,Clear,104,94,10
2011-01-19,2011,January,17,Wednesday,Spring,Clear,197,190,7
2011-01-19,2011,January,18,Wednesday,Spring,Clear,161,156,5
2011-01-19,2011,January,19,Wednesday,Spring,Clear,112,108,4
2011-01-19,2011,January,20,Wednesday,Spring,Clear,76,74,2
2011-01-19,2011,January,21,Wednesday,Spring,Clear,59,55,4
2011-01-19,2011,January,22,Wednesday,Spring,Clear,59,53,6
2011-01-19,2011,January,23,Wednesday,Spring,Clear,28,27,1
2011-01-20,2011,January,0,Thursday,Spring,Clear,13,8,5
2011-01-20,2011,January,1,Thursday,Spring,Clear,5,3,2
2011-01-20,2011,January,2,Thursday,Spring,Clear,2,2,0
2011-01-20,2011,January,3,Thursday,Spring,Clear,1,1,0
2011-01-20,2011,January,4,Thursday,Spring,Clear,1,1,0
2011-01-20,2011,January,5,Thursday,Spring,Clear,6,6,0
2011-01-20,2011,January,6,Thursday,Spring,Clear,35,35,0
2011-01-20,2011,January,7,Thursday,Spring,Clear,101,100,1
2011-01-20,2011,January,8,Thursday,Spring,Clear,249,247,2
2011-01-20,2011,January,9,Thursday,Spring,Cloudy,143,140,3
2011-01-20,2011,January,10,Thursday,Spring,Clear,57,56,1
2011-01-20,2011,January,11,Thursday,Spring,Cloudy,68,63,5
2011-01-20,2011,January,12,Thursday,Spring,Cloudy,84,77,7
2011-01-20,2011,January,13,Thursday,Spring,Cloudy,98,86,12
2011-01-20,2011,January,14,Thursday,Spring,Cloudy,81,75,6
2011-01-20,2011,January,15,Thursday,Spring,Cloudy,70,62,8
2011-01-20,2011,January,16,Thursday,Spring,Cloudy,91,83,8
2011-01-20,2011,January,17,Thursday,Spring,Cloudy,215,207,8
2011-01-20,2011,January,18,Thursday,Spring,Cloudy,185,184,1
2011-01-20,2011,January,19,Thursday,Spring,Clear,152,146,6
2011-01-20,2011,January,20,Thursday,Spring,Cloudy,126,124,2
2011-01-20,2011,January,21,Thursday,Spring,Cloudy,57,54,3
2011-01-20,2011,January,22,Thursday,Spring,Cloudy,56,56,0
2011-01-20,2011,January,23,Thursday,Spring,Cloudy,31,28,3
2011-01-21,2011,January,0,Friday,Spring,Cloudy,21,20,1
2011-01-21,2011,January,1,Friday,Spring,Cloudy,6,6,0
2011-01-21,2011,January,2,Friday,Spring,Light Snow/Rain,2,2,0
2011-01-21,2011,January,3,Friday,Spring,Light Snow/Rain,1,1,0
2011-01-21,2011,January,4,Friday,Spring,Cloudy,1,1,0
2011-01-21,2011,January,5,Friday,Spring,Clear,5,4,1
2011-01-21,2011,January,6,Friday,Spring,Clear,27,27,0
2011-01-21,2011,January,7,Friday,Spring,Clear,68,66,2
2011-01-21,2011,January,8,Friday,Spring,Clear,217,210,7
2011-01-21,2011,January,9,Friday,Spring,Clear,166,159,7
2011-01-21,2011,January,10,Friday,Spring,Clear,63,57,6
2011-01-21,2011,January,11,Friday,Spring,Clear,59,53,6
2011-01-21,2011,January,12,Friday,Spring,Clear,78,67,11
2011-01-21,2011,January,13,Friday,Spring,Clear,73,65,8
2011-01-21,2011,January,14,Friday,Spring,Clear,62,56,6
2011-01-21,2011,January,15,Friday,Spring,Clear,65,61,4
2011-01-21,2011,January,16,Friday,Spring,Clear,97,97,0
2011-01-21,2011,January,17,Friday,Spring,Clear,161,151,10
2011-01-21,2011,January,18,Friday,Spring,Clear,120,119,1
2011-01-21,2011,January,19,Friday,Spring,Clear,96,93,3
2011-01-21,2011,January,20,Friday,Spring,Clear,53,52,1
2011-01-21,2011,January,21,Friday,Spring,Clear,41,41,0
2011-01-21,2011,January,22,Friday,Spring,Clear,34,33,1
2011-01-21,2011,January,23,Friday,Spring,Clear,27,27,0
2011-01-22,2011,January,0,Saturday,Spring,Clear,13,13,0
2011-01-22,2011,January,1,Saturday,Spring,Cloudy,12,9,3
2011-01-22,2011,January,2,Saturday,Spring,Cloudy,11,11,0
2011-01-22,2011,January,3,Saturday,Spring,Cloudy,7,6,1
2011-01-22,2011,January,4,Saturday,Spring,Cloudy,3,3,0
2011-01-22,2011,January,6,Saturday,Spring,Cloudy,2,2,0
2011-01-22,2011,January,7,Saturday,Spring,Clear,8,8,0
2011-01-22,2011,January,8,Saturday,Spring,Clear,27,26,1
2011-01-22,2011,January,9,Saturday,Spring,Clear,40,37,3
2011-01-22,2011,January,10,Saturday,Spring,Cloudy,53,50,3
2011-01-22,2011,January,11,Saturday,Spring,Cloudy,63,59,4
2011-01-22,2011,January,12,Saturday,Spring,Cloudy,70,60,10
2011-01-22,2011,January,13,Saturday,Spring,Clear,84,72,12
2011-01-22,2011,January,14,Saturday,Spring,Clear,75,64,11
2011-01-22,2011,January,15,Saturday,Spring,Clear,103,93,10
2011-01-22,2011,January,16,Saturday,Spring,Clear,83,72,11
2011-01-22,2011,January,17,Saturday,Spring,Clear,67,59,8
2011-01-22,2011,January,18,Saturday,Spring,Clear,54,54,0
2011-01-22,2011,January,19,Saturday,Spring,Clear,59,53,6
2011-01-22,2011,January,20,Saturday,Spring,Clear,45,44,1
2011-01-22,2011,January,21,Saturday,Spring,Clear,39,39,0
2011-01-22,2011,January,22,Saturday,Spring,Clear,30,23,7
2011-01-22,2011,January,23,Saturday,Spring,Clear,33,31,2
2011-01-23,2011,January,0,Sunday,Spring,Clear,22,20,2
2011-01-23,2011,January,1,Sunday,Spring,Clear,13,12,1
2011-01-23,2011,January,2,Sunday,Spring,Clear,18,15,3
2011-01-23,2011,January,3,Sunday,Spring,Clear,5,4,1
2011-01-23,2011,January,5,Sunday,Spring,Cloudy,3,3,0
2011-01-23,2011,January,6,Sunday,Spring,Cloudy,1,1,0
2011-01-23,2011,January,7,Sunday,Spring,Clear,2,1,1
2011-01-23,2011,January,8,Sunday,Spring,Clear,19,17,2
2011-01-23,2011,January,9,Sunday,Spring,Clear,28,25,3
2011-01-23,2011,January,10,Sunday,Spring,Clear,58,51,7
2011-01-23,2011,January,11,Sunday,Spring,Clear,99,77,22
2011-01-23,2011,January,12,Sunday,Spring,Clear,116,92,24
2011-01-23,2011,January,13,Sunday,Spring,Clear,87,75,12
2011-01-23,2011,January,14,Sunday,Spring,Clear,110,93,17
2011-01-23,2011,January,15,Sunday,Spring,Clear,77,64,13
2011-01-23,2011,January,16,Sunday,Spring,Clear,65,56,9
2011-01-23,2011,January,17,Sunday,Spring,Clear,55,50,5
2011-01-23,2011,January,18,Sunday,Spring,Clear,49,44,5
2011-01-23,2011,January,19,Sunday,Spring,Clear,50,45,5
2011-01-23,2011,January,20,Sunday,Spring,Clear,35,31,4
2011-01-23,2011,January,21,Sunday,Spring,Clear,25,20,5
2011-01-23,2011,January,22,Sunday,Spring,Clear,28,23,5
2011-01-23,2011,January,23,Sunday,Spring,Clear,21,17,4
2011-01-24,2011,January,0,Monday,Spring,Clear,7,7,0
2011-01-24,2011,January,1,Monday,Spring,Clear,1,1,0
2011-01-24,2011,January,3,Monday,Spring,Clear,1,1,0
2011-01-24,2011,January,4,Monday,Spring,Clear,1,1,0
2011-01-24,2011,January,5,Monday,Spring,Clear,5,5,0
2011-01-24,2011,January,6,Monday,Spring,Clear,15,15,0
2011-01-24,2011,January,7,Monday,Spring,Clear,84,79,5
2011-01-24,2011,January,8,Monday,Spring,Clear,177,171,6
2011-01-24,2011,January,9,Monday,Spring,Clear,102,98,4
2011-01-24,2011,January,10,Monday,Spring,Clear,40,34,6
2011-01-24,2011,January,11,Monday,Spring,Clear,46,43,3
2011-01-24,2011,January,12,Monday,Spring,Cloudy,63,52,11
2011-01-24,2011,January,13,Monday,Spring,Cloudy,60,54,6
2011-01-24,2011,January,14,Monday,Spring,Cloudy,45,43,2
2011-01-24,2011,January,15,Monday,Spring,Clear,57,50,7
2011-01-24,2011,January,16,Monday,Spring,Clear,70,66,4
2011-01-24,2011,January,17,Monday,Spring,Clear,184,178,6
2011-01-24,2011,January,18,Monday,Spring,Clear,153,145,8
2011-01-24,2011,January,19,Monday,Spring,Clear,106,101,5
2011-01-24,2011,January,20,Monday,Spring,Clear,81,80,1
2011-01-24,2011,January,21,Monday,Spring,Clear,59,53,6
2011-01-24,2011,January,22,Monday,Spring,Cloudy,35,32,3
2011-01-24,2011,January,23,Monday,Spring,Cloudy,24,21,3
2011-01-25,2011,January,0,Tuesday,Spring,Cloudy,9,6,3
2011-01-25,2011,January,1,Tuesday,Spring,Cloudy,5,5,0
2011-01-25,2011,January,2,Tuesday,Spring,Clear,2,2,0
2011-01-25,2011,January,4,Tuesday,Spring,Clear,1,1,0
2011-01-25,2011,January,5,Tuesday,Spring,Clear,9,9,0
2011-01-25,2011,January,6,Tuesday,Spring,Clear,36,35,1
2011-01-25,2011,January,7,Tuesday,Spring,Clear,108,103,5
2011-01-25,2011,January,8,Tuesday,Spring,Cloudy,238,233,5
2011-01-25,2011,January,9,Tuesday,Spring,Cloudy,144,134,10
2011-01-25,2011,January,10,Tuesday,Spring,Cloudy,55,49,6
2011-01-25,2011,January,11,Tuesday,Spring,Cloudy,61,55,6
2011-01-25,2011,January,12,Tuesday,Spring,Cloudy,106,85,21
2011-01-25,2011,January,13,Tuesday,Spring,Cloudy,93,72,21
2011-01-25,2011,January,14,Tuesday,Spring,Cloudy,68,57,11
2011-01-25,2011,January,15,Tuesday,Spring,Cloudy,84,63,21
2011-01-25,2011,January,16,Tuesday,Spring,Cloudy,116,102,14
2011-01-25,2011,January,17,Tuesday,Spring,Clear,222,208,14
2011-01-25,2011,January,18,Tuesday,Spring,Cloudy,225,218,7
2011-01-25,2011,January,19,Tuesday,Spring,Cloudy,146,133,13
2011-01-25,2011,January,20,Tuesday,Spring,Clear,119,103,16
2011-01-25,2011,January,21,Tuesday,Spring,Clear,45,40,5
2011-01-25,2011,January,22,Tuesday,Spring,Clear,53,49,4
2011-01-25,2011,January,23,Tuesday,Spring,Cloudy,40,37,3
2011-01-26,2011,January,0,Wednesday,Spring,Cloudy,17,14,3
2011-01-26,2011,January,1,Wednesday,Spring,Cloudy,5,5,0
2011-01-26,2011,January,2,Wednesday,Spring,Light Snow/Rain,10,7,3
2011-01-26,2011,January,5,Wednesday,Spring,Light Snow/Rain,1,1,0
2011-01-26,2011,January,6,Wednesday,Spring,Light Snow/Rain,8,8,0
2011-01-26,2011,January,7,Wednesday,Spring,Light Snow/Rain,30,29,1
2011-01-26,2011,January,8,Wednesday,Spring,Light Snow/Rain,72,69,3
2011-01-26,2011,January,9,Wednesday,Spring,Light Snow/Rain,58,55,3
2011-01-26,2011,January,10,Wednesday,Spring,Light Snow/Rain,28,26,2
2011-01-26,2011,January,11,Wednesday,Spring,Light Snow/Rain,41,35,6
2011-01-26,2011,January,12,Wednesday,Spring,Light Snow/Rain,48,41,7
2011-01-26,2011,January,13,Wednesday,Spring,Light Snow/Rain,47,43,4
2011-01-26,2011,January,14,Wednesday,Spring,Light Snow/Rain,36,36,0
2011-01-26,2011,January,15,Wednesday,Spring,Light Snow/Rain,43,42,1
2011-01-26,2011,January,16,Wednesday,Spring,Heavy Rain/Ice Pallets,36,35,1
2011-01-26,2011,January,17,Wednesday,Spring,Light Snow/Rain,26,26,0
2011-01-27,2011,January,16,Thursday,Spring,Clear,24,23,1
2011-01-27,2011,January,17,Thursday,Spring,Clear,84,82,2
2011-01-27,2011,January,18,Thursday,Spring,Clear,104,101,3
2011-01-27,2011,January,19,Thursday,Spring,Clear,79,76,3
2011-01-27,2011,January,20,Thursday,Spring,Clear,59,55,4
2011-01-27,2011,January,21,Thursday,Spring,Clear,38,36,2
2011-01-27,2011,January,22,Thursday,Spring,Clear,27,27,0
2011-01-27,2011,January,23,Thursday,Spring,Clear,16,16,0
2011-01-28,2011,January,0,Friday,Spring,Cloudy,9,9,0
2011-01-28,2011,January,1,Friday,Spring,Cloudy,3,2,1
2011-01-28,2011,January,2,Friday,Spring,Cloudy,2,2,0
2011-01-28,2011,January,3,Friday,Spring,Cloudy,1,0,1
2011-01-28,2011,January,5,Friday,Spring,Cloudy,4,4,0
2011-01-28,2011,January,6,Friday,Spring,Cloudy,16,16,0
2011-01-28,2011,January,7,Friday,Spring,Cloudy,60,58,2
2011-01-28,2011,January,8,Friday,Spring,Cloudy,157,155,2
2011-01-28,2011,January,9,Friday,Spring,Light Snow/Rain,101,95,6
2011-01-28,2011,January,10,Friday,Spring,Light Snow/Rain,49,49,0
2011-01-28,2011,January,11,Friday,Spring,Light Snow/Rain,30,30,0
2011-01-28,2011,January,12,Friday,Spring,Light Snow/Rain,29,28,1
2011-01-28,2011,January,13,Friday,Spring,Light Snow/Rain,31,31,0
2011-01-28,2011,January,14,Friday,Spring,Light Snow/Rain,38,36,2
2011-01-28,2011,January,15,Friday,Spring,Cloudy,41,40,1
2011-01-28,2011,January,16,Friday,Spring,Clear,80,70,10
2011-01-28,2011,January,17,Friday,Spring,Clear,149,147,2
2011-01-28,2011,January,18,Friday,Spring,Clear,109,107,2
2011-01-28,2011,January,19,Friday,Spring,Cloudy,89,84,5
2011-01-28,2011,January,20,Friday,Spring,Cloudy,62,61,1
2011-01-28,2011,January,21,Friday,Spring,Cloudy,58,57,1
2011-01-28,2011,January,22,Friday,Spring,Clear,26,26,0
2011-01-28,2011,January,23,Friday,Spring,Clear,23,22,1
2011-01-29,2011,January,0,Saturday,Spring,Clear,28,26,2
2011-01-29,2011,January,1,Saturday,Spring,Clear,20,20,0
2011-01-29,2011,January,2,Saturday,Spring,Clear,15,15,0
2011-01-29,2011,January,3,Saturday,Spring,Clear,8,5,3
2011-01-29,2011,January,4,Saturday,Spring,Clear,3,2,1
2011-01-29,2011,January,6,Saturday,Spring,Clear,2,2,0
2011-01-29,2011,January,7,Saturday,Spring,Clear,5,4,1
2011-01-29,2011,January,8,Saturday,Spring,Clear,34,31,3
2011-01-29,2011,January,9,Saturday,Spring,Clear,34,34,0
2011-01-29,2011,January,10,Saturday,Spring,Cloudy,55,51,4
2011-01-29,2011,January,11,Saturday,Spring,Cloudy,64,60,4
2011-01-29,2011,January,12,Saturday,Spring,Cloudy,78,66,12
2011-01-29,2011,January,13,Saturday,Spring,Cloudy,65,56,9
2011-01-29,2011,January,14,Saturday,Spring,Cloudy,99,89,10
2011-01-29,2011,January,15,Saturday,Spring,Clear,120,98,22
2011-01-29,2011,January,16,Saturday,Spring,Clear,107,88,19
2011-01-29,2011,January,17,Saturday,Spring,Clear,91,82,9
2011-01-29,2011,January,18,Saturday,Spring,Clear,68,59,9
2011-01-29,2011,January,19,Saturday,Spring,Cloudy,58,52,6
2011-01-29,2011,January,20,Saturday,Spring,Clear,43,42,1
2011-01-29,2011,January,21,Saturday,Spring,Clear,36,35,1
2011-01-29,2011,January,22,Saturday,Spring,Clear,32,28,4
2011-01-29,2011,January,23,Saturday,Spring,Clear,33,30,3
2011-01-30,2011,January,0,Sunday,Spring,Clear,33,33,0
2011-01-30,2011,January,1,Sunday,Spring,Clear,29,22,7
2011-01-30,2011,January,2,Sunday,Spring,Clear,11,10,1
2011-01-30,2011,January,3,Sunday,Spring,Clear,8,7,1
2011-01-30,2011,January,4,Sunday,Spring,Clear,1,1,0
2011-01-30,2011,January,5,Sunday,Spring,Clear,3,3,0
2011-01-30,2011,January,7,Sunday,Spring,Clear,3,3,0
2011-01-30,2011,January,8,Sunday,Spring,Cloudy,12,11,1
2011-01-30,2011,January,9,Sunday,Spring,Cloudy,38,34,4
2011-01-30,2011,January,10,Sunday,Spring,Cloudy,64,57,7
2011-01-30,2011,January,11,Sunday,Spring,Clear,59,50,9
2011-01-30,2011,January,12,Sunday,Spring,Clear,97,87,10
2011-01-30,2011,January,13,Sunday,Spring,Clear,84,71,13
2011-01-30,2011,January,14,Sunday,Spring,Clear,122,104,18
2011-01-30,2011,January,15,Sunday,Spring,Clear,109,95,14
2011-01-30,2011,January,16,Sunday,Spring,Clear,123,104,19
2011-01-30,2011,January,17,Sunday,Spring,Clear,77,71,6
2011-01-30,2011,January,18,Sunday,Spring,Clear,65,57,8
2011-01-30,2011,January,19,Sunday,Spring,Clear,55,46,9
2011-01-30,2011,January,20,Sunday,Spring,Cloudy,33,30,3
2011-01-30,2011,January,21,Sunday,Spring,Cloudy,28,25,3
2011-01-30,2011,January,22,Sunday,Spring,Cloudy,21,19,2
2011-01-30,2011,January,23,Sunday,Spring,Cloudy,21,16,5
2011-01-31,2011,January,0,Monday,Spring,Cloudy,7,6,1
2011-01-31,2011,January,1,Monday,Spring,Clear,7,5,2
2011-01-31,2011,January,2,Monday,Spring,Clear,1,1,0
2011-01-31,2011,January,3,Monday,Spring,Clear,2,2,0
2011-01-31,2011,January,4,Monday,Spring,Clear,2,2,0
2011-01-31,2011,January,5,Monday,Spring,Clear,8,8,0
2011-01-31,2011,January,6,Monday,Spring,Clear,37,37,0
2011-01-31,2011,January,7,Monday,Spring,Cloudy,72,71,1
2011-01-31,2011,January,8,Monday,Spring,Cloudy,185,182,3
2011-01-31,2011,January,9,Monday,Spring,Cloudy,112,112,0
2011-01-31,2011,January,10,Monday,Spring,Cloudy,69,68,1
2011-01-31,2011,January,11,Monday,Spring,Cloudy,48,46,2
2011-01-31,2011,January,12,Monday,Spring,Cloudy,68,62,6
2011-01-31,2011,January,13,Monday,Spring,Cloudy,54,52,2
2011-01-31,2011,January,14,Monday,Spring,Cloudy,86,85,1
2011-01-31,2011,January,15,Monday,Spring,Cloudy,44,41,3
2011-01-31,2011,January,16,Monday,Spring,Cloudy,86,83,3
2011-01-31,2011,January,17,Monday,Spring,Cloudy,161,155,6
2011-01-31,2011,January,18,Monday,Spring,Cloudy,156,153,3
2011-01-31,2011,January,19,Monday,Spring,Clear,111,108,3
2011-01-31,2011,January,20,Monday,Spring,Light Snow/Rain,78,78,0
2011-01-31,2011,January,21,Monday,Spring,Light Snow/Rain,56,53,3
2011-01-31,2011,January,22,Monday,Spring,Cloudy,34,34,0
2011-01-31,2011,January,23,Monday,Spring,Cloudy,17,15,2
2011-02-01,2011,February,0,Tuesday,Spring,Cloudy,8,6,2
2011-02-01,2011,February,1,Tuesday,Spring,Cloudy,3,3,0
2011-02-01,2011,February,2,Tuesday,Spring,Cloudy,2,2,0
2011-02-01,2011,February,3,Tuesday,Spring,Cloudy,2,2,0
2011-02-01,2011,February,5,Tuesday,Spring,Light Snow/Rain,3,3,0
2011-02-01,2011,February,6,Tuesday,Spring,Light Snow/Rain,22,22,0
2011-02-01,2011,February,7,Tuesday,Spring,Light Snow/Rain,52,52,0
2011-02-01,2011,February,8,Tuesday,Spring,Light Snow/Rain,135,132,3
2011-02-01,2011,February,9,Tuesday,Spring,Cloudy,116,114,2
2011-02-01,2011,February,10,Tuesday,Spring,Cloudy,47,47,0
2011-02-01,2011,February,11,Tuesday,Spring,Cloudy,51,49,2
2011-02-01,2011,February,12,Tuesday,Spring,Cloudy,55,53,2
2011-02-01,2011,February,13,Tuesday,Spring,Cloudy,52,49,3
2011-02-01,2011,February,14,Tuesday,Spring,Cloudy,54,49,5
2011-02-01,2011,February,15,Tuesday,Spring,Cloudy,52,45,7
2011-02-01,2011,February,16,Tuesday,Spring,Cloudy,64,61,3
2011-02-01,2011,February,17,Tuesday,Spring,Cloudy,176,172,4
2011-02-01,2011,February,18,Tuesday,Spring,Cloudy,168,165,3
2011-02-01,2011,February,19,Tuesday,Spring,Cloudy,108,105,3
2011-02-01,2011,February,20,Tuesday,Spring,Cloudy,74,69,5
2011-02-01,2011,February,21,Tuesday,Spring,Cloudy,64,64,0
2011-02-01,2011,February,22,Tuesday,Spring,Cloudy,36,34,2
2011-02-01,2011,February,23,Tuesday,Spring,Light Snow/Rain,16,15,1
2011-02-02,2011,February,0,Wednesday,Spring,Light Snow/Rain,2,2,0
2011-02-02,2011,February,1,Wednesday,Spring,Light Snow/Rain,3,3,0
2011-02-02,2011,February,2,Wednesday,Spring,Light Snow/Rain,4,0,4
2011-02-02,2011,February,3,Wednesday,Spring,Light Snow/Rain,1,1,0
2011-02-02,2011,February,4,Wednesday,Spring,Light Snow/Rain,1,1,0
2011-02-02,2011,February,5,Wednesday,Spring,Light Snow/Rain,3,3,0
2011-02-02,2011,February,6,Wednesday,Spring,Light Snow/Rain,18,17,1
2011-02-02,2011,February,7,Wednesday,Spring,Light Snow/Rain,49,48,1
2011-02-02,2011,February,8,Wednesday,Spring,Light Snow/Rain,155,154,1
2011-02-02,2011,February,9,Wednesday,Spring,Cloudy,123,119,4
2011-02-02,2011,February,10,Wednesday,Spring,Cloudy,61,59,2
2011-02-02,2011,February,11,Wednesday,Spring,Cloudy,52,47,5
2011-02-02,2011,February,12,Wednesday,Spring,Cloudy,64,61,3
2011-02-02,2011,February,13,Wednesday,Spring,Clear,75,74,1
2011-02-02,2011,February,14,Wednesday,Spring,Clear,63,61,2
2011-02-02,2011,February,15,Wednesday,Spring,Clear,76,66,10
2011-02-02,2011,February,16,Wednesday,Spring,Clear,103,95,8
2011-02-02,2011,February,17,Wednesday,Spring,Clear,190,183,7
2011-02-02,2011,February,18,Wednesday,Spring,Clear,182,175,7
2011-02-02,2011,February,19,Wednesday,Spring,Clear,91,88,3
2011-02-02,2011,February,20,Wednesday,Spring,Clear,75,71,4
2011-02-02,2011,February,21,Wednesday,Spring,Clear,63,62,1
2011-02-02,2011,February,22,Wednesday,Spring,Clear,40,35,5
2011-02-02,2011,February,23,Wednesday,Spring,Clear,32,29,3
2011-02-03,2011,February,0,Thursday,Spring,Clear,12,11,1
2011-02-03,2011,February,1,Thursday,Spring,Clear,5,5,0
2011-02-03,2011,February,2,Thursday,Spring,Clear,2,2,0
2011-02-03,2011,February,3,Thursday,Spring,Clear,1,1,0
2011-02-03,2011,February,5,Thursday,Spring,Clear,2,2,0
2011-02-03,2011,February,6,Thursday,Spring,Clear,39,39,0
2011-02-03,2011,February,7,Thursday,Spring,Clear,87,86,1
2011-02-03,2011,February,8,Thursday,Spring,Clear,188,184,4
2011-02-03,2011,February,9,Thursday,Spring,Clear,133,127,6
2011-02-03,2011,February,10,Thursday,Spring,Clear,52,50,2
2011-02-03,2011,February,11,Thursday,Spring,Clear,64,55,9
2011-02-03,2011,February,12,Thursday,Spring,Clear,69,67,2
2011-02-03,2011,February,13,Thursday,Spring,Clear,51,47,4
2011-02-03,2011,February,14,Thursday,Spring,Clear,47,43,4
2011-02-03,2011,February,15,Thursday,Spring,Clear,60,56,4
2011-02-03,2011,February,16,Thursday,Spring,Clear,78,73,5
2011-02-03,2011,February,17,Thursday,Spring,Clear,175,170,5
2011-02-03,2011,February,18,Thursday,Spring,Clear,147,145,2
2011-02-03,2011,February,19,Thursday,Spring,Clear,96,92,4
2011-02-03,2011,February,20,Thursday,Spring,Clear,109,108,1
2011-02-03,2011,February,21,Thursday,Spring,Clear,54,53,1
2011-02-03,2011,February,22,Thursday,Spring,Clear,41,39,2
2011-02-03,2011,February,23,Thursday,Spring,Clear,38,34,4
2011-02-04,2011,February,0,Friday,Spring,Cloudy,13,10,3
2011-02-04,2011,February,1,Friday,Spring,Cloudy,7,7,0
2011-02-04,2011,February,2,Friday,Spring,Cloudy,1,1,0
2011-02-04,2011,February,3,Friday,Spring,Cloudy,1,1,0
2011-02-04,2011,February,5,Friday,Spring,Cloudy,7,7,0
2011-02-04,2011,February,6,Friday,Spring,Cloudy,28,26,2
2011-02-04,2011,February,7,Friday,Spring,Clear,87,87,0
2011-02-04,2011,February,8,Friday,Spring,Clear,220,217,3
2011-02-04,2011,February,9,Friday,Spring,Cloudy,127,124,3
2011-02-04,2011,February,10,Friday,Spring,Cloudy,51,46,5
2011-02-04,2011,February,11,Friday,Spring,Clear,64,61,3
2011-02-04,2011,February,12,Friday,Spring,Cloudy,86,78,8
2011-02-04,2011,February,13,Friday,Spring,Cloudy,82,73,9
2011-02-04,2011,February,14,Friday,Spring,Cloudy,91,76,15
2011-02-04,2011,February,15,Friday,Spring,Cloudy,90,81,9
2011-02-04,2011,February,16,Friday,Spring,Cloudy,99,91,8
2011-02-04,2011,February,17,Friday,Spring,Cloudy,205,195,10
2011-02-04,2011,February,18,Friday,Spring,Cloudy,155,152,3
2011-02-04,2011,February,19,Friday,Spring,Cloudy,103,102,1
2011-02-04,2011,February,20,Friday,Spring,Cloudy,71,69,2
2011-02-04,2011,February,21,Friday,Spring,Cloudy,43,41,2
2011-02-04,2011,February,22,Friday,Spring,Cloudy,46,45,1
2011-02-04,2011,February,23,Friday,Spring,Cloudy,31,30,1
2011-02-05,2011,February,0,Saturday,Spring,Cloudy,39,36,3
2011-02-05,2011,February,1,Saturday,Spring,Cloudy,18,17,1
2011-02-05,2011,February,2,Saturday,Spring,Cloudy,17,12,5
2011-02-05,2011,February,3,Saturday,Spring,Cloudy,11,10,1
2011-02-05,2011,February,4,Saturday,Spring,Light Snow/Rain,8,8,0
2011-02-05,2011,February,5,Saturday,Spring,Light Snow/Rain,9,9,0
2011-02-05,2011,February,6,Saturday,Spring,Light Snow/Rain,4,4,0
2011-02-05,2011,February,7,Saturday,Spring,Light Snow/Rain,4,4,0
2011-02-05,2011,February,8,Saturday,Spring,Light Snow/Rain,10,10,0
2011-02-05,2011,February,9,Saturday,Spring,Light Snow/Rain,20,17,3
2011-02-05,2011,February,10,Saturday,Spring,Light Snow/Rain,34,31,3
2011-02-05,2011,February,11,Saturday,Spring,Light Snow/Rain,47,46,1
2011-02-05,2011,February,12,Saturday,Spring,Light Snow/Rain,52,42,10
2011-02-05,2011,February,13,Saturday,Spring,Light Snow/Rain,72,62,10
2011-02-05,2011,February,14,Saturday,Spring,Light Snow/Rain,55,50,5
2011-02-05,2011,February,15,Saturday,Spring,Light Snow/Rain,60,49,11
2011-02-05,2011,February,16,Saturday,Spring,Light Snow/Rain,71,63,8
2011-02-05,2011,February,17,Saturday,Spring,Cloudy,78,64,14
2011-02-05,2011,February,18,Saturday,Spring,Cloudy,83,81,2
2011-02-05,2011,February,19,Saturday,Spring,Cloudy,84,78,6
2011-02-05,2011,February,20,Saturday,Spring,Clear,69,64,5
2011-02-05,2011,February,21,Saturday,Spring,Clear,56,53,3
2011-02-05,2011,February,22,Saturday,Spring,Clear,45,43,2
2011-02-05,2011,February,23,Saturday,Spring,Clear,59,52,7
2011-02-06,2011,February,0,Sunday,Spring,Clear,39,37,2
2011-02-06,2011,February,1,Sunday,Spring,Clear,44,40,4
2011-02-06,2011,February,2,Sunday,Spring,Clear,20,20,0
2011-02-06,2011,February,3,Sunday,Spring,Clear,13,10,3
2011-02-06,2011,February,4,Sunday,Spring,Clear,2,2,0
2011-02-06,2011,February,5,Sunday,Spring,Clear,1,1,0
2011-02-06,2011,February,6,Sunday,Spring,Clear,1,1,0
2011-02-06,2011,February,7,Sunday,Spring,Clear,8,8,0
2011-02-06,2011,February,8,Sunday,Spring,Clear,23,21,2
2011-02-06,2011,February,9,Sunday,Spring,Clear,45,38,7
2011-02-06,2011,February,10,Sunday,Spring,Clear,89,74,15
2011-02-06,2011,February,11,Sunday,Spring,Clear,117,89,28
2011-02-06,2011,February,12,Sunday,Spring,Clear,174,126,48
2011-02-06,2011,February,13,Sunday,Spring,Clear,182,135,47
2011-02-06,2011,February,14,Sunday,Spring,Clear,161,114,47
2011-02-06,2011,February,15,Sunday,Spring,Clear,182,130,52
2011-02-06,2011,February,16,Sunday,Spring,Clear,157,115,42
2011-02-06,2011,February,17,Sunday,Spring,Clear,121,97,24
2011-02-06,2011,February,18,Sunday,Spring,Clear,78,65,13
2011-02-06,2011,February,19,Sunday,Spring,Clear,21,20,1
2011-02-06,2011,February,20,Sunday,Spring,Clear,26,21,5
2011-02-06,2011,February,21,Sunday,Spring,Clear,27,22,5
2011-02-06,2011,February,22,Sunday,Spring,Clear,62,57,5
2011-02-06,2011,February,23,Sunday,Spring,Clear,30,26,4
2011-02-07,2011,February,0,Monday,Spring,Clear,15,14,1
2011-02-07,2011,February,1,Monday,Spring,Clear,5,4,1
2011-02-07,2011,February,2,Monday,Spring,Clear,3,3,0
2011-02-07,2011,February,3,Monday,Spring,Clear,1,1,0
2011-02-07,2011,February,4,Monday,Spring,Clear,2,1,1
2011-02-07,2011,February,5,Monday,Spring,Clear,10,9,1
2011-02-07,2011,February,6,Monday,Spring,Clear,30,29,1
2011-02-07,2011,February,7,Monday,Spring,Clear,95,89,6
2011-02-07,2011,February,8,Monday,Spring,Cloudy,230,223,7
2011-02-07,2011,February,9,Monday,Spring,Clear,118,115,3
2011-02-07,2011,February,10,Monday,Spring,Clear,55,49,6
2011-02-07,2011,February,11,Monday,Spring,Clear,47,36,11
2011-02-07,2011,February,12,Monday,Spring,Cloudy,66,59,7
2011-02-07,2011,February,13,Monday,Spring,Cloudy,64,54,10
2011-02-07,2011,February,14,Monday,Spring,Cloudy,60,52,8
2011-02-07,2011,February,15,Monday,Spring,Cloudy,50,46,4
2011-02-07,2011,February,16,Monday,Spring,Cloudy,114,98,16
2011-02-07,2011,February,17,Monday,Spring,Cloudy,216,207,9
2011-02-07,2011,February,18,Monday,Spring,Cloudy,175,170,5
2011-02-07,2011,February,19,Monday,Spring,Cloudy,128,123,5
2011-02-07,2011,February,20,Monday,Spring,Cloudy,88,82,6
2011-02-07,2011,February,21,Monday,Spring,Clear,78,75,3
2011-02-07,2011,February,22,Monday,Spring,Clear,37,34,3
2011-02-07,2011,February,23,Monday,Spring,Cloudy,25,19,6
2011-02-08,2011,February,0,Tuesday,Spring,Cloudy,10,6,4
2011-02-08,2011,February,1,Tuesday,Spring,Cloudy,4,4,0
2011-02-08,2011,February,2,Tuesday,Spring,Cloudy,2,1,1
2011-02-08,2011,February,3,Tuesday,Spring,Light Snow/Rain,1,1,0
2011-02-08,2011,February,4,Tuesday,Spring,Clear,3,3,0
2011-02-08,2011,February,5,Tuesday,Spring,Clear,2,2,0
2011-02-08,2011,February,6,Tuesday,Spring,Clear,39,39,0
2011-02-08,2011,February,7,Tuesday,Spring,Clear,100,97,3
2011-02-08,2011,February,8,Tuesday,Spring,Clear,243,236,7
2011-02-08,2011,February,9,Tuesday,Spring,Clear,135,128,7
2011-02-08,2011,February,10,Tuesday,Spring,Clear,48,44,4
2011-02-08,2011,February,11,Tuesday,Spring,Clear,50,49,1
2011-02-08,2011,February,12,Tuesday,Spring,Clear,65,63,2
2011-02-08,2011,February,13,Tuesday,Spring,Cloudy,50,48,2
2011-02-08,2011,February,14,Tuesday,Spring,Clear,64,61,3
2011-02-08,2011,February,15,Tuesday,Spring,Clear,51,45,6
2011-02-08,2011,February,16,Tuesday,Spring,Clear,83,79,4
2011-02-08,2011,February,17,Tuesday,Spring,Clear,176,172,4
2011-02-08,2011,February,18,Tuesday,Spring,Clear,152,151,1
2011-02-08,2011,February,19,Tuesday,Spring,Clear,101,100,1
2011-02-08,2011,February,20,Tuesday,Spring,Clear,56,53,3
2011-02-08,2011,February,21,Tuesday,Spring,Clear,54,46,8
2011-02-08,2011,February,22,Tuesday,Spring,Clear,29,29,0
2011-02-08,2011,February,23,Tuesday,Spring,Clear,12,9,3
2011-02-09,2011,February,0,Wednesday,Spring,Clear,17,17,0
2011-02-09,2011,February,1,Wednesday,Spring,Clear,7,7,0
2011-02-09,2011,February,2,Wednesday,Spring,Clear,3,2,1
2011-02-09,2011,February,3,Wednesday,Spring,Clear,2,2,0
2011-02-09,2011,February,5,Wednesday,Spring,Clear,7,7,0
2011-02-09,2011,February,6,Wednesday,Spring,Clear,43,43,0
2011-02-09,2011,February,7,Wednesday,Spring,Clear,99,95,4
2011-02-09,2011,February,8,Wednesday,Spring,Clear,199,198,1
2011-02-09,2011,February,9,Wednesday,Spring,Clear,123,119,4
2011-02-09,2011,February,10,Wednesday,Spring,Clear,59,51,8
2011-02-09,2011,February,11,Wednesday,Spring,Cloudy,41,40,1
2011-02-09,2011,February,12,Wednesday,Spring,Cloudy,61,57,4
2011-02-09,2011,February,13,Wednesday,Spring,Clear,69,67,2
2011-02-09,2011,February,14,Wednesday,Spring,Clear,58,56,2
2011-02-09,2011,February,15,Wednesday,Spring,Cloudy,64,61,3
2011-02-09,2011,February,16,Wednesday,Spring,Cloudy,79,72,7
2011-02-09,2011,February,17,Wednesday,Spring,Cloudy,166,157,9
2011-02-09,2011,February,18,Wednesday,Spring,Cloudy,170,168,2
2011-02-09,2011,February,19,Wednesday,Spring,Light Snow/Rain,88,87,1
2011-02-09,2011,February,20,Wednesday,Spring,Light Snow/Rain,84,84,0
2011-02-09,2011,February,21,Wednesday,Spring,Cloudy,83,83,0
2011-02-09,2011,February,22,Wednesday,Spring,Light Snow/Rain,46,42,4
2011-02-09,2011,February,23,Wednesday,Spring,Light Snow/Rain,37,37,0
2011-02-10,2011,February,0,Thursday,Spring,Light Snow/Rain,16,16,0
2011-02-10,2011,February,1,Thursday,Spring,Light Snow/Rain,7,7,0
2011-02-10,2011,February,2,Thursday,Spring,Light Snow/Rain,3,3,0
2011-02-10,2011,February,4,Thursday,Spring,Cloudy,1,1,0
2011-02-10,2011,February,5,Thursday,Spring,Cloudy,6,6,0
2011-02-10,2011,February,6,Thursday,Spring,Cloudy,26,26,0
2011-02-10,2011,February,7,Thursday,Spring,Clear,99,99,0
2011-02-10,2011,February,8,Thursday,Spring,Clear,178,173,5
2011-02-10,2011,February,9,Thursday,Spring,Clear,122,121,1
2011-02-10,2011,February,10,Thursday,Spring,Clear,35,34,1
2011-02-10,2011,February,11,Thursday,Spring,Clear,45,44,1
2011-02-10,2011,February,12,Thursday,Spring,Clear,69,65,4
2011-02-10,2011,February,13,Thursday,Spring,Clear,62,59,3
2011-02-10,2011,February,14,Thursday,Spring,Clear,48,42,6
2011-02-10,2011,February,15,Thursday,Spring,Clear,50,50,0
2011-02-10,2011,February,16,Thursday,Spring,Clear,80,76,4
2011-02-10,2011,February,17,Thursday,Spring,Clear,165,159,6
2011-02-10,2011,February,18,Thursday,Spring,Clear,160,157,3
2011-02-10,2011,February,19,Thursday,Spring,Clear,112,110,2
2011-02-10,2011,February,20,Thursday,Spring,Clear,97,93,4
2011-02-10,2011,February,21,Thursday,Spring,Clear,72,70,2
2011-02-10,2011,February,22,Thursday,Spring,Clear,51,47,4
2011-02-10,2011,February,23,Thursday,Spring,Clear,34,33,1
2011-02-11,2011,February,0,Friday,Spring,Clear,14,12,2
2011-02-11,2011,February,1,Friday,Spring,Clear,7,6,1
2011-02-11,2011,February,2,Friday,Spring,Clear,3,3,0
2011-02-11,2011,February,5,Friday,Spring,Clear,4,4,0
2011-02-11,2011,February,6,Friday,Spring,Clear,24,23,1
2011-02-11,2011,February,7,Friday,Spring,Clear,74,73,1
2011-02-11,2011,February,8,Friday,Spring,Clear,216,212,4
2011-02-11,2011,February,9,Friday,Spring,Clear,140,132,8
2011-02-11,2011,February,10,Friday,Spring,Clear,44,39,5
2011-02-11,2011,February,11,Friday,Spring,Clear,64,52,12
2011-02-11,2011,February,12,Friday,Spring,Clear,71,64,7
2011-02-11,2011,February,13,Friday,Spring,Clear,110,89,21
2011-02-11,2011,February,14,Friday,Spring,Clear,84,67,17
2011-02-11,2011,February,15,Friday,Spring,Clear,74,62,12
2011-02-11,2011,February,16,Friday,Spring,Clear,125,111,14
2011-02-11,2011,February,17,Friday,Spring,Clear,211,193,18
2011-02-11,2011,February,18,Friday,Spring,Clear,174,165,9
2011-02-11,2011,February,19,Friday,Spring,Clear,101,94,7
2011-02-11,2011,February,20,Friday,Spring,Clear,63,61,2
2011-02-11,2011,February,21,Friday,Spring,Clear,47,46,1
2011-02-11,2011,February,22,Friday,Spring,Clear,43,41,2
2011-02-11,2011,February,23,Friday,Spring,Clear,53,48,5
2011-02-12,2011,February,0,Saturday,Spring,Clear,30,27,3
2011-02-12,2011,February,1,Saturday,Spring,Clear,24,22,2
2011-02-12,2011,February,2,Saturday,Spring,Clear,15,13,2
2011-02-12,2011,February,3,Saturday,Spring,Clear,10,7,3
2011-02-12,2011,February,4,Saturday,Spring,Clear,4,4,0
2011-02-12,2011,February,5,Saturday,Spring,Clear,1,1,0
2011-02-12,2011,February,6,Saturday,Spring,Clear,2,1,1
2011-02-12,2011,February,7,Saturday,Spring,Clear,11,9,2
2011-02-12,2011,February,8,Saturday,Spring,Clear,30,28,2
2011-02-12,2011,February,9,Saturday,Spring,Clear,43,38,5
2011-02-12,2011,February,10,Saturday,Spring,Clear,84,71,13
2011-02-12,2011,February,11,Saturday,Spring,Clear,114,84,30
2011-02-12,2011,February,12,Saturday,Spring,Clear,120,93,27
2011-02-12,2011,February,13,Saturday,Spring,Clear,135,103,32
2011-02-12,2011,February,14,Saturday,Spring,Clear,120,90,30
2011-02-12,2011,February,15,Saturday,Spring,Clear,174,127,47
2011-02-12,2011,February,16,Saturday,Spring,Clear,145,103,42
2011-02-12,2011,February,17,Saturday,Spring,Clear,137,113,24
2011-02-12,2011,February,18,Saturday,Spring,Clear,64,60,4
2011-02-12,2011,February,19,Saturday,Spring,Clear,41,39,2
2011-02-12,2011,February,20,Saturday,Spring,Clear,40,39,1
2011-02-12,2011,February,21,Saturday,Spring,Clear,51,42,9
2011-02-12,2011,February,22,Saturday,Spring,Clear,45,39,6
2011-02-12,2011,February,23,Saturday,Spring,Clear,32,31,1
2011-02-13,2011,February,0,Sunday,Spring,Clear,39,34,5
2011-02-13,2011,February,1,Sunday,Spring,Clear,24,23,1
2011-02-13,2011,February,2,Sunday,Spring,Cloudy,20,19,1
2011-02-13,2011,February,3,Sunday,Spring,Cloudy,12,8,4
2011-02-13,2011,February,4,Sunday,Spring,Cloudy,2,2,0
2011-02-13,2011,February,6,Sunday,Spring,Cloudy,5,3,2
2011-02-13,2011,February,7,Sunday,Spring,Cloudy,3,3,0
2011-02-13,2011,February,8,Sunday,Spring,Cloudy,12,11,1
2011-02-13,2011,February,9,Sunday,Spring,Cloudy,47,35,12
2011-02-13,2011,February,10,Sunday,Spring,Clear,105,86,19
2011-02-13,2011,February,11,Sunday,Spring,Clear,112,86,26
2011-02-13,2011,February,12,Sunday,Spring,Clear,152,94,58
2011-02-13,2011,February,13,Sunday,Spring,Clear,154,92,62
2011-02-13,2011,February,14,Sunday,Spring,Cloudy,161,110,51
2011-02-13,2011,February,15,Sunday,Spring,Cloudy,162,122,40
2011-02-13,2011,February,16,Sunday,Spring,Cloudy,134,106,28
2011-02-13,2011,February,17,Sunday,Spring,Clear,125,95,30
2011-02-13,2011,February,18,Sunday,Spring,Clear,95,78,17
2011-02-13,2011,February,19,Sunday,Spring,Clear,61,50,11
2011-02-13,2011,February,20,Sunday,Spring,Clear,47,32,15
2011-02-13,2011,February,21,Sunday,Spring,Clear,51,45,6
2011-02-13,2011,February,22,Sunday,Spring,Clear,36,31,5
2011-02-13,2011,February,23,Sunday,Spring,Clear,30,27,3
2011-02-14,2011,February,0,Monday,Spring,Clear,11,8,3
2011-02-14,2011,February,1,Monday,Spring,Clear,7,6,1
2011-02-14,2011,February,2,Monday,Spring,Clear,2,2,0
2011-02-14,2011,February,3,Monday,Spring,Clear,2,1,1
2011-02-14,2011,February,4,Monday,Spring,Clear,2,2,0
2011-02-14,2011,February,5,Monday,Spring,Clear,3,3,0
2011-02-14,2011,February,6,Monday,Spring,Clear,26,25,1
2011-02-14,2011,February,7,Monday,Spring,Clear,98,96,2
2011-02-14,2011,February,8,Monday,Spring,Clear,256,249,7
2011-02-14,2011,February,9,Monday,Spring,Clear,130,122,8
2011-02-14,2011,February,10,Monday,Spring,Clear,55,46,9
2011-02-14,2011,February,11,Monday,Spring,Clear,53,43,10
2011-02-14,2011,February,12,Monday,Spring,Clear,126,99,27
2011-02-14,2011,February,13,Monday,Spring,Clear,120,93,27
2011-02-14,2011,February,14,Monday,Spring,Clear,90,76,14
2011-02-14,2011,February,15,Monday,Spring,Clear,90,71,19
2011-02-14,2011,February,16,Monday,Spring,Clear,118,102,16
2011-02-14,2011,February,17,Monday,Spring,Clear,243,218,25
2011-02-14,2011,February,18,Monday,Spring,Clear,205,194,11
2011-02-14,2011,February,19,Monday,Spring,Clear,98,86,12
2011-02-14,2011,February,20,Monday,Spring,Clear,70,65,5
2011-02-14,2011,February,21,Monday,Spring,Clear,43,35,8
2011-02-14,2011,February,22,Monday,Spring,Clear,45,44,1
2011-02-14,2011,February,23,Monday,Spring,Clear,20,19,1
2011-02-15,2011,February,0,Tuesday,Spring,Clear,19,12,7
2011-02-15,2011,February,1,Tuesday,Spring,Clear,5,5,0
2011-02-15,2011,February,2,Tuesday,Spring,Clear,3,2,1
2011-02-15,2011,February,4,Tuesday,Spring,Clear,1,1,0
2011-02-15,2011,February,5,Tuesday,Spring,Clear,4,4,0
2011-02-15,2011,February,6,Tuesday,Spring,Clear,30,30,0
2011-02-15,2011,February,7,Tuesday,Spring,Clear,105,103,2
2011-02-15,2011,February,8,Tuesday,Spring,Clear,223,213,10
2011-02-15,2011,February,9,Tuesday,Spring,Clear,110,108,2
2011-02-15,2011,February,10,Tuesday,Spring,Clear,52,47,5
2011-02-15,2011,February,11,Tuesday,Spring,Clear,57,46,11
2011-02-15,2011,February,12,Tuesday,Spring,Clear,71,65,6
2011-02-15,2011,February,13,Tuesday,Spring,Clear,82,68,14
2011-02-15,2011,February,14,Tuesday,Spring,Clear,79,69,10
2011-02-15,2011,February,15,Tuesday,Spring,Clear,85,74,11
2011-02-15,2011,February,16,Tuesday,Spring,Clear,98,77,21
2011-02-15,2011,February,17,Tuesday,Spring,Clear,206,191,15
2011-02-15,2011,February,18,Tuesday,Spring,Clear,212,198,14
2011-02-15,2011,February,19,Tuesday,Spring,Clear,145,142,3
2011-02-15,2011,February,20,Tuesday,Spring,Clear,101,98,3
2011-02-15,2011,February,21,Tuesday,Spring,Clear,66,61,5
2011-02-15,2011,February,22,Tuesday,Spring,Clear,41,41,0
2011-02-15,2011,February,23,Tuesday,Spring,Cloudy,20,20,0
2011-02-16,2011,February,0,Wednesday,Spring,Clear,15,15,0
2011-02-16,2011,February,1,Wednesday,Spring,Clear,9,9,0
2011-02-16,2011,February,3,Wednesday,Spring,Cloudy,1,1,0
2011-02-16,2011,February,4,Wednesday,Spring,Clear,1,1,0
2011-02-16,2011,February,5,Wednesday,Spring,Clear,5,5,0
2011-02-16,2011,February,6,Wednesday,Spring,Clear,33,32,1
2011-02-16,2011,February,7,Wednesday,Spring,Cloudy,108,103,5
2011-02-16,2011,February,8,Wednesday,Spring,Cloudy,230,224,6
2011-02-16,2011,February,9,Wednesday,Spring,Clear,124,122,2
2011-02-16,2011,February,10,Wednesday,Spring,Clear,69,55,14
2011-02-16,2011,February,11,Wednesday,Spring,Clear,66,59,7
2011-02-16,2011,February,12,Wednesday,Spring,Clear,86,72,14
2011-02-16,2011,February,13,Wednesday,Spring,Clear,93,80,13
2011-02-16,2011,February,14,Wednesday,Spring,Clear,82,65,17
2011-02-16,2011,February,15,Wednesday,Spring,Clear,117,82,35
2011-02-16,2011,February,16,Wednesday,Spring,Clear,122,96,26
2011-02-16,2011,February,17,Wednesday,Spring,Clear,255,244,11
2011-02-16,2011,February,18,Wednesday,Spring,Clear,222,202,20
2011-02-16,2011,February,19,Wednesday,Spring,Clear,161,143,18
2011-02-16,2011,February,20,Wednesday,Spring,Clear,118,108,10
2011-02-16,2011,February,21,Wednesday,Spring,Clear,92,87,5
2011-02-16,2011,February,22,Wednesday,Spring,Clear,73,61,12
2011-02-16,2011,February,23,Wednesday,Spring,Clear,33,31,2
2011-02-17,2011,February,0,Thursday,Spring,Clear,17,16,1
2011-02-17,2011,February,1,Thursday,Spring,Clear,6,6,0
2011-02-17,2011,February,2,Thursday,Spring,Cloudy,6,4,2
2011-02-17,2011,February,3,Thursday,Spring,Clear,4,1,3
2011-02-17,2011,February,4,Thursday,Spring,Clear,4,1,3
2011-02-17,2011,February,5,Thursday,Spring,Clear,12,11,1
2011-02-17,2011,February,6,Thursday,Spring,Clear,47,44,3
2011-02-17,2011,February,7,Thursday,Spring,Clear,126,119,7
2011-02-17,2011,February,8,Thursday,Spring,Clear,285,267,18
2011-02-17,2011,February,9,Thursday,Spring,Clear,179,163,16
2011-02-17,2011,February,10,Thursday,Spring,Clear,88,70,18
2011-02-17,2011,February,11,Thursday,Spring,Cloudy,90,71,19
2011-02-17,2011,February,12,Thursday,Spring,Clear,101,86,15
2011-02-17,2011,February,13,Thursday,Spring,Clear,123,108,15
2011-02-17,2011,February,14,Thursday,Spring,Clear,81,55,26
2011-02-17,2011,February,15,Thursday,Spring,Clear,106,91,15
2011-02-17,2011,February,16,Thursday,Spring,Cloudy,146,117,29
2011-02-17,2011,February,17,Thursday,Spring,Cloudy,274,256,18
2011-02-17,2011,February,18,Thursday,Spring,Cloudy,222,211,11
2011-02-17,2011,February,19,Thursday,Spring,Clear,175,161,14
2011-02-17,2011,February,20,Thursday,Spring,Clear,139,131,8
2011-02-17,2011,February,21,Thursday,Spring,Clear,124,119,5
2011-02-17,2011,February,22,Thursday,Spring,Clear,76,68,8
2011-02-17,2011,February,23,Thursday,Spring,Clear,44,40,4
2011-02-18,2011,February,0,Friday,Spring,Clear,32,20,12
2011-02-18,2011,February,1,Friday,Spring,Clear,8,7,1
2011-02-18,2011,February,2,Friday,Spring,Clear,7,5,2
2011-02-18,2011,February,3,Friday,Spring,Clear,8,6,2
2011-02-18,2011,February,4,Friday,Spring,Clear,1,1,0
2011-02-18,2011,February,5,Friday,Spring,Cloudy,7,6,1
2011-02-18,2011,February,6,Friday,Spring,Cloudy,50,48,2
2011-02-18,2011,February,7,Friday,Spring,Cloudy,116,108,8
2011-02-18,2011,February,8,Friday,Spring,Cloudy,272,246,26
2011-02-18,2011,February,9,Friday,Spring,Cloudy,169,154,15
2011-02-18,2011,February,10,Friday,Spring,Cloudy,95,78,17
2011-02-18,2011,February,11,Friday,Spring,Clear,113,82,31
2011-02-18,2011,February,12,Friday,Spring,Clear,185,126,59
2011-02-18,2011,February,13,Friday,Spring,Clear,176,131,45
2011-02-18,2011,February,14,Friday,Spring,Clear,191,118,73
2011-02-18,2011,February,15,Friday,Spring,Clear,172,117,55
2011-02-18,2011,February,16,Friday,Spring,Clear,232,164,68
2011-02-18,2011,February,17,Friday,Spring,Clear,327,275,52
2011-02-18,2011,February,18,Friday,Spring,Clear,224,195,29
2011-02-18,2011,February,19,Friday,Spring,Clear,162,146,16
2011-02-18,2011,February,20,Friday,Spring,Clear,124,105,19
2011-02-18,2011,February,21,Friday,Spring,Clear,72,61,11
2011-02-18,2011,February,22,Friday,Spring,Clear,107,88,19
2011-02-18,2011,February,23,Friday,Spring,Clear,77,61,16
2011-02-19,2011,February,0,Saturday,Spring,Clear,29,23,6
2011-02-19,2011,February,1,Saturday,Spring,Clear,31,21,10
2011-02-19,2011,February,2,Saturday,Spring,Clear,17,14,3
2011-02-19,2011,February,3,Saturday,Spring,Clear,7,7,0
2011-02-19,2011,February,4,Saturday,Spring,Clear,3,3,0
2011-02-19,2011,February,5,Saturday,Spring,Clear,3,3,0
2011-02-19,2011,February,6,Saturday,Spring,Clear,6,3,3
2011-02-19,2011,February,7,Saturday,Spring,Clear,22,16,6
2011-02-19,2011,February,8,Saturday,Spring,Clear,45,36,9
2011-02-19,2011,February,9,Saturday,Spring,Clear,55,37,18
2011-02-19,2011,February,10,Saturday,Spring,Clear,106,72,34
2011-02-19,2011,February,11,Saturday,Spring,Clear,123,76,47
2011-02-19,2011,February,12,Saturday,Spring,Clear,119,81,38
2011-02-19,2011,February,13,Saturday,Spring,Clear,155,103,52
2011-02-19,2011,February,14,Saturday,Spring,Clear,196,94,102
2011-02-19,2011,February,15,Saturday,Spring,Clear,171,87,84
2011-02-19,2011,February,16,Saturday,Spring,Clear,120,81,39
2011-02-19,2011,February,17,Saturday,Spring,Clear,127,91,36
2011-02-19,2011,February,18,Saturday,Spring,Clear,88,67,21
2011-02-19,2011,February,19,Saturday,Spring,Clear,59,54,5
2011-02-19,2011,February,20,Saturday,Spring,Clear,47,38,9
2011-02-19,2011,February,21,Saturday,Spring,Clear,33,29,4
2011-02-19,2011,February,22,Saturday,Spring,Clear,44,42,2
2011-02-19,2011,February,23,Saturday,Spring,Clear,29,25,4
2011-02-20,2011,February,0,Sunday,Spring,Clear,17,14,3
2011-02-20,2011,February,1,Sunday,Spring,Clear,16,11,5
2011-02-20,2011,February,2,Sunday,Spring,Clear,17,17,0
2011-02-20,2011,February,3,Sunday,Spring,Clear,18,9,9
2011-02-20,2011,February,4,Sunday,Spring,Clear,1,1,0
2011-02-20,2011,February,6,Sunday,Spring,Clear,2,1,1
2011-02-20,2011,February,7,Sunday,Spring,Clear,2,2,0
2011-02-20,2011,February,8,Sunday,Spring,Clear,24,22,2
2011-02-20,2011,February,9,Sunday,Spring,Clear,55,48,7
2011-02-20,2011,February,10,Sunday,Spring,Cloudy,104,70,34
2011-02-20,2011,February,11,Sunday,Spring,Cloudy,161,89,72
2011-02-20,2011,February,12,Sunday,Spring,Clear,182,120,62
2011-02-20,2011,February,13,Sunday,Spring,Clear,198,122,76
2011-02-20,2011,February,14,Sunday,Spring,Clear,212,104,108
2011-02-20,2011,February,15,Sunday,Spring,Clear,168,102,66
2011-02-20,2011,February,16,Sunday,Spring,Clear,147,88,59
2011-02-20,2011,February,17,Sunday,Spring,Clear,146,86,60
2011-02-20,2011,February,18,Sunday,Spring,Cloudy,101,71,30
2011-02-20,2011,February,19,Sunday,Spring,Cloudy,42,39,3
2011-02-20,2011,February,20,Sunday,Spring,Cloudy,42,30,12
2011-02-20,2011,February,21,Sunday,Spring,Cloudy,56,39,17
2011-02-20,2011,February,22,Sunday,Spring,Cloudy,47,43,4
2011-02-20,2011,February,23,Sunday,Spring,Cloudy,54,45,9
2011-02-21,2011,February,0,Monday,Spring,Cloudy,37,30,7
2011-02-21,2011,February,1,Monday,Spring,Cloudy,13,11,2
2011-02-21,2011,February,2,Monday,Spring,Cloudy,4,3,1
2011-02-21,2011,February,3,Monday,Spring,Cloudy,5,3,2
2011-02-21,2011,February,4,Monday,Spring,Clear,1,0,1
2011-02-21,2011,February,5,Monday,Spring,Cloudy,3,2,1
2011-02-21,2011,February,6,Monday,Spring,Cloudy,8,6,2
2011-02-21,2011,February,7,Monday,Spring,Cloudy,19,16,3
2011-02-21,2011,February,8,Monday,Spring,Cloudy,63,56,7
2011-02-21,2011,February,9,Monday,Spring,Cloudy,57,46,11
2011-02-21,2011,February,10,Monday,Spring,Cloudy,81,52,29
2011-02-21,2011,February,11,Monday,Spring,Cloudy,90,70,20
2011-02-21,2011,February,12,Monday,Spring,Cloudy,93,67,26
2011-02-21,2011,February,13,Monday,Spring,Light Snow/Rain,103,75,28
2011-02-21,2011,February,14,Monday,Spring,Cloudy,116,101,15
2011-02-21,2011,February,15,Monday,Spring,Cloudy,87,76,11
2011-02-21,2011,February,16,Monday,Spring,Light Snow/Rain,56,48,8
2011-02-21,2011,February,17,Monday,Spring,Cloudy,80,62,18
2011-02-21,2011,February,18,Monday,Spring,Cloudy,66,64,2
2011-02-21,2011,February,19,Monday,Spring,Cloudy,49,49,0
2011-02-21,2011,February,20,Monday,Spring,Light Snow/Rain,29,29,0
2011-02-21,2011,February,21,Monday,Spring,Light Snow/Rain,34,33,1
2011-02-21,2011,February,22,Monday,Spring,Light Snow/Rain,11,11,0
2011-02-21,2011,February,23,Monday,Spring,Light Snow/Rain,2,2,0
2011-02-22,2011,February,6,Tuesday,Spring,Cloudy,7,7,0
2011-02-22,2011,February,7,Tuesday,Spring,Cloudy,40,40,0
2011-02-22,2011,February,8,Tuesday,Spring,Cloudy,114,107,7
2011-02-22,2011,February,9,Tuesday,Spring,Cloudy,106,101,5
2011-02-22,2011,February,10,Tuesday,Spring,Clear,44,44,0
2011-02-22,2011,February,11,Tuesday,Spring,Clear,50,43,7
2011-02-22,2011,February,12,Tuesday,Spring,Clear,55,48,7
2011-02-22,2011,February,13,Tuesday,Spring,Clear,55,52,3
2011-02-22,2011,February,14,Tuesday,Spring,Clear,58,49,9
2011-02-22,2011,February,15,Tuesday,Spring,Clear,69,67,2
2011-02-22,2011,February,16,Tuesday,Spring,Clear,86,79,7
2011-02-22,2011,February,17,Tuesday,Spring,Clear,196,188,8
2011-02-22,2011,February,18,Tuesday,Spring,Clear,167,161,6
2011-02-22,2011,February,19,Tuesday,Spring,Clear,118,114,4
2011-02-22,2011,February,20,Tuesday,Spring,Clear,105,102,3
2011-02-22,2011,February,21,Tuesday,Spring,Clear,82,80,2
2011-02-22,2011,February,22,Tuesday,Spring,Clear,77,76,1
2011-02-22,2011,February,23,Tuesday,Spring,Clear,21,18,3
2011-02-23,2011,February,0,Wednesday,Spring,Clear,6,6,0
2011-02-23,2011,February,1,Wednesday,Spring,Clear,4,4,0
2011-02-23,2011,February,2,Wednesday,Spring,Clear,1,1,0
2011-02-23,2011,February,3,Wednesday,Spring,Clear,2,2,0
2011-02-23,2011,February,5,Wednesday,Spring,Clear,8,8,0
2011-02-23,2011,February,6,Wednesday,Spring,Clear,36,36,0
2011-02-23,2011,February,7,Wednesday,Spring,Clear,96,94,2
2011-02-23,2011,February,8,Wednesday,Spring,Clear,235,227,8
2011-02-23,2011,February,9,Wednesday,Spring,Clear,139,130,9
2011-02-23,2011,February,10,Wednesday,Spring,Clear,51,47,4
2011-02-23,2011,February,11,Wednesday,Spring,Clear,69,53,16
2011-02-23,2011,February,12,Wednesday,Spring,Clear,67,56,11
2011-02-23,2011,February,13,Wednesday,Spring,Clear,87,78,9
2011-02-23,2011,February,14,Wednesday,Spring,Clear,78,61,17
2011-02-23,2011,February,15,Wednesday,Spring,Clear,72,54,18
2011-02-23,2011,February,16,Wednesday,Spring,Clear,94,79,15
2011-02-23,2011,February,17,Wednesday,Spring,Clear,222,207,15
2011-02-23,2011,February,18,Wednesday,Spring,Clear,209,206,3
2011-02-23,2011,February,19,Wednesday,Spring,Clear,141,135,6
2011-02-23,2011,February,20,Wednesday,Spring,Clear,109,107,2
2011-02-23,2011,February,21,Wednesday,Spring,Clear,91,89,2
2011-02-23,2011,February,22,Wednesday,Spring,Clear,61,60,1
2011-02-23,2011,February,23,Wednesday,Spring,Clear,39,38,1
2011-02-24,2011,February,0,Thursday,Spring,Clear,11,11,0
2011-02-24,2011,February,1,Thursday,Spring,Clear,7,7,0
2011-02-24,2011,February,2,Thursday,Spring,Clear,4,4,0
2011-02-24,2011,February,3,Thursday,Spring,Clear,2,2,0
2011-02-24,2011,February,5,Thursday,Spring,Clear,4,3,1
2011-02-24,2011,February,6,Thursday,Spring,Clear,58,58,0
2011-02-24,2011,February,7,Thursday,Spring,Clear,104,104,0
2011-02-24,2011,February,8,Thursday,Spring,Clear,252,244,8
2011-02-24,2011,February,9,Thursday,Spring,Cloudy,137,133,4
2011-02-24,2011,February,10,Thursday,Spring,Cloudy,57,49,8
2011-02-24,2011,February,11,Thursday,Spring,Cloudy,79,71,8
2011-02-24,2011,February,12,Thursday,Spring,Cloudy,95,85,10
2011-02-24,2011,February,13,Thursday,Spring,Cloudy,88,72,16
2011-02-24,2011,February,14,Thursday,Spring,Cloudy,69,67,2
2011-02-24,2011,February,15,Thursday,Spring,Light Snow/Rain,63,58,5
2011-02-24,2011,February,16,Thursday,Spring,Light Snow/Rain,71,67,4
2011-02-24,2011,February,17,Thursday,Spring,Light Snow/Rain,177,168,9
2011-02-24,2011,February,18,Thursday,Spring,Cloudy,137,132,5
2011-02-24,2011,February,19,Thursday,Spring,Light Snow/Rain,115,112,3
2011-02-24,2011,February,20,Thursday,Spring,Cloudy,89,87,2
2011-02-24,2011,February,21,Thursday,Spring,Cloudy,83,76,7
2011-02-24,2011,February,22,Thursday,Spring,Light Snow/Rain,55,50,5
2011-02-24,2011,February,23,Thursday,Spring,Cloudy,50,47,3
2011-02-25,2011,February,0,Friday,Spring,Light Snow/Rain,9,8,1
2011-02-25,2011,February,1,Friday,Spring,Cloudy,10,9,1
2011-02-25,2011,February,2,Friday,Spring,Cloudy,3,3,0
2011-02-25,2011,February,3,Friday,Spring,Cloudy,2,1,1
2011-02-25,2011,February,5,Friday,Spring,Cloudy,6,5,1
2011-02-25,2011,February,6,Friday,Spring,Light Snow/Rain,11,11,0
2011-02-25,2011,February,7,Friday,Spring,Light Snow/Rain,35,34,1
2011-02-25,2011,February,8,Friday,Spring,Light Snow/Rain,73,70,3
2011-02-25,2011,February,9,Friday,Spring,Light Snow/Rain,114,111,3
2011-02-25,2011,February,10,Friday,Spring,Light Snow/Rain,49,42,7
2011-02-25,2011,February,11,Friday,Spring,Clear,59,50,9
2011-02-25,2011,February,12,Friday,Spring,Light Snow/Rain,115,95,20
2011-02-25,2011,February,13,Friday,Spring,Light Snow/Rain,83,77,6
2011-02-25,2011,February,14,Friday,Spring,Light Snow/Rain,85,71,14
2011-02-25,2011,February,15,Friday,Spring,Clear,55,50,5
2011-02-25,2011,February,16,Friday,Spring,Clear,102,91,11
2011-02-25,2011,February,17,Friday,Spring,Clear,189,181,8
2011-02-25,2011,February,18,Friday,Spring,Clear,157,150,7
2011-02-25,2011,February,19,Friday,Spring,Clear,90,86,4
2011-02-25,2011,February,20,Friday,Spring,Clear,62,60,2
2011-02-25,2011,February,21,Friday,Spring,Clear,63,56,7
2011-02-25,2011,February,22,Friday,Spring,Clear,50,43,7
2011-02-25,2011,February,23,Friday,Spring,Clear,39,37,2
2011-02-26,2011,February,0,Saturday,Spring,Clear,28,25,3
2011-02-26,2011,February,1,Saturday,Spring,Clear,27,25,2
2011-02-26,2011,February,2,Saturday,Spring,Clear,12,9,3
2011-02-26,2011,February,3,Saturday,Spring,Clear,8,7,1
2011-02-26,2011,February,4,Saturday,Spring,Cloudy,2,1,1
2011-02-26,2011,February,5,Saturday,Spring,Cloudy,10,9,1
2011-02-26,2011,February,6,Saturday,Spring,Clear,7,6,1
2011-02-26,2011,February,7,Saturday,Spring,Clear,22,21,1
2011-02-26,2011,February,8,Saturday,Spring,Cloudy,57,55,2
2011-02-26,2011,February,9,Saturday,Spring,Cloudy,74,65,9
2011-02-26,2011,February,10,Saturday,Spring,Cloudy,85,71,14
2011-02-26,2011,February,11,Saturday,Spring,Clear,126,100,26
2011-02-26,2011,February,12,Saturday,Spring,Cloudy,160,115,45
2011-02-26,2011,February,13,Saturday,Spring,Cloudy,174,136,38
2011-02-26,2011,February,14,Saturday,Spring,Cloudy,211,154,57
2011-02-26,2011,February,15,Saturday,Spring,Cloudy,165,125,40
2011-02-26,2011,February,16,Saturday,Spring,Clear,171,130,41
2011-02-26,2011,February,17,Saturday,Spring,Clear,183,130,53
2011-02-26,2011,February,18,Saturday,Spring,Clear,137,111,26
2011-02-26,2011,February,19,Saturday,Spring,Clear,94,64,30
2011-02-26,2011,February,20,Saturday,Spring,Clear,68,60,8
2011-02-26,2011,February,21,Saturday,Spring,Clear,68,59,9
2011-02-26,2011,February,22,Saturday,Spring,Clear,46,38,8
2011-02-26,2011,February,23,Saturday,Spring,Clear,34,29,5
2011-02-27,2011,February,0,Sunday,Spring,Clear,34,26,8
2011-02-27,2011,February,1,Sunday,Spring,Clear,37,30,7
2011-02-27,2011,February,2,Sunday,Spring,Clear,22,20,2
2011-02-27,2011,February,3,Sunday,Spring,Clear,11,8,3
2011-02-27,2011,February,4,Sunday,Spring,Clear,2,2,0
2011-02-27,2011,February,6,Sunday,Spring,Clear,3,1,2
2011-02-27,2011,February,7,Sunday,Spring,Clear,14,8,6
2011-02-27,2011,February,8,Sunday,Spring,Clear,35,26,9
2011-02-27,2011,February,9,Sunday,Spring,Clear,59,42,17
2011-02-27,2011,February,10,Sunday,Spring,Clear,103,79,24
2011-02-27,2011,February,11,Sunday,Spring,Clear,125,92,33
2011-02-27,2011,February,12,Sunday,Spring,Clear,193,132,61
2011-02-27,2011,February,13,Sunday,Spring,Clear,259,169,90
2011-02-27,2011,February,14,Sunday,Spring,Clear,282,177,105
2011-02-27,2011,February,15,Sunday,Spring,Clear,261,163,98
2011-02-27,2011,February,16,Sunday,Spring,Clear,268,170,98
2011-02-27,2011,February,17,Sunday,Spring,Clear,187,121,66
2011-02-27,2011,February,18,Sunday,Spring,Clear,127,103,24
2011-02-27,2011,February,19,Sunday,Spring,Clear,102,86,16
2011-02-27,2011,February,20,Sunday,Spring,Clear,81,72,9
2011-02-27,2011,February,21,Sunday,Spring,Clear,69,61,8
2011-02-27,2011,February,22,Sunday,Spring,Cloudy,69,67,2
2011-02-27,2011,February,23,Sunday,Spring,Cloudy,59,53,6
2011-02-28,2011,February,0,Monday,Spring,Cloudy,30,25,5
2011-02-28,2011,February,1,Monday,Spring,Light Snow/Rain,8,7,1
2011-02-28,2011,February,3,Monday,Spring,Light Snow/Rain,1,1,0
2011-02-28,2011,February,5,Monday,Spring,Cloudy,5,4,1
2011-02-28,2011,February,6,Monday,Spring,Cloudy,28,27,1
2011-02-28,2011,February,7,Monday,Spring,Cloudy,92,90,2
2011-02-28,2011,February,8,Monday,Spring,Cloudy,255,242,13
2011-02-28,2011,February,9,Monday,Spring,Clear,142,127,15
2011-02-28,2011,February,10,Monday,Spring,Cloudy,92,79,13
2011-02-28,2011,February,11,Monday,Spring,Cloudy,87,74,13
2011-02-28,2011,February,12,Monday,Spring,Cloudy,36,36,0
2011-02-28,2011,February,13,Monday,Spring,Light Snow/Rain,32,31,1
2011-02-28,2011,February,14,Monday,Spring,Light Snow/Rain,25,24,1
2011-02-28,2011,February,15,Monday,Spring,Light Snow/Rain,35,35,0
2011-02-28,2011,February,16,Monday,Spring,Light Snow/Rain,42,40,2
2011-02-28,2011,February,17,Monday,Spring,Light Snow/Rain,79,77,2
2011-02-28,2011,February,18,Monday,Spring,Light Snow/Rain,131,127,4
2011-02-28,2011,February,19,Monday,Spring,Light Snow/Rain,80,79,1
2011-02-28,2011,February,20,Monday,Spring,Light Snow/Rain,45,45,0
2011-02-28,2011,February,21,Monday,Spring,Cloudy,80,78,2
2011-02-28,2011,February,22,Monday,Spring,Light Snow/Rain,76,72,4
2011-02-28,2011,February,23,Monday,Spring,Cloudy,45,45,0
2011-03-01,2011,March,0,Tuesday,Spring,Clear,7,7,0
2011-03-01,2011,March,1,Tuesday,Spring,Clear,3,3,0
2011-03-01,2011,March,2,Tuesday,Spring,Clear,4,4,0
2011-03-01,2011,March,3,Tuesday,Spring,Clear,2,2,0
2011-03-01,2011,March,4,Tuesday,Spring,Clear,1,1,0
2011-03-01,2011,March,5,Tuesday,Spring,Clear,2,1,1
2011-03-01,2011,March,6,Tuesday,Spring,Clear,46,46,0
2011-03-01,2011,March,7,Tuesday,Spring,Clear,107,105,2
2011-03-01,2011,March,8,Tuesday,Spring,Clear,214,204,10
2011-03-01,2011,March,9,Tuesday,Spring,Clear,124,116,8
2011-03-01,2011,March,10,Tuesday,Spring,Clear,68,55,13
2011-03-01,2011,March,11,Tuesday,Spring,Clear,56,48,8
2011-03-01,2011,March,12,Tuesday,Spring,Clear,86,80,6
2011-03-01,2011,March,13,Tuesday,Spring,Clear,78,65,13
2011-03-01,2011,March,14,Tuesday,Spring,Clear,79,61,18
2011-03-01,2011,March,15,Tuesday,Spring,Clear,64,57,7
2011-03-01,2011,March,16,Tuesday,Spring,Clear,102,92,10
2011-03-01,2011,March,17,Tuesday,Spring,Clear,242,230,12
2011-03-01,2011,March,18,Tuesday,Spring,Clear,224,214,10
2011-03-01,2011,March,19,Tuesday,Spring,Clear,119,115,4
2011-03-01,2011,March,20,Tuesday,Spring,Clear,88,86,2
2011-03-01,2011,March,21,Tuesday,Spring,Clear,63,55,8
2011-03-01,2011,March,22,Tuesday,Spring,Clear,47,44,3
2011-03-01,2011,March,23,Tuesday,Spring,Clear,25,23,2
2011-03-02,2011,March,0,Wednesday,Spring,Clear,8,5,3
2011-03-02,2011,March,1,Wednesday,Spring,Clear,4,4,0
2011-03-02,2011,March,2,Wednesday,Spring,Clear,2,2,0
2011-03-02,2011,March,3,Wednesday,Spring,Clear,4,1,3
2011-03-02,2011,March,4,Wednesday,Spring,Clear,1,0,1
2011-03-02,2011,March,5,Wednesday,Spring,Clear,5,5,0
2011-03-02,2011,March,6,Wednesday,Spring,Clear,40,39,1
2011-03-02,2011,March,7,Wednesday,Spring,Clear,110,108,2
2011-03-02,2011,March,8,Wednesday,Spring,Clear,256,243,13
2011-03-02,2011,March,9,Wednesday,Spring,Clear,148,141,7
2011-03-02,2011,March,10,Wednesday,Spring,Clear,76,65,11
2011-03-02,2011,March,11,Wednesday,Spring,Clear,73,65,8
2011-03-02,2011,March,12,Wednesday,Spring,Clear,82,62,20
2011-03-02,2011,March,13,Wednesday,Spring,Clear,125,90,35
2011-03-02,2011,March,14,Wednesday,Spring,Clear,96,75,21
2011-03-02,2011,March,15,Wednesday,Spring,Clear,110,91,19
2011-03-02,2011,March,16,Wednesday,Spring,Clear,139,112,27
2011-03-02,2011,March,17,Wednesday,Spring,Clear,268,238,30
2011-03-02,2011,March,18,Wednesday,Spring,Clear,201,193,8
2011-03-02,2011,March,19,Wednesday,Spring,Clear,150,144,6
2011-03-02,2011,March,20,Wednesday,Spring,Clear,95,86,9
2011-03-02,2011,March,21,Wednesday,Spring,Clear,71,68,3
2011-03-02,2011,March,22,Wednesday,Spring,Clear,48,44,4
2011-03-02,2011,March,23,Wednesday,Spring,Clear,22,22,0
2011-03-03,2011,March,0,Thursday,Spring,Clear,13,10,3
2011-03-03,2011,March,1,Thursday,Spring,Clear,1,1,0
2011-03-03,2011,March,2,Thursday,Spring,Clear,3,2,1
2011-03-03,2011,March,3,Thursday,Spring,Clear,1,1,0
2011-03-03,2011,March,4,Thursday,Spring,Clear,1,1,0
2011-03-03,2011,March,5,Thursday,Spring,Clear,8,7,1
2011-03-03,2011,March,6,Thursday,Spring,Clear,35,34,1
2011-03-03,2011,March,7,Thursday,Spring,Clear,111,110,1
2011-03-03,2011,March,8,Thursday,Spring,Clear,220,216,4
2011-03-03,2011,March,9,Thursday,Spring,Clear,145,135,10
2011-03-03,2011,March,10,Thursday,Spring,Clear,56,49,7
2011-03-03,2011,March,11,Thursday,Spring,Clear,50,40,10
2011-03-03,2011,March,12,Thursday,Spring,Clear,72,65,7
2011-03-03,2011,March,13,Thursday,Spring,Clear,80,67,13
2011-03-03,2011,March,14,Thursday,Spring,Clear,78,60,18
2011-03-03,2011,March,15,Thursday,Spring,Clear,68,62,6
2011-03-03,2011,March,16,Thursday,Spring,Clear,71,65,6
2011-03-03,2011,March,17,Thursday,Spring,Clear,202,185,17
2011-03-03,2011,March,18,Thursday,Spring,Clear,167,161,6
2011-03-03,2011,March,19,Thursday,Spring,Clear,106,101,5
2011-03-03,2011,March,20,Thursday,Spring,Clear,70,69,1
2011-03-03,2011,March,21,Thursday,Spring,Clear,51,48,3
2011-03-03,2011,March,22,Thursday,Spring,Clear,53,50,3
2011-03-03,2011,March,23,Thursday,Spring,Cloudy,23,23,0
2011-03-04,2011,March,0,Friday,Spring,Cloudy,12,12,0
2011-03-04,2011,March,1,Friday,Spring,Cloudy,4,4,0
2011-03-04,2011,March,2,Friday,Spring,Cloudy,2,2,0
2011-03-04,2011,March,3,Friday,Spring,Cloudy,1,1,0
2011-03-04,2011,March,4,Friday,Spring,Cloudy,1,0,1
2011-03-04,2011,March,5,Friday,Spring,Cloudy,7,7,0
2011-03-04,2011,March,6,Friday,Spring,Cloudy,29,28,1
2011-03-04,2011,March,7,Friday,Spring,Clear,83,83,0
2011-03-04,2011,March,8,Friday,Spring,Clear,228,222,6
2011-03-04,2011,March,9,Friday,Spring,Clear,150,138,12
2011-03-04,2011,March,10,Friday,Spring,Clear,66,56,10
2011-03-04,2011,March,11,Friday,Spring,Clear,89,73,16
2011-03-04,2011,March,12,Friday,Spring,Clear,97,87,10
2011-03-04,2011,March,13,Friday,Spring,Clear,87,74,13
2011-03-04,2011,March,14,Friday,Spring,Clear,95,65,30
2011-03-04,2011,March,15,Friday,Spring,Clear,106,75,31
2011-03-04,2011,March,16,Friday,Spring,Clear,118,101,17
2011-03-04,2011,March,17,Friday,Spring,Cloudy,228,206,22
2011-03-04,2011,March,18,Friday,Spring,Cloudy,187,172,15
2011-03-04,2011,March,19,Friday,Spring,Clear,107,102,5
2011-03-04,2011,March,20,Friday,Spring,Cloudy,87,78,9
2011-03-04,2011,March,21,Friday,Spring,Cloudy,70,64,6
2011-03-04,2011,March,22,Friday,Spring,Clear,44,40,4
2011-03-04,2011,March,23,Friday,Spring,Cloudy,46,40,6
2011-03-05,2011,March,0,Saturday,Spring,Cloudy,19,15,4
2011-03-05,2011,March,1,Saturday,Spring,Cloudy,25,20,5
2011-03-05,2011,March,2,Saturday,Spring,Cloudy,20,15,5
2011-03-05,2011,March,3,Saturday,Spring,Cloudy,2,2,0
2011-03-05,2011,March,4,Saturday,Spring,Cloudy,1,1,0
2011-03-05,2011,March,5,Saturday,Spring,Cloudy,3,3,0
2011-03-05,2011,March,6,Saturday,Spring,Cloudy,4,3,1
2011-03-05,2011,March,7,Saturday,Spring,Cloudy,15,10,5
2011-03-05,2011,March,8,Saturday,Spring,Cloudy,45,34,11
2011-03-05,2011,March,9,Saturday,Spring,Cloudy,63,48,15
2011-03-05,2011,March,10,Saturday,Spring,Cloudy,103,69,34
2011-03-05,2011,March,11,Saturday,Spring,Cloudy,159,116,43
2011-03-05,2011,March,12,Saturday,Spring,Cloudy,167,121,46
2011-03-05,2011,March,13,Saturday,Spring,Cloudy,190,130,60
2011-03-05,2011,March,14,Saturday,Spring,Cloudy,198,118,80
2011-03-05,2011,March,15,Saturday,Spring,Cloudy,205,122,83
2011-03-05,2011,March,16,Saturday,Spring,Cloudy,204,130,74
2011-03-05,2011,March,17,Saturday,Spring,Cloudy,164,104,60
2011-03-05,2011,March,18,Saturday,Spring,Cloudy,152,115,37
2011-03-05,2011,March,19,Saturday,Spring,Cloudy,89,62,27
2011-03-05,2011,March,20,Saturday,Spring,Cloudy,70,58,12
2011-03-05,2011,March,21,Saturday,Spring,Cloudy,72,60,12
2011-03-05,2011,March,22,Saturday,Spring,Cloudy,63,47,16
2011-03-05,2011,March,23,Saturday,Spring,Cloudy,44,34,10
2011-03-06,2011,March,0,Sunday,Spring,Cloudy,52,41,11
2011-03-06,2011,March,1,Sunday,Spring,Cloudy,39,27,12
2011-03-06,2011,March,2,Sunday,Spring,Cloudy,32,27,5
2011-03-06,2011,March,3,Sunday,Spring,Cloudy,11,9,2
2011-03-06,2011,March,4,Sunday,Spring,Cloudy,3,3,0
2011-03-06,2011,March,6,Sunday,Spring,Cloudy,2,1,1
2011-03-06,2011,March,7,Sunday,Spring,Light Snow/Rain,5,5,0
2011-03-06,2011,March,8,Sunday,Spring,Cloudy,9,8,1
2011-03-06,2011,March,9,Sunday,Spring,Cloudy,22,18,4
2011-03-06,2011,March,10,Sunday,Spring,Cloudy,31,27,4
2011-03-06,2011,March,11,Sunday,Spring,Cloudy,62,44,18
2011-03-06,2011,March,12,Sunday,Spring,Cloudy,79,69,10
2011-03-06,2011,March,13,Sunday,Spring,Cloudy,105,83,22
2011-03-06,2011,March,14,Sunday,Spring,Light Snow/Rain,39,27,12
2011-03-06,2011,March,15,Sunday,Spring,Light Snow/Rain,7,4,3
2011-03-06,2011,March,16,Sunday,Spring,Light Snow/Rain,11,8,3
2011-03-06,2011,March,17,Sunday,Spring,Light Snow/Rain,25,23,2
2011-03-06,2011,March,18,Sunday,Spring,Light Snow/Rain,23,23,0
2011-03-06,2011,March,19,Sunday,Spring,Light Snow/Rain,11,11,0
2011-03-06,2011,March,20,Sunday,Spring,Light Snow/Rain,11,8,3
2011-03-06,2011,March,21,Sunday,Spring,Light Snow/Rain,7,6,1
2011-03-06,2011,March,22,Sunday,Spring,Cloudy,10,10,0
2011-03-06,2011,March,23,Sunday,Spring,Cloudy,9,9,0
2011-03-07,2011,March,0,Monday,Spring,Light Snow/Rain,4,4,0
2011-03-07,2011,March,1,Monday,Spring,Light Snow/Rain,2,2,0
2011-03-07,2011,March,3,Monday,Spring,Clear,1,1,0
2011-03-07,2011,March,4,Monday,Spring,Clear,1,0,1
2011-03-07,2011,March,5,Monday,Spring,Clear,1,1,0
2011-03-07,2011,March,6,Monday,Spring,Clear,34,31,3
2011-03-07,2011,March,7,Monday,Spring,Clear,91,88,3
2011-03-07,2011,March,8,Monday,Spring,Clear,211,200,11
2011-03-07,2011,March,9,Monday,Spring,Clear,134,129,5
2011-03-07,2011,March,10,Monday,Spring,Clear,58,43,15
2011-03-07,2011,March,11,Monday,Spring,Clear,60,41,19
2011-03-07,2011,March,12,Monday,Spring,Clear,96,68,28
2011-03-07,2011,March,13,Monday,Spring,Clear,70,54,16
2011-03-07,2011,March,14,Monday,Spring,Clear,77,56,21
2011-03-07,2011,March,15,Monday,Spring,Clear,96,64,32
2011-03-07,2011,March,16,Monday,Spring,Clear,122,96,26
2011-03-07,2011,March,17,Monday,Spring,Clear,233,206,27
2011-03-07,2011,March,18,Monday,Spring,Clear,233,214,19
2011-03-07,2011,March,19,Monday,Spring,Clear,145,134,11
2011-03-07,2011,March,20,Monday,Spring,Clear,92,87,5
2011-03-07,2011,March,21,Monday,Spring,Clear,54,53,1
2011-03-07,2011,March,22,Monday,Spring,Clear,35,34,1
2011-03-07,2011,March,23,Monday,Spring,Clear,22,22,0
2011-03-08,2011,March,0,Tuesday,Spring,Clear,10,9,1
2011-03-08,2011,March,1,Tuesday,Spring,Clear,4,4,0
2011-03-08,2011,March,2,Tuesday,Spring,Clear,1,0,1
2011-03-08,2011,March,3,Tuesday,Spring,Clear,7,2,5
2011-03-08,2011,March,4,Tuesday,Spring,Clear,2,2,0
2011-03-08,2011,March,5,Tuesday,Spring,Clear,10,8,2
2011-03-08,2011,March,6,Tuesday,Spring,Clear,45,42,3
2011-03-08,2011,March,7,Tuesday,Spring,Clear,128,119,9
2011-03-08,2011,March,8,Tuesday,Spring,Clear,257,247,10
2011-03-08,2011,March,9,Tuesday,Spring,Clear,151,140,11
2011-03-08,2011,March,10,Tuesday,Spring,Cloudy,71,46,25
2011-03-08,2011,March,11,Tuesday,Spring,Cloudy,78,52,26
2011-03-08,2011,March,12,Tuesday,Spring,Cloudy,99,70,29
2011-03-08,2011,March,13,Tuesday,Spring,Cloudy,98,73,25
2011-03-08,2011,March,14,Tuesday,Spring,Cloudy,72,56,16
2011-03-08,2011,March,15,Tuesday,Spring,Cloudy,112,77,35
2011-03-08,2011,March,16,Tuesday,Spring,Clear,108,82,26
2011-03-08,2011,March,17,Tuesday,Spring,Clear,248,209,39
2011-03-08,2011,March,18,Tuesday,Spring,Clear,235,214,21
2011-03-08,2011,March,19,Tuesday,Spring,Clear,150,141,9
2011-03-08,2011,March,20,Tuesday,Spring,Clear,76,74,2
2011-03-08,2011,March,21,Tuesday,Spring,Clear,75,68,7
2011-03-08,2011,March,22,Tuesday,Spring,Clear,55,44,11
2011-03-08,2011,March,23,Tuesday,Spring,Clear,41,38,3
2011-03-09,2011,March,0,Wednesday,Spring,Clear,9,9,0
2011-03-09,2011,March,1,Wednesday,Spring,Clear,4,4,0
2011-03-09,2011,March,2,Wednesday,Spring,Clear,2,1,1
2011-03-09,2011,March,3,Wednesday,Spring,Clear,3,2,1
2011-03-09,2011,March,4,Wednesday,Spring,Clear,2,2,0
2011-03-09,2011,March,5,Wednesday,Spring,Cloudy,8,7,1
2011-03-09,2011,March,6,Wednesday,Spring,Cloudy,49,44,5
2011-03-09,2011,March,7,Wednesday,Spring,Cloudy,141,123,18
2011-03-09,2011,March,8,Wednesday,Spring,Cloudy,249,238,11
2011-03-09,2011,March,9,Wednesday,Spring,Cloudy,141,136,5
2011-03-09,2011,March,10,Wednesday,Spring,Cloudy,57,49,8
2011-03-09,2011,March,11,Wednesday,Spring,Cloudy,59,44,15
2011-03-09,2011,March,12,Wednesday,Spring,Cloudy,98,84,14
2011-03-09,2011,March,13,Wednesday,Spring,Cloudy,99,82,17
2011-03-09,2011,March,14,Wednesday,Spring,Cloudy,71,61,10
2011-03-09,2011,March,15,Wednesday,Spring,Cloudy,79,64,15
2011-03-09,2011,March,16,Wednesday,Spring,Cloudy,112,102,10
2011-03-09,2011,March,17,Wednesday,Spring,Cloudy,194,176,18
2011-03-09,2011,March,18,Wednesday,Spring,Cloudy,188,176,12
2011-03-09,2011,March,19,Wednesday,Spring,Cloudy,134,123,11
2011-03-09,2011,March,20,Wednesday,Spring,Cloudy,91,87,4
2011-03-09,2011,March,21,Wednesday,Spring,Cloudy,62,52,10
2011-03-09,2011,March,22,Wednesday,Spring,Light Snow/Rain,21,17,4
2011-03-09,2011,March,23,Wednesday,Spring,Light Snow/Rain,18,17,1
2011-03-10,2011,March,0,Thursday,Spring,Light Snow/Rain,3,0,3
2011-03-10,2011,March,1,Thursday,Spring,Light Snow/Rain,2,2,0
2011-03-10,2011,March,2,Thursday,Spring,Light Snow/Rain,1,1,0
2011-03-10,2011,March,5,Thursday,Spring,Light Snow/Rain,3,2,1
2011-03-10,2011,March,6,Thursday,Spring,Light Snow/Rain,12,12,0
2011-03-10,2011,March,7,Thursday,Spring,Light Snow/Rain,37,36,1
2011-03-10,2011,March,8,Thursday,Spring,Light Snow/Rain,44,43,1
2011-03-10,2011,March,9,Thursday,Spring,Light Snow/Rain,24,23,1
2011-03-10,2011,March,10,Thursday,Spring,Light Snow/Rain,17,17,0
2011-03-10,2011,March,11,Thursday,Spring,Light Snow/Rain,11,5,6
2011-03-10,2011,March,12,Thursday,Spring,Light Snow/Rain,34,30,4
2011-03-10,2011,March,13,Thursday,Spring,Light Snow/Rain,12,11,1
2011-03-10,2011,March,14,Thursday,Spring,Light Snow/Rain,12,12,0
2011-03-10,2011,March,15,Thursday,Spring,Light Snow/Rain,14,11,3
2011-03-10,2011,March,16,Thursday,Spring,Light Snow/Rain,21,20,1
2011-03-10,2011,March,17,Thursday,Spring,Cloudy,111,109,2
2011-03-10,2011,March,18,Thursday,Spring,Light Snow/Rain,82,80,2
2011-03-10,2011,March,19,Thursday,Spring,Light Snow/Rain,56,51,5
2011-03-10,2011,March,20,Thursday,Spring,Light Snow/Rain,38,29,9
2011-03-10,2011,March,21,Thursday,Spring,Light Snow/Rain,28,27,1
2011-03-10,2011,March,22,Thursday,Spring,Cloudy,34,30,4
2011-03-10,2011,March,23,Thursday,Spring,Light Snow/Rain,27,26,1
2011-03-11,2011,March,0,Friday,Spring,Cloudy,6,6,0
2011-03-11,2011,March,1,Friday,Spring,Light Snow/Rain,8,8,0
2011-03-11,2011,March,2,Friday,Spring,Light Snow/Rain,5,3,2
2011-03-11,2011,March,3,Friday,Spring,Cloudy,2,2,0
2011-03-11,2011,March,5,Friday,Spring,Clear,7,6,1
2011-03-11,2011,March,6,Friday,Spring,Clear,32,31,1
2011-03-11,2011,March,7,Friday,Spring,Clear,114,104,10
2011-03-11,2011,March,8,Friday,Spring,Clear,259,244,15
2011-03-11,2011,March,9,Friday,Spring,Cloudy,156,143,13
2011-03-11,2011,March,10,Friday,Spring,Cloudy,78,60,18
2011-03-11,2011,March,11,Friday,Spring,Cloudy,81,67,14
2011-03-11,2011,March,12,Friday,Spring,Cloudy,111,96,15
2011-03-11,2011,March,13,Friday,Spring,Clear,107,92,15
2011-03-11,2011,March,14,Friday,Spring,Cloudy,89,64,25
2011-03-11,2011,March,15,Friday,Spring,Cloudy,85,64,21
2011-03-11,2011,March,16,Friday,Spring,Cloudy,113,95,18
2011-03-11,2011,March,17,Friday,Spring,Clear,223,200,23
2011-03-11,2011,March,18,Friday,Spring,Clear,153,134,19
2011-03-11,2011,March,19,Friday,Spring,Clear,118,111,7
2011-03-11,2011,March,20,Friday,Spring,Clear,76,70,6
2011-03-11,2011,March,21,Friday,Spring,Cloudy,53,43,10
2011-03-11,2011,March,22,Friday,Spring,Clear,64,53,11
2011-03-11,2011,March,23,Friday,Spring,Clear,37,34,3
2011-03-12,2011,March,0,Saturday,Spring,Clear,34,30,4
2011-03-12,2011,March,1,Saturday,Spring,Clear,18,15,3
2011-03-12,2011,March,2,Saturday,Spring,Clear,14,14,0
2011-03-12,2011,March,3,Saturday,Spring,Clear,7,6,1
2011-03-12,2011,March,4,Saturday,Spring,Clear,1,1,0
2011-03-12,2011,March,5,Saturday,Spring,Clear,2,2,0
2011-03-12,2011,March,6,Saturday,Spring,Clear,4,2,2
2011-03-12,2011,March,7,Saturday,Spring,Clear,23,19,4
2011-03-12,2011,March,8,Saturday,Spring,Clear,53,44,9
2011-03-12,2011,March,9,Saturday,Spring,Clear,101,76,25
2011-03-12,2011,March,10,Saturday,Spring,Clear,99,78,21
2011-03-12,2011,March,11,Saturday,Spring,Clear,119,83,36
2011-03-12,2011,March,12,Saturday,Spring,Clear,158,107,51
2011-03-12,2011,March,13,Saturday,Spring,Clear,157,95,62
2011-03-12,2011,March,14,Saturday,Spring,Clear,166,96,70
2011-03-12,2011,March,15,Saturday,Spring,Clear,182,101,81
2011-03-12,2011,March,16,Saturday,Spring,Clear,244,144,100
2011-03-12,2011,March,17,Saturday,Spring,Clear,213,114,99
2011-03-12,2011,March,18,Saturday,Spring,Clear,145,91,54
2011-03-12,2011,March,19,Saturday,Spring,Clear,112,86,26
2011-03-12,2011,March,20,Saturday,Spring,Clear,86,64,22
2011-03-12,2011,March,21,Saturday,Spring,Clear,82,46,36
2011-03-12,2011,March,22,Saturday,Spring,Clear,63,56,7
2011-03-12,2011,March,23,Saturday,Spring,Clear,49,38,11
2011-03-13,2011,March,0,Sunday,Spring,Clear,38,35,3
2011-03-13,2011,March,1,Sunday,Spring,Clear,33,23,10
2011-03-13,2011,March,3,Sunday,Spring,Clear,23,17,6
2011-03-13,2011,March,4,Sunday,Spring,Clear,13,9,4
2011-03-13,2011,March,5,Sunday,Spring,Clear,3,3,0
2011-03-13,2011,March,6,Sunday,Spring,Clear,2,2,0
2011-03-13,2011,March,7,Sunday,Spring,Clear,10,8,2
2011-03-13,2011,March,8,Sunday,Spring,Clear,34,23,11
2011-03-13,2011,March,9,Sunday,Spring,Clear,44,36,8
2011-03-13,2011,March,10,Sunday,Spring,Clear,122,86,36
2011-03-13,2011,March,11,Sunday,Spring,Clear,181,93,88
2011-03-13,2011,March,12,Sunday,Spring,Clear,194,120,74
2011-03-13,2011,March,13,Sunday,Spring,Clear,221,124,97
2011-03-13,2011,March,14,Sunday,Spring,Clear,250,106,144
2011-03-13,2011,March,15,Sunday,Spring,Clear,304,155,149
2011-03-13,2011,March,16,Sunday,Spring,Clear,256,132,124
2011-03-13,2011,March,17,Sunday,Spring,Clear,241,143,98
2011-03-13,2011,March,18,Sunday,Spring,Clear,147,92,55
2011-03-13,2011,March,19,Sunday,Spring,Clear,101,73,28
2011-03-13,2011,March,20,Sunday,Spring,Clear,77,54,23
2011-03-13,2011,March,21,Sunday,Spring,Clear,58,49,9
2011-03-13,2011,March,22,Sunday,Spring,Clear,37,29,8
2011-03-13,2011,March,23,Sunday,Spring,Clear,28,23,5
2011-03-14,2011,March,0,Monday,Spring,Clear,11,7,4
2011-03-14,2011,March,1,Monday,Spring,Clear,1,1,0
2011-03-14,2011,March,2,Monday,Spring,Clear,1,1,0
2011-03-14,2011,March,3,Monday,Spring,Clear,3,3,0
2011-03-14,2011,March,5,Monday,Spring,Clear,8,8,0
2011-03-14,2011,March,6,Monday,Spring,Clear,28,27,1
2011-03-14,2011,March,7,Monday,Spring,Cloudy,88,84,4
2011-03-14,2011,March,8,Monday,Spring,Cloudy,241,217,24
2011-03-14,2011,March,9,Monday,Spring,Clear,140,127,13
2011-03-14,2011,March,10,Monday,Spring,Clear,84,57,27
2011-03-14,2011,March,11,Monday,Spring,Clear,71,45,26
2011-03-14,2011,March,12,Monday,Spring,Clear,94,54,40
2011-03-14,2011,March,13,Monday,Spring,Clear,75,51,24
2011-03-14,2011,March,14,Monday,Spring,Cloudy,79,52,27
2011-03-14,2011,March,15,Monday,Spring,Clear,101,77,24
2011-03-14,2011,March,16,Monday,Spring,Clear,107,80,27
2011-03-14,2011,March,17,Monday,Spring,Clear,271,229,42
2011-03-14,2011,March,18,Monday,Spring,Clear,235,210,25
2011-03-14,2011,March,19,Monday,Spring,Clear,150,133,17
2011-03-14,2011,March,20,Monday,Spring,Clear,129,106,23
2011-03-14,2011,March,21,Monday,Spring,Clear,63,58,5
2011-03-14,2011,March,22,Monday,Spring,Clear,47,43,4
2011-03-14,2011,March,23,Monday,Spring,Clear,19,17,2
2011-03-15,2011,March,0,Tuesday,Spring,Clear,14,7,7
2011-03-15,2011,March,1,Tuesday,Spring,Clear,10,6,4
2011-03-15,2011,March,2,Tuesday,Spring,Clear,3,2,1
2011-03-15,2011,March,4,Tuesday,Spring,Clear,2,1,1
2011-03-15,2011,March,5,Tuesday,Spring,Clear,11,11,0
2011-03-15,2011,March,6,Tuesday,Spring,Clear,35,32,3
2011-03-15,2011,March,7,Tuesday,Spring,Clear,119,109,10
2011-03-15,2011,March,8,Tuesday,Spring,Clear,282,259,23
2011-03-15,2011,March,9,Tuesday,Spring,Cloudy,157,147,10
2011-03-15,2011,March,10,Tuesday,Spring,Cloudy,78,56,22
2011-03-15,2011,March,11,Tuesday,Spring,Cloudy,78,51,27
2011-03-15,2011,March,12,Tuesday,Spring,Cloudy,102,70,32
2011-03-15,2011,March,13,Tuesday,Spring,Cloudy,97,74,23
2011-03-15,2011,March,14,Tuesday,Spring,Cloudy,88,74,14
2011-03-15,2011,March,15,Tuesday,Spring,Cloudy,90,66,24
2011-03-15,2011,March,16,Tuesday,Spring,Cloudy,114,93,21
2011-03-15,2011,March,17,Tuesday,Spring,Cloudy,217,195,22
2011-03-15,2011,March,18,Tuesday,Spring,Cloudy,225,207,18
2011-03-15,2011,March,19,Tuesday,Spring,Cloudy,152,138,14
2011-03-15,2011,March,20,Tuesday,Spring,Cloudy,88,79,9
2011-03-15,2011,March,21,Tuesday,Spring,Light Snow/Rain,55,53,2
2011-03-15,2011,March,22,Tuesday,Spring,Cloudy,21,20,1
2011-03-15,2011,March,23,Tuesday,Spring,Cloudy,18,17,1
2011-03-16,2011,March,0,Wednesday,Spring,Light Snow/Rain,8,8,0
2011-03-16,2011,March,1,Wednesday,Spring,Light Snow/Rain,3,2,1
2011-03-16,2011,March,3,Wednesday,Spring,Cloudy,3,2,1
2011-03-16,2011,March,4,Wednesday,Spring,Cloudy,1,1,0
2011-03-16,2011,March,5,Wednesday,Spring,Cloudy,3,3,0
2011-03-16,2011,March,6,Wednesday,Spring,Cloudy,31,30,1
2011-03-16,2011,March,7,Wednesday,Spring,Cloudy,111,101,10
2011-03-16,2011,March,8,Wednesday,Spring,Cloudy,253,227,26
2011-03-16,2011,March,9,Wednesday,Spring,Cloudy,154,144,10
2011-03-16,2011,March,10,Wednesday,Spring,Cloudy,68,49,19
2011-03-16,2011,March,11,Wednesday,Spring,Cloudy,75,62,13
2011-03-16,2011,March,12,Wednesday,Spring,Cloudy,88,65,23
2011-03-16,2011,March,13,Wednesday,Spring,Cloudy,99,81,18
2011-03-16,2011,March,14,Wednesday,Spring,Cloudy,100,67,33
2011-03-16,2011,March,15,Wednesday,Spring,Cloudy,101,79,22
2011-03-16,2011,March,16,Wednesday,Spring,Cloudy,151,121,30
2011-03-16,2011,March,17,Wednesday,Spring,Cloudy,253,216,37
2011-03-16,2011,March,18,Wednesday,Spring,Cloudy,237,211,26
2011-03-16,2011,March,19,Wednesday,Spring,Cloudy,168,150,18
2011-03-16,2011,March,20,Wednesday,Spring,Cloudy,121,111,10
2011-03-16,2011,March,21,Wednesday,Spring,Cloudy,78,75,3
2011-03-16,2011,March,22,Wednesday,Spring,Cloudy,59,48,11
2011-03-16,2011,March,23,Wednesday,Spring,Clear,27,18,9
2011-03-17,2011,March,0,Thursday,Spring,Clear,23,19,4
2011-03-17,2011,March,1,Thursday,Spring,Clear,12,11,1
2011-03-17,2011,March,2,Thursday,Spring,Clear,8,5,3
2011-03-17,2011,March,3,Thursday,Spring,Clear,2,1,1
2011-03-17,2011,March,4,Thursday,Spring,Clear,3,3,0
2011-03-17,2011,March,5,Thursday,Spring,Clear,13,13,0
2011-03-17,2011,March,6,Thursday,Spring,Clear,51,47,4
2011-03-17,2011,March,7,Thursday,Spring,Clear,140,128,12
2011-03-17,2011,March,8,Thursday,Spring,Clear,299,282,17
2011-03-17,2011,March,9,Thursday,Spring,Clear,185,162,23
2011-03-17,2011,March,10,Thursday,Spring,Clear,78,69,9
2011-03-17,2011,March,11,Thursday,Spring,Clear,86,66,20
2011-03-17,2011,March,12,Thursday,Spring,Clear,105,81,24
2011-03-17,2011,March,13,Thursday,Spring,Cloudy,111,85,26
2011-03-17,2011,March,14,Thursday,Spring,Clear,119,87,32
2011-03-17,2011,March,15,Thursday,Spring,Clear,125,95,30
2011-03-17,2011,March,16,Thursday,Spring,Clear,142,108,34
2011-03-17,2011,March,17,Thursday,Spring,Clear,313,265,48
2011-03-17,2011,March,18,Thursday,Spring,Cloudy,310,260,50
2011-03-17,2011,March,19,Thursday,Spring,Clear,207,189,18
2011-03-17,2011,March,20,Thursday,Spring,Clear,137,112,25
2011-03-17,2011,March,21,Thursday,Spring,Clear,138,119,19
2011-03-17,2011,March,22,Thursday,Spring,Clear,87,70,17
2011-03-17,2011,March,23,Thursday,Spring,Clear,50,43,7
2011-03-18,2011,March,0,Friday,Spring,Clear,29,24,5
2011-03-18,2011,March,1,Friday,Spring,Clear,16,12,4
2011-03-18,2011,March,2,Friday,Spring,Clear,14,9,5
2011-03-18,2011,March,3,Friday,Spring,Clear,5,4,1
2011-03-18,2011,March,5,Friday,Spring,Clear,10,8,2
2011-03-18,2011,March,6,Friday,Spring,Clear,36,35,1
2011-03-18,2011,March,7,Friday,Spring,Clear,123,112,11
2011-03-18,2011,March,8,Friday,Spring,Clear,280,256,24
2011-03-18,2011,March,9,Friday,Spring,Clear,210,192,18
2011-03-18,2011,March,10,Friday,Spring,Clear,117,74,43
2011-03-18,2011,March,11,Friday,Spring,Clear,159,104,55
2011-03-18,2011,March,12,Friday,Spring,Cloudy,195,123,72
2011-03-18,2011,March,13,Friday,Spring,Clear,175,118,57
2011-03-18,2011,March,14,Friday,Spring,Clear,174,103,71
2011-03-18,2011,March,15,Friday,Spring,Cloudy,173,111,62
2011-03-18,2011,March,16,Friday,Spring,Clear,204,137,67
2011-03-18,2011,March,17,Friday,Spring,Clear,332,237,95
2011-03-18,2011,March,18,Friday,Spring,Clear,331,247,84
2011-03-18,2011,March,19,Friday,Spring,Clear,190,132,58
2011-03-18,2011,March,20,Friday,Spring,Clear,149,103,46
2011-03-18,2011,March,21,Friday,Spring,Clear,113,91,22
2011-03-18,2011,March,22,Friday,Spring,Clear,118,63,55
2011-03-18,2011,March,23,Friday,Spring,Cloudy,86,60,26
2011-03-19,2011,March,0,Saturday,Spring,Cloudy,76,50,26
2011-03-19,2011,March,1,Saturday,Spring,Cloudy,51,35,16
2011-03-19,2011,March,2,Saturday,Spring,Cloudy,25,20,5
2011-03-19,2011,March,3,Saturday,Spring,Cloudy,8,7,1
2011-03-19,2011,March,4,Saturday,Spring,Clear,3,2,1
2011-03-19,2011,March,5,Saturday,Spring,Clear,2,2,0
2011-03-19,2011,March,6,Saturday,Spring,Clear,10,10,0
2011-03-19,2011,March,7,Saturday,Spring,Clear,13,9,4
2011-03-19,2011,March,8,Saturday,Spring,Clear,48,37,11
2011-03-19,2011,March,9,Saturday,Spring,Clear,76,41,35
2011-03-19,2011,March,10,Saturday,Spring,Clear,140,85,55
2011-03-19,2011,March,11,Saturday,Spring,Clear,196,106,90
2011-03-19,2011,March,12,Saturday,Spring,Clear,267,141,126
2011-03-19,2011,March,13,Saturday,Spring,Clear,301,127,174
2011-03-19,2011,March,14,Saturday,Spring,Clear,312,144,168
2011-03-19,2011,March,15,Saturday,Spring,Clear,313,143,170
2011-03-19,2011,March,16,Saturday,Spring,Clear,304,129,175
2011-03-19,2011,March,17,Saturday,Spring,Clear,278,140,138
2011-03-19,2011,March,18,Saturday,Spring,Clear,217,125,92
2011-03-19,2011,March,19,Saturday,Spring,Clear,154,116,38
2011-03-19,2011,March,20,Saturday,Spring,Clear,108,69,39
2011-03-19,2011,March,21,Saturday,Spring,Clear,93,73,20
2011-03-19,2011,March,22,Saturday,Spring,Clear,72,45,27
2011-03-19,2011,March,23,Saturday,Spring,Clear,50,37,13
2011-03-20,2011,March,0,Sunday,Spring,Clear,40,33,7
2011-03-20,2011,March,1,Sunday,Spring,Clear,24,22,2
2011-03-20,2011,March,2,Sunday,Spring,Clear,30,24,6
2011-03-20,2011,March,3,Sunday,Spring,Clear,12,11,1
2011-03-20,2011,March,4,Sunday,Spring,Clear,3,1,2
2011-03-20,2011,March,5,Sunday,Spring,Clear,9,6,3
2011-03-20,2011,March,6,Sunday,Spring,Clear,4,3,1
2011-03-20,2011,March,7,Sunday,Spring,Clear,14,9,5
2011-03-20,2011,March,8,Sunday,Spring,Clear,37,30,7
2011-03-20,2011,March,9,Sunday,Spring,Clear,78,43,35
2011-03-20,2011,March,10,Sunday,Spring,Cloudy,136,81,55
2011-03-20,2011,March,11,Sunday,Spring,Clear,203,111,92
2011-03-20,2011,March,12,Sunday,Spring,Clear,228,108,120
2011-03-20,2011,March,13,Sunday,Spring,Clear,203,115,88
2011-03-20,2011,March,14,Sunday,Spring,Clear,279,134,145
2011-03-20,2011,March,15,Sunday,Spring,Clear,308,136,172
2011-03-20,2011,March,16,Sunday,Spring,Clear,224,132,92
2011-03-20,2011,March,17,Sunday,Spring,Clear,226,143,83
2011-03-20,2011,March,18,Sunday,Spring,Clear,156,98,58
2011-03-20,2011,March,19,Sunday,Spring,Clear,79,58,21
2011-03-20,2011,March,20,Sunday,Spring,Clear,67,46,21
2011-03-20,2011,March,21,Sunday,Spring,Cloudy,49,39,10
2011-03-20,2011,March,22,Sunday,Spring,Cloudy,38,30,8
2011-03-20,2011,March,23,Sunday,Spring,Light Snow/Rain,24,11,13
2011-03-21,2011,March,0,Monday,Summer,Light Snow/Rain,13,11,2
2011-03-21,2011,March,1,Monday,Summer,Cloudy,7,6,1
2011-03-21,2011,March,2,Monday,Summer,Cloudy,6,5,1
2011-03-21,2011,March,3,Monday,Summer,Cloudy,1,1,0
2011-03-21,2011,March,5,Monday,Summer,Clear,2,1,1
2011-03-21,2011,March,6,Monday,Summer,Light Snow/Rain,32,30,2
2011-03-21,2011,March,7,Monday,Summer,Light Snow/Rain,18,15,3
2011-03-21,2011,March,8,Monday,Summer,Cloudy,98,95,3
2011-03-21,2011,March,9,Monday,Summer,Cloudy,127,115,12
2011-03-21,2011,March,10,Monday,Summer,Cloudy,62,45,17
2011-03-21,2011,March,11,Monday,Summer,Cloudy,79,47,32
2011-03-21,2011,March,12,Monday,Summer,Cloudy,81,56,25
2011-03-21,2011,March,13,Monday,Summer,Cloudy,112,77,35
2011-03-21,2011,March,14,Monday,Summer,Cloudy,101,65,36
2011-03-21,2011,March,15,Monday,Summer,Cloudy,107,66,41
2011-03-21,2011,March,16,Monday,Summer,Cloudy,141,112,29
2011-03-21,2011,March,17,Monday,Summer,Cloudy,272,231,41
2011-03-21,2011,March,18,Monday,Summer,Cloudy,276,232,44
2011-03-21,2011,March,19,Monday,Summer,Clear,221,199,22
2011-03-21,2011,March,20,Monday,Summer,Clear,122,106,16
2011-03-21,2011,March,21,Monday,Summer,Clear,91,79,12
2011-03-21,2011,March,22,Monday,Summer,Clear,78,60,18
2011-03-21,2011,March,23,Monday,Summer,Clear,30,22,8
2011-03-22,2011,March,0,Tuesday,Summer,Clear,11,7,4
2011-03-22,2011,March,1,Tuesday,Summer,Clear,19,13,6
2011-03-22,2011,March,2,Tuesday,Summer,Clear,1,1,0
2011-03-22,2011,March,3,Tuesday,Summer,Clear,5,2,3
2011-03-22,2011,March,4,Tuesday,Summer,Cloudy,1,1,0
2011-03-22,2011,March,5,Tuesday,Summer,Cloudy,12,11,1
2011-03-22,2011,March,6,Tuesday,Summer,Clear,60,58,2
2011-03-22,2011,March,7,Tuesday,Summer,Cloudy,136,132,4
2011-03-22,2011,March,8,Tuesday,Summer,Cloudy,336,312,24
2011-03-22,2011,March,9,Tuesday,Summer,Cloudy,178,159,19
2011-03-22,2011,March,10,Tuesday,Summer,Cloudy,124,95,29
2011-03-22,2011,March,11,Tuesday,Summer,Clear,86,64,22
2011-03-22,2011,March,12,Tuesday,Summer,Clear,121,86,35
2011-03-22,2011,March,13,Tuesday,Summer,Clear,106,85,21
2011-03-22,2011,March,14,Tuesday,Summer,Clear,101,71,30
2011-03-22,2011,March,15,Tuesday,Summer,Clear,134,79,55
2011-03-22,2011,March,16,Tuesday,Summer,Clear,165,125,40
2011-03-22,2011,March,17,Tuesday,Summer,Clear,307,265,42
2011-03-22,2011,March,18,Tuesday,Summer,Clear,312,271,41
2011-03-22,2011,March,19,Tuesday,Summer,Cloudy,164,142,22
2011-03-22,2011,March,20,Tuesday,Summer,Cloudy,135,116,19
2011-03-22,2011,March,21,Tuesday,Summer,Cloudy,87,63,24
2011-03-22,2011,March,22,Tuesday,Summer,Cloudy,70,57,13
2011-03-22,2011,March,23,Tuesday,Summer,Cloudy,32,28,4
2011-03-23,2011,March,0,Wednesday,Summer,Light Snow/Rain,11,8,3
2011-03-23,2011,March,1,Wednesday,Summer,Light Snow/Rain,7,7,0
2011-03-23,2011,March,2,Wednesday,Summer,Light Snow/Rain,2,1,1
2011-03-23,2011,March,3,Wednesday,Summer,Cloudy,3,3,0
2011-03-23,2011,March,5,Wednesday,Summer,Light Snow/Rain,10,10,0
2011-03-23,2011,March,6,Wednesday,Summer,Cloudy,44,43,1
2011-03-23,2011,March,7,Wednesday,Summer,Cloudy,118,111,7
2011-03-23,2011,March,8,Wednesday,Summer,Cloudy,261,247,14
2011-03-23,2011,March,9,Wednesday,Summer,Cloudy,182,174,8
2011-03-23,2011,March,10,Wednesday,Summer,Cloudy,75,60,15
2011-03-23,2011,March,11,Wednesday,Summer,Cloudy,71,53,18
2011-03-23,2011,March,12,Wednesday,Summer,Cloudy,87,73,14
2011-03-23,2011,March,13,Wednesday,Summer,Light Snow/Rain,108,94,14
2011-03-23,2011,March,14,Wednesday,Summer,Cloudy,84,71,13
2011-03-23,2011,March,15,Wednesday,Summer,Cloudy,85,74,11
2011-03-23,2011,March,16,Wednesday,Summer,Cloudy,136,123,13
2011-03-23,2011,March,17,Wednesday,Summer,Cloudy,273,245,28
2011-03-23,2011,March,18,Wednesday,Summer,Light Snow/Rain,238,218,20
2011-03-23,2011,March,19,Wednesday,Summer,Light Snow/Rain,159,147,12
2011-03-23,2011,March,20,Wednesday,Summer,Light Snow/Rain,75,72,3
2011-03-23,2011,March,21,Wednesday,Summer,Light Snow/Rain,22,22,0
2011-03-23,2011,March,22,Wednesday,Summer,Cloudy,44,38,6
2011-03-23,2011,March,23,Wednesday,Summer,Light Snow/Rain,26,24,2
2011-03-24,2011,March,0,Thursday,Summer,Cloudy,11,11,0
2011-03-24,2011,March,1,Thursday,Summer,Cloudy,3,3,0
2011-03-24,2011,March,2,Thursday,Summer,Cloudy,6,6,0
2011-03-24,2011,March,3,Thursday,Summer,Cloudy,1,0,1
2011-03-24,2011,March,4,Thursday,Summer,Cloudy,1,1,0
2011-03-24,2011,March,5,Thursday,Summer,Cloudy,9,8,1
2011-03-24,2011,March,6,Thursday,Summer,Cloudy,41,41,0
2011-03-24,2011,March,7,Thursday,Summer,Light Snow/Rain,108,106,2
2011-03-24,2011,March,8,Thursday,Summer,Light Snow/Rain,124,120,4
2011-03-24,2011,March,9,Thursday,Summer,Cloudy,97,94,3
2011-03-24,2011,March,10,Thursday,Summer,Cloudy,65,55,10
2011-03-24,2011,March,11,Thursday,Summer,Cloudy,71,61,10
2011-03-24,2011,March,12,Thursday,Summer,Cloudy,94,82,12
2011-03-24,2011,March,13,Thursday,Summer,Cloudy,101,90,11
2011-03-24,2011,March,14,Thursday,Summer,Cloudy,83,66,17
2011-03-24,2011,March,15,Thursday,Summer,Cloudy,90,77,13
2011-03-24,2011,March,16,Thursday,Summer,Cloudy,84,78,6
2011-03-24,2011,March,17,Thursday,Summer,Cloudy,233,221,12
2011-03-24,2011,March,18,Thursday,Summer,Cloudy,214,197,17
2011-03-24,2011,March,19,Thursday,Summer,Clear,138,122,16
2011-03-24,2011,March,20,Thursday,Summer,Clear,118,110,8
2011-03-24,2011,March,21,Thursday,Summer,Clear,78,67,11
2011-03-24,2011,March,22,Thursday,Summer,Clear,62,59,3
2011-03-24,2011,March,23,Thursday,Summer,Clear,33,24,9
2011-03-25,2011,March,0,Friday,Summer,Clear,18,17,1
2011-03-25,2011,March,1,Friday,Summer,Clear,5,5,0
2011-03-25,2011,March,2,Friday,Summer,Clear,5,5,0
2011-03-25,2011,March,3,Friday,Summer,Clear,2,2,0
2011-03-25,2011,March,4,Friday,Summer,Clear,5,2,3
2011-03-25,2011,March,5,Friday,Summer,Clear,9,9,0
2011-03-25,2011,March,6,Friday,Summer,Clear,32,32,0
2011-03-25,2011,March,7,Friday,Summer,Clear,104,100,4
2011-03-25,2011,March,8,Friday,Summer,Clear,237,228,9
2011-03-25,2011,March,9,Friday,Summer,Clear,166,150,16
2011-03-25,2011,March,10,Friday,Summer,Clear,68,53,15
2011-03-25,2011,March,11,Friday,Summer,Clear,75,58,17
2011-03-25,2011,March,12,Friday,Summer,Clear,145,108,37
2011-03-25,2011,March,13,Friday,Summer,Clear,138,104,34
2011-03-25,2011,March,14,Friday,Summer,Clear,133,103,30
2011-03-25,2011,March,15,Friday,Summer,Cloudy,122,79,43
2011-03-25,2011,March,16,Friday,Summer,Cloudy,150,127,23
2011-03-25,2011,March,17,Friday,Summer,Cloudy,225,202,23
2011-03-25,2011,March,18,Friday,Summer,Clear,198,190,8
2011-03-25,2011,March,19,Friday,Summer,Cloudy,135,126,9
2011-03-25,2011,March,20,Friday,Summer,Cloudy,81,75,6
2011-03-25,2011,March,21,Friday,Summer,Cloudy,75,64,11
2011-03-25,2011,March,22,Friday,Summer,Cloudy,43,40,3
2011-03-25,2011,March,23,Friday,Summer,Cloudy,39,31,8
2011-03-26,2011,March,0,Saturday,Summer,Cloudy,28,25,3
2011-03-26,2011,March,1,Saturday,Summer,Clear,27,24,3
2011-03-26,2011,March,2,Saturday,Summer,Clear,25,21,4
2011-03-26,2011,March,3,Saturday,Summer,Clear,9,7,2
2011-03-26,2011,March,4,Saturday,Summer,Clear,6,4,2
2011-03-26,2011,March,5,Saturday,Summer,Clear,8,8,0
2011-03-26,2011,March,6,Saturday,Summer,Clear,10,8,2
2011-03-26,2011,March,7,Saturday,Summer,Clear,41,23,18
2011-03-26,2011,March,8,Saturday,Summer,Clear,66,42,24
2011-03-26,2011,March,9,Saturday,Summer,Clear,100,68,32
2011-03-26,2011,March,10,Saturday,Summer,Clear,125,93,32
2011-03-26,2011,March,11,Saturday,Summer,Clear,168,93,75
2011-03-26,2011,March,12,Saturday,Summer,Clear,227,129,98
2011-03-26,2011,March,13,Saturday,Summer,Clear,239,145,94
2011-03-26,2011,March,14,Saturday,Summer,Clear,216,123,93
2011-03-26,2011,March,15,Saturday,Summer,Clear,219,109,110
2011-03-26,2011,March,16,Saturday,Summer,Clear,248,130,118
2011-03-26,2011,March,17,Saturday,Summer,Clear,203,101,102
2011-03-26,2011,March,18,Saturday,Summer,Cloudy,153,89,64
2011-03-26,2011,March,19,Saturday,Summer,Cloudy,138,93,45
2011-03-26,2011,March,20,Saturday,Summer,Cloudy,85,67,18
2011-03-26,2011,March,21,Saturday,Summer,Cloudy,51,36,15
2011-03-26,2011,March,22,Saturday,Summer,Cloudy,63,46,17
2011-03-26,2011,March,23,Saturday,Summer,Cloudy,41,31,10
2011-03-27,2011,March,0,Sunday,Summer,Cloudy,31,26,5
2011-03-27,2011,March,1,Sunday,Summer,Cloudy,20,17,3
2011-03-27,2011,March,2,Sunday,Summer,Light Snow/Rain,21,15,6
2011-03-27,2011,March,3,Sunday,Summer,Light Snow/Rain,14,14,0
2011-03-27,2011,March,4,Sunday,Summer,Light Snow/Rain,6,5,1
2011-03-27,2011,March,6,Sunday,Summer,Light Snow/Rain,2,2,0
2011-03-27,2011,March,7,Sunday,Summer,Light Snow/Rain,7,7,0
2011-03-27,2011,March,8,Sunday,Summer,Clear,14,8,6
2011-03-27,2011,March,9,Sunday,Summer,Clear,54,37,17
2011-03-27,2011,March,10,Sunday,Summer,Cloudy,86,59,27
2011-03-27,2011,March,11,Sunday,Summer,Cloudy,108,85,23
2011-03-27,2011,March,12,Sunday,Summer,Cloudy,163,120,43
2011-03-27,2011,March,13,Sunday,Summer,Clear,147,100,47
2011-03-27,2011,March,14,Sunday,Summer,Clear,164,103,61
2011-03-27,2011,March,15,Sunday,Summer,Clear,172,111,61
2011-03-27,2011,March,16,Sunday,Summer,Clear,143,98,45
2011-03-27,2011,March,17,Sunday,Summer,Clear,159,109,50
2011-03-27,2011,March,18,Sunday,Summer,Clear,137,105,32
2011-03-27,2011,March,19,Sunday,Summer,Clear,103,80,23
2011-03-27,2011,March,20,Sunday,Summer,Clear,57,50,7
2011-03-27,2011,March,21,Sunday,Summer,Clear,36,29,7
2011-03-27,2011,March,22,Sunday,Summer,Clear,30,25,5
2011-03-27,2011,March,23,Sunday,Summer,Clear,19,16,3
2011-03-28,2011,March,0,Monday,Summer,Clear,12,11,1
2011-03-28,2011,March,1,Monday,Summer,Clear,6,4,2
2011-03-28,2011,March,2,Monday,Summer,Clear,5,5,0
2011-03-28,2011,March,3,Monday,Summer,Clear,2,2,0
2011-03-28,2011,March,5,Monday,Summer,Clear,8,8,0
2011-03-28,2011,March,6,Monday,Summer,Clear,40,40,0
2011-03-28,2011,March,7,Monday,Summer,Clear,110,104,6
2011-03-28,2011,March,8,Monday,Summer,Clear,254,239,15
2011-03-28,2011,March,9,Monday,Summer,Cloudy,121,109,12
2011-03-28,2011,March,10,Monday,Summer,Clear,69,47,22
2011-03-28,2011,March,11,Monday,Summer,Cloudy,57,39,18
2011-03-28,2011,March,12,Monday,Summer,Cloudy,79,71,8
2011-03-28,2011,March,13,Monday,Summer,Cloudy,83,69,14
2011-03-28,2011,March,14,Monday,Summer,Clear,80,65,15
2011-03-28,2011,March,15,Monday,Summer,Clear,72,53,19
2011-03-28,2011,March,16,Monday,Summer,Clear,132,117,15
2011-03-28,2011,March,17,Monday,Summer,Clear,252,227,25
2011-03-28,2011,March,18,Monday,Summer,Clear,241,220,21
2011-03-28,2011,March,19,Monday,Summer,Clear,173,156,17
2011-03-28,2011,March,20,Monday,Summer,Clear,112,107,5
2011-03-28,2011,March,21,Monday,Summer,Clear,61,55,6
2011-03-28,2011,March,22,Monday,Summer,Clear,40,40,0
2011-03-28,2011,March,23,Monday,Summer,Clear,19,18,1
2011-03-29,2011,March,0,Tuesday,Summer,Clear,16,15,1
2011-03-29,2011,March,1,Tuesday,Summer,Clear,4,4,0
2011-03-29,2011,March,2,Tuesday,Summer,Clear,3,3,0
2011-03-29,2011,March,3,Tuesday,Summer,Clear,3,1,2
2011-03-29,2011,March,4,Tuesday,Summer,Clear,2,1,1
2011-03-29,2011,March,5,Tuesday,Summer,Clear,8,8,0
2011-03-29,2011,March,6,Tuesday,Summer,Clear,50,46,4
2011-03-29,2011,March,7,Tuesday,Summer,Clear,133,128,5
2011-03-29,2011,March,8,Tuesday,Summer,Clear,287,268,19
2011-03-29,2011,March,9,Tuesday,Summer,Clear,172,156,16
2011-03-29,2011,March,10,Tuesday,Summer,Clear,59,46,13
2011-03-29,2011,March,11,Tuesday,Summer,Cloudy,81,63,18
2011-03-29,2011,March,12,Tuesday,Summer,Clear,106,77,29
2011-03-29,2011,March,13,Tuesday,Summer,Clear,104,80,24
2011-03-29,2011,March,14,Tuesday,Summer,Clear,86,66,20
2011-03-29,2011,March,15,Tuesday,Summer,Clear,87,65,22
2011-03-29,2011,March,16,Tuesday,Summer,Clear,136,124,12
2011-03-29,2011,March,17,Tuesday,Summer,Clear,299,265,34
2011-03-29,2011,March,18,Tuesday,Summer,Clear,294,252,42
2011-03-29,2011,March,19,Tuesday,Summer,Clear,190,170,20
2011-03-29,2011,March,20,Tuesday,Summer,Clear,132,119,13
2011-03-29,2011,March,21,Tuesday,Summer,Clear,83,75,8
2011-03-29,2011,March,22,Tuesday,Summer,Clear,55,49,6
2011-03-29,2011,March,23,Tuesday,Summer,Cloudy,35,27,8
2011-03-30,2011,March,0,Wednesday,Summer,Cloudy,11,8,3
2011-03-30,2011,March,1,Wednesday,Summer,Clear,10,9,1
2011-03-30,2011,March,2,Wednesday,Summer,Cloudy,4,4,0
2011-03-30,2011,March,3,Wednesday,Summer,Cloudy,4,4,0
2011-03-30,2011,March,4,Wednesday,Summer,Cloudy,1,0,1
2011-03-30,2011,March,5,Wednesday,Summer,Cloudy,7,7,0
2011-03-30,2011,March,6,Wednesday,Summer,Cloudy,48,44,4
2011-03-30,2011,March,7,Wednesday,Summer,Cloudy,136,128,8
2011-03-30,2011,March,8,Wednesday,Summer,Cloudy,263,247,16
2011-03-30,2011,March,9,Wednesday,Summer,Cloudy,154,147,7
2011-03-30,2011,March,10,Wednesday,Summer,Cloudy,64,51,13
2011-03-30,2011,March,11,Wednesday,Summer,Cloudy,90,64,26
2011-03-30,2011,March,12,Wednesday,Summer,Cloudy,80,65,15
2011-03-30,2011,March,13,Wednesday,Summer,Cloudy,98,84,14
2011-03-30,2011,March,14,Wednesday,Summer,Cloudy,80,64,16
2011-03-30,2011,March,15,Wednesday,Summer,Light Snow/Rain,70,56,14
2011-03-30,2011,March,16,Wednesday,Summer,Light Snow/Rain,36,36,0
2011-03-30,2011,March,17,Wednesday,Summer,Light Snow/Rain,116,105,11
2011-03-30,2011,March,18,Wednesday,Summer,Cloudy,85,79,6
2011-03-30,2011,March,19,Wednesday,Summer,Cloudy,72,67,5
2011-03-30,2011,March,20,Wednesday,Summer,Light Snow/Rain,44,40,4
2011-03-30,2011,March,21,Wednesday,Summer,Cloudy,27,27,0
2011-03-30,2011,March,22,Wednesday,Summer,Light Snow/Rain,24,21,3
2011-03-30,2011,March,23,Wednesday,Summer,Light Snow/Rain,12,11,1
2011-03-31,2011,March,0,Thursday,Summer,Light Snow/Rain,3,3,0
2011-03-31,2011,March,1,Thursday,Summer,Light Snow/Rain,5,4,1
2011-03-31,2011,March,2,Thursday,Summer,Light Snow/Rain,5,5,0
2011-03-31,2011,March,3,Thursday,Summer,Light Snow/Rain,1,1,0
2011-03-31,2011,March,4,Thursday,Summer,Light Snow/Rain,2,2,0
2011-03-31,2011,March,5,Thursday,Summer,Light Snow/Rain,8,8,0
2011-03-31,2011,March,6,Thursday,Summer,Light Snow/Rain,36,34,2
2011-03-31,2011,March,7,Thursday,Summer,Light Snow/Rain,92,87,5
2011-03-31,2011,March,8,Thursday,Summer,Cloudy,192,185,7
2011-03-31,2011,March,9,Thursday,Summer,Light Snow/Rain,132,126,6
2011-03-31,2011,March,10,Thursday,Summer,Light Snow/Rain,69,54,15
2011-03-31,2011,March,11,Thursday,Summer,Light Snow/Rain,58,52,6
2011-03-31,2011,March,12,Thursday,Summer,Light Snow/Rain,90,73,17
2011-03-31,2011,March,13,Thursday,Summer,Light Snow/Rain,68,55,13
2011-03-31,2011,March,14,Thursday,Summer,Light Snow/Rain,76,49,27
2011-03-31,2011,March,15,Thursday,Summer,Light Snow/Rain,65,61,4
2011-03-31,2011,March,16,Thursday,Summer,Cloudy,85,72,13
2011-03-31,2011,March,17,Thursday,Summer,Cloudy,168,153,15
2011-03-31,2011,March,18,Thursday,Summer,Cloudy,177,165,12
2011-03-31,2011,March,19,Thursday,Summer,Cloudy,130,118,12
2011-03-31,2011,March,20,Thursday,Summer,Light Snow/Rain,85,79,6
2011-03-31,2011,March,21,Thursday,Summer,Cloudy,60,53,7
2011-03-31,2011,March,22,Thursday,Summer,Light Snow/Rain,51,44,7
2011-03-31,2011,March,23,Thursday,Summer,Light Snow/Rain,27,23,4
2011-04-01,2011,April,0,Friday,Summer,Light Snow/Rain,6,6,0
2011-04-01,2011,April,1,Friday,Summer,Light Snow/Rain,4,4,0
2011-04-01,2011,April,2,Friday,Summer,Light Snow/Rain,7,7,0
2011-04-01,2011,April,3,Friday,Summer,Cloudy,4,4,0
2011-04-01,2011,April,4,Friday,Summer,Cloudy,3,3,0
2011-04-01,2011,April,5,Friday,Summer,Light Snow/Rain,12,11,1
2011-04-01,2011,April,6,Friday,Summer,Light Snow/Rain,28,26,2
2011-04-01,2011,April,7,Friday,Summer,Light Snow/Rain,95,91,4
2011-04-01,2011,April,8,Friday,Summer,Cloudy,206,198,8
2011-04-01,2011,April,9,Friday,Summer,Clear,173,162,11
2011-04-01,2011,April,10,Friday,Summer,Clear,75,63,12
2011-04-01,2011,April,11,Friday,Summer,Clear,89,72,17
2011-04-01,2011,April,12,Friday,Summer,Clear,95,80,15
2011-04-01,2011,April,13,Friday,Summer,Clear,110,92,18
2011-04-01,2011,April,14,Friday,Summer,Cloudy,87,61,26
2011-04-01,2011,April,15,Friday,Summer,Clear,111,81,30
2011-04-01,2011,April,16,Friday,Summer,Clear,167,125,42
2011-04-01,2011,April,17,Friday,Summer,Clear,281,245,36
2011-04-01,2011,April,18,Friday,Summer,Clear,241,205,36
2011-04-01,2011,April,19,Friday,Summer,Clear,136,120,16
2011-04-01,2011,April,20,Friday,Summer,Clear,77,75,2
2011-04-01,2011,April,21,Friday,Summer,Clear,93,84,9
2011-04-01,2011,April,22,Friday,Summer,Clear,74,64,10
2011-04-01,2011,April,23,Friday,Summer,Clear,53,41,12
2011-04-02,2011,April,0,Saturday,Summer,Cloudy,32,29,3
2011-04-02,2011,April,1,Saturday,Summer,Clear,32,28,4
2011-04-02,2011,April,2,Saturday,Summer,Clear,21,20,1
2011-04-02,2011,April,3,Saturday,Summer,Clear,9,8,1
2011-04-02,2011,April,4,Saturday,Summer,Clear,5,5,0
2011-04-02,2011,April,5,Saturday,Summer,Cloudy,5,4,1
2011-04-02,2011,April,6,Saturday,Summer,Clear,12,7,5
2011-04-02,2011,April,7,Saturday,Summer,Cloudy,18,16,2
2011-04-02,2011,April,8,Saturday,Summer,Clear,55,45,10
2011-04-02,2011,April,9,Saturday,Summer,Cloudy,87,65,22
2011-04-02,2011,April,10,Saturday,Summer,Cloudy,154,113,41
2011-04-02,2011,April,11,Saturday,Summer,Cloudy,198,126,72
2011-04-02,2011,April,12,Saturday,Summer,Light Snow/Rain,184,100,84
2011-04-02,2011,April,13,Saturday,Summer,Clear,137,81,56
2011-04-02,2011,April,14,Saturday,Summer,Light Snow/Rain,190,93,97
2011-04-02,2011,April,15,Saturday,Summer,Light Snow/Rain,136,64,72
2011-04-02,2011,April,16,Saturday,Summer,Clear,196,85,111
2011-04-02,2011,April,17,Saturday,Summer,Clear,184,95,89
2011-04-02,2011,April,18,Saturday,Summer,Clear,179,110,69
2011-04-02,2011,April,19,Saturday,Summer,Clear,148,77,71
2011-04-02,2011,April,20,Saturday,Summer,Clear,85,56,29
2011-04-02,2011,April,21,Saturday,Summer,Clear,77,53,24
2011-04-02,2011,April,22,Saturday,Summer,Clear,55,41,14
2011-04-02,2011,April,23,Saturday,Summer,Clear,53,33,20
2011-04-03,2011,April,0,Sunday,Summer,Clear,39,31,8
2011-04-03,2011,April,1,Sunday,Summer,Clear,34,26,8
2011-04-03,2011,April,2,Sunday,Summer,Clear,24,19,5
2011-04-03,2011,April,3,Sunday,Summer,Clear,11,8,3
2011-04-03,2011,April,4,Sunday,Summer,Clear,3,0,3
2011-04-03,2011,April,5,Sunday,Summer,Clear,5,4,1
2011-04-03,2011,April,6,Sunday,Summer,Clear,33,23,10
2011-04-03,2011,April,7,Sunday,Summer,Clear,33,20,13
2011-04-03,2011,April,8,Sunday,Summer,Clear,62,44,18
2011-04-03,2011,April,9,Sunday,Summer,Clear,142,74,68
2011-04-03,2011,April,10,Sunday,Summer,Clear,215,104,111
2011-04-03,2011,April,11,Sunday,Summer,Clear,243,104,139
2011-04-03,2011,April,12,Sunday,Summer,Clear,313,147,166
2011-04-03,2011,April,13,Sunday,Summer,Clear,367,148,219
2011-04-03,2011,April,14,Sunday,Summer,Clear,349,109,240
2011-04-03,2011,April,15,Sunday,Summer,Cloudy,292,118,174
2011-04-03,2011,April,16,Sunday,Summer,Cloudy,303,156,147
2011-04-03,2011,April,17,Sunday,Summer,Cloudy,274,126,148
2011-04-03,2011,April,18,Sunday,Summer,Cloudy,172,101,71
2011-04-03,2011,April,19,Sunday,Summer,Cloudy,144,93,51
2011-04-03,2011,April,20,Sunday,Summer,Light Snow/Rain,79,55,24
2011-04-03,2011,April,21,Sunday,Summer,Cloudy,45,37,8
2011-04-03,2011,April,22,Sunday,Summer,Clear,36,29,7
2011-04-03,2011,April,23,Sunday,Summer,Clear,31,22,9
2011-04-04,2011,April,0,Monday,Summer,Clear,6,5,1
2011-04-04,2011,April,1,Monday,Summer,Clear,11,4,7
2011-04-04,2011,April,2,Monday,Summer,Clear,2,1,1
2011-04-04,2011,April,3,Monday,Summer,Clear,1,0,1
2011-04-04,2011,April,4,Monday,Summer,Clear,2,1,1
2011-04-04,2011,April,5,Monday,Summer,Clear,7,7,0
2011-04-04,2011,April,6,Monday,Summer,Clear,46,43,3
2011-04-04,2011,April,7,Monday,Summer,Cloudy,157,150,7
2011-04-04,2011,April,8,Monday,Summer,Cloudy,339,308,31
2011-04-04,2011,April,9,Monday,Summer,Cloudy,158,134,24
2011-04-04,2011,April,10,Monday,Summer,Cloudy,90,55,35
2011-04-04,2011,April,11,Monday,Summer,Clear,124,66,58
2011-04-04,2011,April,12,Monday,Summer,Clear,157,98,59
2011-04-04,2011,April,13,Monday,Summer,Clear,139,92,47
2011-04-04,2011,April,14,Monday,Summer,Cloudy,123,76,47
2011-04-04,2011,April,15,Monday,Summer,Clear,143,96,47
2011-04-04,2011,April,16,Monday,Summer,Clear,189,130,59
2011-04-04,2011,April,17,Monday,Summer,Clear,366,283,83
2011-04-04,2011,April,18,Monday,Summer,Cloudy,386,308,78
2011-04-04,2011,April,19,Monday,Summer,Clear,278,227,51
2011-04-04,2011,April,20,Monday,Summer,Cloudy,173,133,40
2011-04-04,2011,April,21,Monday,Summer,Cloudy,95,76,19
2011-04-04,2011,April,22,Monday,Summer,Cloudy,75,58,17
2011-04-04,2011,April,23,Monday,Summer,Cloudy,48,30,18
2011-04-05,2011,April,0,Tuesday,Summer,Clear,22,12,10
2011-04-05,2011,April,1,Tuesday,Summer,Light Snow/Rain,15,5,10
2011-04-05,2011,April,2,Tuesday,Summer,Cloudy,5,5,0
2011-04-05,2011,April,3,Tuesday,Summer,Cloudy,4,3,1
2011-04-05,2011,April,4,Tuesday,Summer,Light Snow/Rain,2,2,0
2011-04-05,2011,April,5,Tuesday,Summer,Light Snow/Rain,5,5,0
2011-04-05,2011,April,6,Tuesday,Summer,Cloudy,38,36,2
2011-04-05,2011,April,7,Tuesday,Summer,Cloudy,134,124,10
2011-04-05,2011,April,8,Tuesday,Summer,Light Snow/Rain,157,148,9
2011-04-05,2011,April,9,Tuesday,Summer,Light Snow/Rain,46,44,2
2011-04-05,2011,April,10,Tuesday,Summer,Light Snow/Rain,28,25,3
2011-04-05,2011,April,11,Tuesday,Summer,Light Snow/Rain,19,18,1
2011-04-05,2011,April,12,Tuesday,Summer,Cloudy,38,32,6
2011-04-05,2011,April,13,Tuesday,Summer,Cloudy,56,51,5
2011-04-05,2011,April,14,Tuesday,Summer,Cloudy,76,67,9
2011-04-05,2011,April,15,Tuesday,Summer,Clear,68,62,6
2011-04-05,2011,April,16,Tuesday,Summer,Clear,130,113,17
2011-04-05,2011,April,17,Tuesday,Summer,Clear,273,246,27
2011-04-05,2011,April,18,Tuesday,Summer,Clear,267,248,19
2011-04-05,2011,April,19,Tuesday,Summer,Clear,160,148,12
2011-04-05,2011,April,20,Tuesday,Summer,Clear,91,87,4
2011-04-05,2011,April,21,Tuesday,Summer,Clear,89,81,8
2011-04-05,2011,April,22,Tuesday,Summer,Clear,46,43,3
2011-04-05,2011,April,23,Tuesday,Summer,Clear,26,23,3
2011-04-06,2011,April,0,Wednesday,Summer,Clear,15,15,0
2011-04-06,2011,April,1,Wednesday,Summer,Clear,2,2,0
2011-04-06,2011,April,2,Wednesday,Summer,Clear,5,5,0
2011-04-06,2011,April,3,Wednesday,Summer,Clear,4,4,0
2011-04-06,2011,April,4,Wednesday,Summer,Clear,1,1,0
2011-04-06,2011,April,5,Wednesday,Summer,Clear,13,12,1
2011-04-06,2011,April,6,Wednesday,Summer,Clear,56,52,4
2011-04-06,2011,April,7,Wednesday,Summer,Clear,133,130,3
2011-04-06,2011,April,8,Wednesday,Summer,Clear,325,308,17
2011-04-06,2011,April,9,Wednesday,Summer,Clear,165,157,8
2011-04-06,2011,April,10,Wednesday,Summer,Clear,69,48,21
2011-04-06,2011,April,11,Wednesday,Summer,Clear,93,70,23
2011-04-06,2011,April,12,Wednesday,Summer,Clear,134,112,22
2011-04-06,2011,April,13,Wednesday,Summer,Clear,112,83,29
2011-04-06,2011,April,14,Wednesday,Summer,Clear,115,80,35
2011-04-06,2011,April,15,Wednesday,Summer,Clear,117,83,34
2011-04-06,2011,April,16,Wednesday,Summer,Clear,169,142,27
2011-04-06,2011,April,17,Wednesday,Summer,Clear,356,303,53
2011-04-06,2011,April,18,Wednesday,Summer,Clear,325,282,43
2011-04-06,2011,April,19,Wednesday,Summer,Clear,232,196,36
2011-04-06,2011,April,20,Wednesday,Summer,Clear,141,126,15
2011-04-06,2011,April,21,Wednesday,Summer,Clear,102,84,18
2011-04-06,2011,April,22,Wednesday,Summer,Clear,84,71,13
2011-04-06,2011,April,23,Wednesday,Summer,Clear,40,29,11
2011-04-07,2011,April,0,Thursday,Summer,Clear,20,15,5
2011-04-07,2011,April,1,Thursday,Summer,Clear,13,11,2
2011-04-07,2011,April,2,Thursday,Summer,Clear,7,7,0
2011-04-07,2011,April,3,Thursday,Summer,Clear,3,3,0
2011-04-07,2011,April,4,Thursday,Summer,Clear,1,1,0
2011-04-07,2011,April,5,Thursday,Summer,Clear,6,6,0
2011-04-07,2011,April,6,Thursday,Summer,Clear,64,59,5
2011-04-07,2011,April,7,Thursday,Summer,Cloudy,160,152,8
2011-04-07,2011,April,8,Thursday,Summer,Clear,314,291,23
2011-04-07,2011,April,9,Thursday,Summer,Cloudy,170,155,15
2011-04-07,2011,April,10,Thursday,Summer,Cloudy,95,66,29
2011-04-07,2011,April,11,Thursday,Summer,Cloudy,122,86,36
2011-04-07,2011,April,12,Thursday,Summer,Cloudy,153,114,39
2011-04-07,2011,April,13,Thursday,Summer,Cloudy,135,99,36
2011-04-07,2011,April,14,Thursday,Summer,Clear,157,111,46
2011-04-07,2011,April,15,Thursday,Summer,Clear,160,133,27
2011-04-07,2011,April,16,Thursday,Summer,Clear,213,161,52
2011-04-07,2011,April,17,Thursday,Summer,Clear,343,280,63
2011-04-07,2011,April,18,Thursday,Summer,Clear,333,265,68
2011-04-07,2011,April,19,Thursday,Summer,Clear,226,192,34
2011-04-07,2011,April,20,Thursday,Summer,Clear,203,166,37
2011-04-07,2011,April,21,Thursday,Summer,Cloudy,108,89,19
2011-04-07,2011,April,22,Thursday,Summer,Cloudy,81,63,18
2011-04-07,2011,April,23,Thursday,Summer,Clear,54,45,9
2011-04-08,2011,April,0,Friday,Summer,Cloudy,25,21,4
2011-04-08,2011,April,1,Friday,Summer,Cloudy,9,6,3
2011-04-08,2011,April,2,Friday,Summer,Light Snow/Rain,13,10,3
2011-04-08,2011,April,3,Friday,Summer,Light Snow/Rain,1,1,0
2011-04-08,2011,April,4,Friday,Summer,Cloudy,1,1,0
2011-04-08,2011,April,5,Friday,Summer,Cloudy,9,8,1
2011-04-08,2011,April,6,Friday,Summer,Cloudy,35,33,2
2011-04-08,2011,April,7,Friday,Summer,Light Snow/Rain,113,109,4
2011-04-08,2011,April,8,Friday,Summer,Light Snow/Rain,221,208,13
2011-04-08,2011,April,9,Friday,Summer,Cloudy,185,168,17
2011-04-08,2011,April,10,Friday,Summer,Cloudy,73,63,10
2011-04-08,2011,April,11,Friday,Summer,Cloudy,98,79,19
2011-04-08,2011,April,12,Friday,Summer,Light Snow/Rain,80,51,29
2011-04-08,2011,April,13,Friday,Summer,Light Snow/Rain,42,35,7
2011-04-08,2011,April,14,Friday,Summer,Light Snow/Rain,15,13,2
2011-04-08,2011,April,15,Friday,Summer,Light Snow/Rain,25,24,1
2011-04-08,2011,April,16,Friday,Summer,Cloudy,60,58,2
2011-04-08,2011,April,17,Friday,Summer,Light Snow/Rain,148,138,10
2011-04-08,2011,April,18,Friday,Summer,Light Snow/Rain,62,54,8
2011-04-08,2011,April,19,Friday,Summer,Light Snow/Rain,53,52,1
2011-04-08,2011,April,20,Friday,Summer,Cloudy,63,51,12
2011-04-08,2011,April,21,Friday,Summer,Cloudy,54,43,11
2011-04-08,2011,April,22,Friday,Summer,Cloudy,51,42,9
2011-04-08,2011,April,23,Friday,Summer,Cloudy,35,31,4
2011-04-09,2011,April,0,Saturday,Summer,Cloudy,31,26,5
2011-04-09,2011,April,1,Saturday,Summer,Cloudy,20,17,3
2011-04-09,2011,April,2,Saturday,Summer,Cloudy,17,15,2
2011-04-09,2011,April,3,Saturday,Summer,Light Snow/Rain,14,11,3
2011-04-09,2011,April,4,Saturday,Summer,Light Snow/Rain,3,3,0
2011-04-09,2011,April,5,Saturday,Summer,Cloudy,5,5,0
2011-04-09,2011,April,6,Saturday,Summer,Cloudy,13,13,0
2011-04-09,2011,April,7,Saturday,Summer,Cloudy,21,13,8
2011-04-09,2011,April,8,Saturday,Summer,Cloudy,54,47,7
2011-04-09,2011,April,9,Saturday,Summer,Cloudy,98,71,27
2011-04-09,2011,April,10,Saturday,Summer,Cloudy,133,90,43
2011-04-09,2011,April,11,Saturday,Summer,Cloudy,142,91,51
2011-04-09,2011,April,12,Saturday,Summer,Cloudy,202,123,79
2011-04-09,2011,April,13,Saturday,Summer,Cloudy,222,108,114
2011-04-09,2011,April,14,Saturday,Summer,Cloudy,212,118,94
2011-04-09,2011,April,15,Saturday,Summer,Cloudy,201,116,85
2011-04-09,2011,April,16,Saturday,Summer,Cloudy,191,118,73
2011-04-09,2011,April,17,Saturday,Summer,Cloudy,257,129,128
2011-04-09,2011,April,18,Saturday,Summer,Cloudy,177,129,48
2011-04-09,2011,April,19,Saturday,Summer,Cloudy,130,83,47
2011-04-09,2011,April,20,Saturday,Summer,Cloudy,93,74,19
2011-04-09,2011,April,21,Saturday,Summer,Cloudy,75,65,10
2011-04-09,2011,April,22,Saturday,Summer,Cloudy,87,66,21
2011-04-09,2011,April,23,Saturday,Summer,Cloudy,57,45,12
2011-04-10,2011,April,0,Sunday,Summer,Cloudy,53,48,5
2011-04-10,2011,April,1,Sunday,Summer,Cloudy,37,31,6
2011-04-10,2011,April,2,Sunday,Summer,Cloudy,36,24,12
2011-04-10,2011,April,3,Sunday,Summer,Cloudy,16,11,5
2011-04-10,2011,April,4,Sunday,Summer,Cloudy,5,2,3
2011-04-10,2011,April,5,Sunday,Summer,Cloudy,4,4,0
2011-04-10,2011,April,6,Sunday,Summer,Cloudy,4,4,0
2011-04-10,2011,April,7,Sunday,Summer,Cloudy,10,7,3
2011-04-10,2011,April,8,Sunday,Summer,Cloudy,55,38,17
2011-04-10,2011,April,9,Sunday,Summer,Cloudy,81,50,31
2011-04-10,2011,April,10,Sunday,Summer,Cloudy,150,81,69
2011-04-10,2011,April,11,Sunday,Summer,Cloudy,202,109,93
2011-04-10,2011,April,12,Sunday,Summer,Cloudy,230,136,94
2011-04-10,2011,April,13,Sunday,Summer,Clear,263,142,121
2011-04-10,2011,April,14,Sunday,Summer,Clear,281,133,148
2011-04-10,2011,April,15,Sunday,Summer,Clear,297,141,156
2011-04-10,2011,April,16,Sunday,Summer,Cloudy,288,153,135
2011-04-10,2011,April,17,Sunday,Summer,Cloudy,236,152,84
2011-04-10,2011,April,18,Sunday,Summer,Clear,240,137,103
2011-04-10,2011,April,19,Sunday,Summer,Clear,131,84,47
2011-04-10,2011,April,20,Sunday,Summer,Clear,92,71,21
2011-04-10,2011,April,21,Sunday,Summer,Clear,95,77,18
2011-04-10,2011,April,22,Sunday,Summer,Clear,57,45,12
2011-04-10,2011,April,23,Sunday,Summer,Clear,32,27,5
2011-04-11,2011,April,0,Monday,Summer,Clear,23,16,7
2011-04-11,2011,April,1,Monday,Summer,Clear,4,3,1
2011-04-11,2011,April,2,Monday,Summer,Clear,9,2,7
2011-04-11,2011,April,4,Monday,Summer,Clear,1,1,0
2011-04-11,2011,April,5,Monday,Summer,Clear,13,12,1
2011-04-11,2011,April,6,Monday,Summer,Cloudy,61,59,2
2011-04-11,2011,April,7,Monday,Summer,Cloudy,176,164,12
2011-04-11,2011,April,8,Monday,Summer,Cloudy,314,286,28
2011-04-11,2011,April,9,Monday,Summer,Cloudy,165,132,33
2011-04-11,2011,April,10,Monday,Summer,Cloudy,96,55,41
2011-04-11,2011,April,11,Monday,Summer,Cloudy,104,59,45
2011-04-11,2011,April,12,Monday,Summer,Cloudy,134,97,37
2011-04-11,2011,April,13,Monday,Summer,Cloudy,139,77,62
2011-04-11,2011,April,14,Monday,Summer,Cloudy,145,85,60
2011-04-11,2011,April,15,Monday,Summer,Clear,141,85,56
2011-04-11,2011,April,16,Monday,Summer,Clear,235,162,73
2011-04-11,2011,April,17,Monday,Summer,Clear,452,352,100
2011-04-11,2011,April,18,Monday,Summer,Clear,383,290,93
2011-04-11,2011,April,19,Monday,Summer,Clear,284,211,73
2011-04-11,2011,April,20,Monday,Summer,Clear,166,122,44
2011-04-11,2011,April,21,Monday,Summer,Clear,158,119,39
2011-04-11,2011,April,22,Monday,Summer,Cloudy,91,66,25
2011-04-11,2011,April,23,Monday,Summer,Light Snow/Rain,54,38,16
2011-04-12,2011,April,0,Tuesday,Summer,Cloudy,24,13,11
2011-04-12,2011,April,1,Tuesday,Summer,Cloudy,13,7,6
2011-04-12,2011,April,2,Tuesday,Summer,Cloudy,14,7,7
2011-04-12,2011,April,3,Tuesday,Summer,Cloudy,1,1,0
2011-04-12,2011,April,4,Tuesday,Summer,Cloudy,6,2,4
2011-04-12,2011,April,5,Tuesday,Summer,Cloudy,16,15,1
2011-04-12,2011,April,6,Tuesday,Summer,Cloudy,58,55,3
2011-04-12,2011,April,7,Tuesday,Summer,Cloudy,189,177,12
2011-04-12,2011,April,8,Tuesday,Summer,Light Snow/Rain,226,211,15
2011-04-12,2011,April,9,Tuesday,Summer,Light Snow/Rain,54,50,4
2011-04-12,2011,April,10,Tuesday,Summer,Light Snow/Rain,40,34,6
2011-04-12,2011,April,11,Tuesday,Summer,Clear,49,38,11
2011-04-12,2011,April,12,Tuesday,Summer,Cloudy,92,83,9
2011-04-12,2011,April,13,Tuesday,Summer,Light Snow/Rain,106,84,22
2011-04-12,2011,April,14,Tuesday,Summer,Cloudy,44,28,16
2011-04-12,2011,April,15,Tuesday,Summer,Cloudy,78,54,24
2011-04-12,2011,April,16,Tuesday,Summer,Cloudy,99,80,19
2011-04-12,2011,April,17,Tuesday,Summer,Light Snow/Rain,291,262,29
2011-04-12,2011,April,18,Tuesday,Summer,Light Snow/Rain,224,203,21
2011-04-12,2011,April,19,Tuesday,Summer,Cloudy,130,127,3
2011-04-12,2011,April,20,Tuesday,Summer,Cloudy,103,94,9
2011-04-12,2011,April,21,Tuesday,Summer,Cloudy,84,74,10
2011-04-12,2011,April,22,Tuesday,Summer,Cloudy,54,47,7
2011-04-12,2011,April,23,Tuesday,Summer,Cloudy,39,31,8
2011-04-13,2011,April,0,Wednesday,Summer,Cloudy,15,12,3
2011-04-13,2011,April,1,Wednesday,Summer,Cloudy,1,1,0
2011-04-13,2011,April,2,Wednesday,Summer,Light Snow/Rain,2,2,0
2011-04-13,2011,April,3,Wednesday,Summer,Light Snow/Rain,2,2,0
2011-04-13,2011,April,4,Wednesday,Summer,Light Snow/Rain,3,2,1
2011-04-13,2011,April,5,Wednesday,Summer,Light Snow/Rain,5,4,1
2011-04-13,2011,April,6,Wednesday,Summer,Light Snow/Rain,34,33,1
2011-04-13,2011,April,7,Wednesday,Summer,Light Snow/Rain,70,67,3
2011-04-13,2011,April,8,Wednesday,Summer,Light Snow/Rain,164,158,6
2011-04-13,2011,April,9,Wednesday,Summer,Cloudy,65,63,2
2011-04-13,2011,April,10,Wednesday,Summer,Cloudy,46,42,4
2011-04-13,2011,April,11,Wednesday,Summer,Cloudy,61,57,4
2011-04-13,2011,April,12,Wednesday,Summer,Light Snow/Rain,95,83,12
2011-04-13,2011,April,13,Wednesday,Summer,Cloudy,61,55,6
2011-04-13,2011,April,14,Wednesday,Summer,Cloudy,106,82,24
2011-04-13,2011,April,15,Wednesday,Summer,Cloudy,81,69,12
2011-04-13,2011,April,16,Wednesday,Summer,Clear,142,119,23
2011-04-13,2011,April,17,Wednesday,Summer,Clear,309,284,25
2011-04-13,2011,April,18,Wednesday,Summer,Clear,321,293,28
2011-04-13,2011,April,19,Wednesday,Summer,Clear,175,160,15
2011-04-13,2011,April,20,Wednesday,Summer,Clear,126,119,7
2011-04-13,2011,April,21,Wednesday,Summer,Clear,117,100,17
2011-04-13,2011,April,22,Wednesday,Summer,Clear,99,89,10
2011-04-13,2011,April,23,Wednesday,Summer,Clear,62,57,5
2011-04-14,2011,April,0,Thursday,Summer,Clear,21,18,3
2011-04-14,2011,April,1,Thursday,Summer,Clear,10,9,1
2011-04-14,2011,April,2,Thursday,Summer,Clear,3,3,0
2011-04-14,2011,April,3,Thursday,Summer,Clear,2,2,0
2011-04-14,2011,April,4,Thursday,Summer,Clear,9,8,1
2011-04-14,2011,April,5,Thursday,Summer,Clear,14,12,2
2011-04-14,2011,April,6,Thursday,Summer,Clear,70,66,4
2011-04-14,2011,April,7,Thursday,Summer,Clear,193,182,11
2011-04-14,2011,April,8,Thursday,Summer,Clear,337,316,21
2011-04-14,2011,April,9,Thursday,Summer,Clear,170,152,18
2011-04-14,2011,April,10,Thursday,Summer,Clear,89,68,21
2011-04-14,2011,April,11,Thursday,Summer,Clear,115,87,28
2011-04-14,2011,April,12,Thursday,Summer,Clear,145,110,35
2011-04-14,2011,April,13,Thursday,Summer,Clear,159,121,38
2011-04-14,2011,April,14,Thursday,Summer,Clear,137,101,36
2011-04-14,2011,April,15,Thursday,Summer,Clear,142,85,57
2011-04-14,2011,April,16,Thursday,Summer,Clear,202,153,49
2011-04-14,2011,April,17,Thursday,Summer,Clear,388,338,50
2011-04-14,2011,April,18,Thursday,Summer,Clear,337,290,47
2011-04-14,2011,April,19,Thursday,Summer,Clear,259,222,37
2011-04-14,2011,April,20,Thursday,Summer,Clear,169,147,22
2011-04-14,2011,April,21,Thursday,Summer,Clear,145,126,19
2011-04-14,2011,April,22,Thursday,Summer,Clear,104,82,22
2011-04-14,2011,April,23,Thursday,Summer,Clear,47,40,7
2011-04-15,2011,April,0,Friday,Summer,Clear,27,21,6
2011-04-15,2011,April,1,Friday,Summer,Clear,15,9,6
2011-04-15,2011,April,2,Friday,Summer,Clear,18,10,8
2011-04-15,2011,April,3,Friday,Summer,Clear,3,3,0
2011-04-15,2011,April,4,Friday,Summer,Clear,3,3,0
2011-04-15,2011,April,5,Friday,Summer,Clear,13,11,2
2011-04-15,2011,April,6,Friday,Summer,Clear,47,42,5
2011-04-15,2011,April,7,Friday,Summer,Clear,149,139,10
2011-04-15,2011,April,8,Friday,Summer,Clear,300,279,21
2011-04-15,2011,April,9,Friday,Summer,Clear,178,162,16
2011-04-15,2011,April,10,Friday,Summer,Clear,122,91,31
2011-04-15,2011,April,11,Friday,Summer,Clear,136,95,41
2011-04-15,2011,April,12,Friday,Summer,Clear,200,155,45
2011-04-15,2011,April,13,Friday,Summer,Clear,180,133,47
2011-04-15,2011,April,14,Friday,Summer,Clear,163,106,57
2011-04-15,2011,April,15,Friday,Summer,Clear,162,112,50
2011-04-15,2011,April,16,Friday,Summer,Clear,243,173,70
2011-04-15,2011,April,17,Friday,Summer,Cloudy,331,267,64
2011-04-15,2011,April,18,Friday,Summer,Cloudy,263,216,47
2011-04-15,2011,April,19,Friday,Summer,Clear,209,168,41
2011-04-15,2011,April,20,Friday,Summer,Cloudy,118,92,26
2011-04-15,2011,April,21,Friday,Summer,Cloudy,102,77,25
2011-04-15,2011,April,22,Friday,Summer,Cloudy,80,64,16
2011-04-15,2011,April,23,Friday,Summer,Cloudy,64,56,8
2011-04-16,2011,April,0,Saturday,Summer,Cloudy,43,36,7
2011-04-16,2011,April,1,Saturday,Summer,Cloudy,33,28,5
2011-04-16,2011,April,2,Saturday,Summer,Cloudy,24,19,5
2011-04-16,2011,April,3,Saturday,Summer,Cloudy,14,9,5
2011-04-16,2011,April,4,Saturday,Summer,Cloudy,5,4,1
2011-04-16,2011,April,5,Saturday,Summer,Cloudy,4,3,1
2011-04-16,2011,April,6,Saturday,Summer,Light Snow/Rain,10,9,1
2011-04-16,2011,April,7,Saturday,Summer,Cloudy,21,18,3
2011-04-16,2011,April,8,Saturday,Summer,Light Snow/Rain,45,38,7
2011-04-16,2011,April,9,Saturday,Summer,Light Snow/Rain,29,27,2
2011-04-16,2011,April,10,Saturday,Summer,Light Snow/Rain,22,21,1
2011-04-16,2011,April,11,Saturday,Summer,Light Snow/Rain,31,27,4
2011-04-16,2011,April,12,Saturday,Summer,Cloudy,32,26,6
2011-04-16,2011,April,13,Saturday,Summer,Light Snow/Rain,58,49,9
2011-04-16,2011,April,14,Saturday,Summer,Light Snow/Rain,63,49,14
2011-04-16,2011,April,15,Saturday,Summer,Light Snow/Rain,78,62,16
2011-04-16,2011,April,16,Saturday,Summer,Light Snow/Rain,33,27,6
2011-04-16,2011,April,17,Saturday,Summer,Light Snow/Rain,15,14,1
2011-04-16,2011,April,18,Saturday,Summer,Cloudy,38,32,6
2011-04-16,2011,April,19,Saturday,Summer,Cloudy,71,62,9
2011-04-16,2011,April,20,Saturday,Summer,Light Snow/Rain,53,49,4
2011-04-16,2011,April,21,Saturday,Summer,Cloudy,14,13,1
2011-04-16,2011,April,22,Saturday,Summer,Light Snow/Rain,24,22,2
2011-04-16,2011,April,23,Saturday,Summer,Cloudy,35,30,5
2011-04-17,2011,April,0,Sunday,Summer,Cloudy,33,29,4
2011-04-17,2011,April,1,Sunday,Summer,Clear,31,25,6
2011-04-17,2011,April,2,Sunday,Summer,Clear,29,25,4
2011-04-17,2011,April,3,Sunday,Summer,Clear,25,13,12
2011-04-17,2011,April,4,Sunday,Summer,Clear,7,5,2
2011-04-17,2011,April,5,Sunday,Summer,Clear,3,1,2
2011-04-17,2011,April,6,Sunday,Summer,Clear,8,5,3
2011-04-17,2011,April,7,Sunday,Summer,Clear,16,14,2
2011-04-17,2011,April,8,Sunday,Summer,Clear,43,36,7
2011-04-17,2011,April,9,Sunday,Summer,Clear,102,71,31
2011-04-17,2011,April,10,Sunday,Summer,Clear,211,120,91
2011-04-17,2011,April,11,Sunday,Summer,Clear,304,185,119
2011-04-17,2011,April,12,Sunday,Summer,Clear,354,187,167
2011-04-17,2011,April,13,Sunday,Summer,Clear,343,162,181
2011-04-17,2011,April,14,Sunday,Summer,Clear,361,191,170
2011-04-17,2011,April,15,Sunday,Summer,Clear,388,209,179
2011-04-17,2011,April,16,Sunday,Summer,Clear,343,182,161
2011-04-17,2011,April,17,Sunday,Summer,Clear,306,163,143
2011-04-17,2011,April,18,Sunday,Summer,Clear,277,175,102
2011-04-17,2011,April,19,Sunday,Summer,Clear,210,135,75
2011-04-17,2011,April,20,Sunday,Summer,Clear,141,97,44
2011-04-17,2011,April,21,Sunday,Summer,Clear,83,70,13
2011-04-17,2011,April,22,Sunday,Summer,Clear,70,49,21
2011-04-17,2011,April,23,Sunday,Summer,Clear,56,37,19
2011-04-18,2011,April,0,Monday,Summer,Clear,39,24,15
2011-04-18,2011,April,1,Monday,Summer,Clear,19,8,11
2011-04-18,2011,April,2,Monday,Summer,Clear,16,2,14
2011-04-18,2011,April,3,Monday,Summer,Clear,7,1,6
2011-04-18,2011,April,4,Monday,Summer,Clear,6,4,2
2011-04-18,2011,April,5,Monday,Summer,Clear,16,16,0
2011-04-18,2011,April,6,Monday,Summer,Clear,54,51,3
2011-04-18,2011,April,7,Monday,Summer,Clear,168,156,12
2011-04-18,2011,April,8,Monday,Summer,Clear,297,277,20
2011-04-18,2011,April,9,Monday,Summer,Cloudy,169,132,37
2011-04-18,2011,April,10,Monday,Summer,Cloudy,109,68,41
2011-04-18,2011,April,11,Monday,Summer,Cloudy,123,87,36
2011-04-18,2011,April,12,Monday,Summer,Cloudy,184,124,60
2011-04-18,2011,April,13,Monday,Summer,Cloudy,169,128,41
2011-04-18,2011,April,14,Monday,Summer,Cloudy,144,95,49
2011-04-18,2011,April,15,Monday,Summer,Cloudy,176,112,64
2011-04-18,2011,April,16,Monday,Summer,Clear,205,165,40
2011-04-18,2011,April,17,Monday,Summer,Clear,428,362,66
2011-04-18,2011,April,18,Monday,Summer,Clear,362,321,41
2011-04-18,2011,April,19,Monday,Summer,Clear,286,244,42
2011-04-18,2011,April,20,Monday,Summer,Clear,165,136,29
2011-04-18,2011,April,21,Monday,Summer,Clear,151,131,20
2011-04-18,2011,April,22,Monday,Summer,Clear,90,81,9
2011-04-18,2011,April,23,Monday,Summer,Clear,46,35,11
2011-04-19,2011,April,0,Tuesday,Summer,Clear,25,23,2
2011-04-19,2011,April,1,Tuesday,Summer,Clear,7,2,5
2011-04-19,2011,April,2,Tuesday,Summer,Clear,13,5,8
2011-04-19,2011,April,3,Tuesday,Summer,Clear,3,3,0
2011-04-19,2011,April,4,Tuesday,Summer,Clear,5,4,1
2011-04-19,2011,April,5,Tuesday,Summer,Cloudy,18,17,1
2011-04-19,2011,April,6,Tuesday,Summer,Cloudy,65,63,2
2011-04-19,2011,April,7,Tuesday,Summer,Cloudy,188,166,22
2011-04-19,2011,April,8,Tuesday,Summer,Cloudy,351,331,20
2011-04-19,2011,April,9,Tuesday,Summer,Light Snow/Rain,162,139,23
2011-04-19,2011,April,10,Tuesday,Summer,Cloudy,75,60,15
2011-04-19,2011,April,11,Tuesday,Summer,Cloudy,72,53,19
2011-04-19,2011,April,12,Tuesday,Summer,Cloudy,103,84,19
2011-04-19,2011,April,13,Tuesday,Summer,Cloudy,129,103,26
2011-04-19,2011,April,14,Tuesday,Summer,Cloudy,107,88,19
2011-04-19,2011,April,15,Tuesday,Summer,Cloudy,127,83,44
2011-04-19,2011,April,16,Tuesday,Summer,Clear,192,162,30
2011-04-19,2011,April,17,Tuesday,Summer,Clear,411,372,39
2011-04-19,2011,April,18,Tuesday,Summer,Cloudy,421,377,44
2011-04-19,2011,April,19,Tuesday,Summer,Cloudy,276,248,28
2011-04-19,2011,April,20,Tuesday,Summer,Cloudy,168,148,20
2011-04-19,2011,April,21,Tuesday,Summer,Cloudy,122,114,8
2011-04-19,2011,April,22,Tuesday,Summer,Clear,112,109,3
2011-04-19,2011,April,23,Tuesday,Summer,Clear,52,41,11
2011-04-20,2011,April,0,Wednesday,Summer,Clear,33,29,4
2011-04-20,2011,April,1,Wednesday,Summer,Clear,7,5,2
2011-04-20,2011,April,2,Wednesday,Summer,Clear,2,2,0
2011-04-20,2011,April,3,Wednesday,Summer,Clear,2,2,0
2011-04-20,2011,April,4,Wednesday,Summer,Clear,9,4,5
2011-04-20,2011,April,5,Wednesday,Summer,Clear,15,14,1
2011-04-20,2011,April,6,Wednesday,Summer,Clear,64,62,2
2011-04-20,2011,April,7,Wednesday,Summer,Clear,237,211,26
2011-04-20,2011,April,8,Wednesday,Summer,Clear,396,374,22
2011-04-20,2011,April,9,Wednesday,Summer,Clear,197,170,27
2011-04-20,2011,April,10,Wednesday,Summer,Clear,131,86,45
2011-04-20,2011,April,11,Wednesday,Summer,Clear,118,87,31
2011-04-20,2011,April,12,Wednesday,Summer,Clear,145,117,28
2011-04-20,2011,April,13,Wednesday,Summer,Clear,177,135,42
2011-04-20,2011,April,14,Wednesday,Summer,Clear,148,115,33
2011-04-20,2011,April,15,Wednesday,Summer,Cloudy,145,113,32
2011-04-20,2011,April,16,Wednesday,Summer,Cloudy,255,201,54
2011-04-20,2011,April,17,Wednesday,Summer,Cloudy,432,398,34
2011-04-20,2011,April,18,Wednesday,Summer,Clear,441,385,56
2011-04-20,2011,April,19,Wednesday,Summer,Clear,383,309,74
2011-04-20,2011,April,20,Wednesday,Summer,Clear,225,194,31
2011-04-20,2011,April,21,Wednesday,Summer,Clear,172,134,38
2011-04-20,2011,April,22,Wednesday,Summer,Clear,117,105,12
2011-04-20,2011,April,23,Wednesday,Summer,Clear,93,79,14
2011-04-21,2011,April,0,Thursday,Summer,Clear,44,33,11
2011-04-21,2011,April,1,Thursday,Summer,Clear,26,20,6
2011-04-21,2011,April,2,Thursday,Summer,Clear,13,10,3
2011-04-21,2011,April,3,Thursday,Summer,Cloudy,7,3,4
2011-04-21,2011,April,4,Thursday,Summer,Cloudy,6,4,2
2011-04-21,2011,April,5,Thursday,Summer,Cloudy,14,14,0
2011-04-21,2011,April,6,Thursday,Summer,Cloudy,75,73,2
2011-04-21,2011,April,7,Thursday,Summer,Cloudy,198,183,15
2011-04-21,2011,April,8,Thursday,Summer,Cloudy,365,346,19
2011-04-21,2011,April,9,Thursday,Summer,Cloudy,196,178,18
2011-04-21,2011,April,10,Thursday,Summer,Clear,98,73,25
2011-04-21,2011,April,11,Thursday,Summer,Clear,133,99,34
2011-04-21,2011,April,12,Thursday,Summer,Clear,199,150,49
2011-04-21,2011,April,13,Thursday,Summer,Clear,177,122,55
2011-04-21,2011,April,14,Thursday,Summer,Clear,228,160,68
2011-04-21,2011,April,15,Thursday,Summer,Clear,235,166,69
2011-04-21,2011,April,16,Thursday,Summer,Clear,294,228,66
2011-04-21,2011,April,17,Thursday,Summer,Clear,481,402,79
2011-04-21,2011,April,18,Thursday,Summer,Clear,452,381,71
2011-04-21,2011,April,19,Thursday,Summer,Clear,324,272,52
2011-04-21,2011,April,20,Thursday,Summer,Clear,204,176,28
2011-04-21,2011,April,21,Thursday,Summer,Clear,184,159,25
2011-04-21,2011,April,22,Thursday,Summer,Clear,137,106,31
2011-04-21,2011,April,23,Thursday,Summer,Clear,99,86,13
2011-04-22,2011,April,0,Friday,Summer,Clear,33,30,3
2011-04-22,2011,April,1,Friday,Summer,Clear,24,22,2
2011-04-22,2011,April,2,Friday,Summer,Clear,9,7,2
2011-04-22,2011,April,3,Friday,Summer,Clear,2,2,0
2011-04-22,2011,April,4,Friday,Summer,Clear,3,2,1
2011-04-22,2011,April,5,Friday,Summer,Clear,16,16,0
2011-04-22,2011,April,6,Friday,Summer,Clear,49,47,2
2011-04-22,2011,April,7,Friday,Summer,Cloudy,180,175,5
2011-04-22,2011,April,8,Friday,Summer,Cloudy,346,331,15
2011-04-22,2011,April,9,Friday,Summer,Light Snow/Rain,195,178,17
2011-04-22,2011,April,10,Friday,Summer,Cloudy,136,104,32
2011-04-22,2011,April,11,Friday,Summer,Light Snow/Rain,106,83,23
2011-04-22,2011,April,12,Friday,Summer,Light Snow/Rain,80,61,19
2011-04-22,2011,April,13,Friday,Summer,Light Snow/Rain,40,37,3
2011-04-22,2011,April,14,Friday,Summer,Light Snow/Rain,36,33,3
2011-04-22,2011,April,15,Friday,Summer,Light Snow/Rain,75,62,13
2011-04-22,2011,April,16,Friday,Summer,Light Snow/Rain,62,58,4
2011-04-22,2011,April,17,Friday,Summer,Light Snow/Rain,69,63,6
2011-04-22,2011,April,18,Friday,Summer,Light Snow/Rain,51,47,4
2011-04-22,2011,April,19,Friday,Summer,Light Snow/Rain,55,48,7
2011-04-22,2011,April,20,Friday,Summer,Light Snow/Rain,47,39,8
2011-04-22,2011,April,21,Friday,Summer,Light Snow/Rain,28,23,5
2011-04-22,2011,April,22,Friday,Summer,Light Snow/Rain,24,21,3
2011-04-22,2011,April,23,Friday,Summer,Light Snow/Rain,17,17,0
2011-04-23,2011,April,0,Saturday,Summer,Cloudy,18,18,0
2011-04-23,2011,April,1,Saturday,Summer,Cloudy,16,11,5
2011-04-23,2011,April,2,Saturday,Summer,Light Snow/Rain,17,14,3
2011-04-23,2011,April,3,Saturday,Summer,Light Snow/Rain,4,4,0
2011-04-23,2011,April,4,Saturday,Summer,Light Snow/Rain,5,3,2
2011-04-23,2011,April,5,Saturday,Summer,Light Snow/Rain,7,6,1
2011-04-23,2011,April,6,Saturday,Summer,Cloudy,11,11,0
2011-04-23,2011,April,7,Saturday,Summer,Light Snow/Rain,19,17,2
2011-04-23,2011,April,8,Saturday,Summer,Cloudy,47,32,15
2011-04-23,2011,April,9,Saturday,Summer,Cloudy,68,55,13
2011-04-23,2011,April,10,Saturday,Summer,Cloudy,129,93,36
2011-04-23,2011,April,11,Saturday,Summer,Cloudy,232,164,68
2011-04-23,2011,April,12,Saturday,Summer,Clear,291,197,94
2011-04-23,2011,April,13,Saturday,Summer,Clear,312,186,126
2011-04-23,2011,April,14,Saturday,Summer,Clear,391,209,182
2011-04-23,2011,April,15,Saturday,Summer,Clear,397,226,171
2011-04-23,2011,April,16,Saturday,Summer,Clear,426,246,180
2011-04-23,2011,April,17,Saturday,Summer,Clear,383,215,168
2011-04-23,2011,April,18,Saturday,Summer,Clear,376,227,149
2011-04-23,2011,April,19,Saturday,Summer,Clear,283,199,84
2011-04-23,2011,April,20,Saturday,Summer,Cloudy,183,138,45
2011-04-23,2011,April,21,Saturday,Summer,Cloudy,135,103,32
2011-04-23,2011,April,22,Saturday,Summer,Cloudy,169,114,55
2011-04-23,2011,April,23,Saturday,Summer,Cloudy,117,86,31
2011-04-24,2011,April,0,Sunday,Summer,Clear,96,66,30
2011-04-24,2011,April,1,Sunday,Summer,Clear,54,40,14
2011-04-24,2011,April,2,Sunday,Summer,Clear,72,45,27
2011-04-24,2011,April,3,Sunday,Summer,Clear,24,20,4
2011-04-24,2011,April,4,Sunday,Summer,Clear,5,5,0
2011-04-24,2011,April,5,Sunday,Summer,Clear,12,7,5
2011-04-24,2011,April,6,Sunday,Summer,Cloudy,13,3,10
2011-04-24,2011,April,7,Sunday,Summer,Cloudy,27,11,16
2011-04-24,2011,April,8,Sunday,Summer,Clear,80,42,38
2011-04-24,2011,April,9,Sunday,Summer,Clear,177,104,73
2011-04-24,2011,April,10,Sunday,Summer,Clear,289,171,118
2011-04-24,2011,April,11,Sunday,Summer,Clear,317,193,124
2011-04-24,2011,April,12,Sunday,Summer,Clear,388,220,168
2011-04-24,2011,April,13,Sunday,Summer,Clear,441,236,205
2011-04-24,2011,April,14,Sunday,Summer,Clear,420,223,197
2011-04-24,2011,April,15,Sunday,Summer,Clear,369,202,167
2011-04-24,2011,April,16,Sunday,Summer,Clear,359,197,162
2011-04-24,2011,April,17,Sunday,Summer,Clear,331,189,142
2011-04-24,2011,April,18,Sunday,Summer,Clear,270,174,96
2011-04-24,2011,April,19,Sunday,Summer,Light Snow/Rain,194,132,62
2011-04-24,2011,April,20,Sunday,Summer,Light Snow/Rain,105,71,34
2011-04-24,2011,April,21,Sunday,Summer,Light Snow/Rain,61,53,8
2011-04-24,2011,April,22,Sunday,Summer,Light Snow/Rain,45,40,5
2011-04-24,2011,April,23,Sunday,Summer,Light Snow/Rain,42,37,5
2011-04-25,2011,April,0,Monday,Summer,Light Snow/Rain,12,10,2
2011-04-25,2011,April,1,Monday,Summer,Clear,10,8,2
2011-04-25,2011,April,2,Monday,Summer,Clear,10,9,1
2011-04-25,2011,April,3,Monday,Summer,Cloudy,10,8,2
2011-04-25,2011,April,4,Monday,Summer,Cloudy,5,4,1
2011-04-25,2011,April,5,Monday,Summer,Cloudy,17,14,3
2011-04-25,2011,April,6,Monday,Summer,Cloudy,66,59,7
2011-04-25,2011,April,7,Monday,Summer,Cloudy,196,183,13
2011-04-25,2011,April,8,Monday,Summer,Clear,353,326,27
2011-04-25,2011,April,9,Monday,Summer,Clear,174,147,27
2011-04-25,2011,April,10,Monday,Summer,Clear,125,64,61
2011-04-25,2011,April,11,Monday,Summer,Clear,147,94,53
2011-04-25,2011,April,12,Monday,Summer,Clear,188,140,48
2011-04-25,2011,April,13,Monday,Summer,Clear,203,146,57
2011-04-25,2011,April,14,Monday,Summer,Clear,146,99,47
2011-04-25,2011,April,15,Monday,Summer,Clear,175,125,50
2011-04-25,2011,April,16,Monday,Summer,Clear,239,198,41
2011-04-25,2011,April,17,Monday,Summer,Clear,521,441,80
2011-04-25,2011,April,18,Monday,Summer,Clear,499,425,74
2011-04-25,2011,April,19,Monday,Summer,Clear,382,320,62
2011-04-25,2011,April,20,Monday,Summer,Clear,237,195,42
2011-04-25,2011,April,21,Monday,Summer,Clear,190,149,41
2011-04-25,2011,April,22,Monday,Summer,Clear,106,83,23
2011-04-25,2011,April,23,Monday,Summer,Clear,62,53,9
2011-04-26,2011,April,0,Tuesday,Summer,Clear,27,17,10
2011-04-26,2011,April,1,Tuesday,Summer,Clear,21,5,16
2011-04-26,2011,April,2,Tuesday,Summer,Clear,26,9,17
2011-04-26,2011,April,3,Tuesday,Summer,Clear,21,4,17
2011-04-26,2011,April,4,Tuesday,Summer,Clear,6,4,2
2011-04-26,2011,April,5,Tuesday,Summer,Clear,16,16,0
2011-04-26,2011,April,6,Tuesday,Summer,Clear,80,80,0
2011-04-26,2011,April,7,Tuesday,Summer,Clear,270,254,16
2011-04-26,2011,April,8,Tuesday,Summer,Clear,449,417,32
2011-04-26,2011,April,9,Tuesday,Summer,Clear,199,164,35
2011-04-26,2011,April,10,Tuesday,Summer,Clear,120,98,22
2011-04-26,2011,April,11,Tuesday,Summer,Clear,172,132,40
2011-04-26,2011,April,12,Tuesday,Summer,Clear,186,146,40
2011-04-26,2011,April,13,Tuesday,Summer,Clear,176,139,37
2011-04-26,2011,April,14,Tuesday,Summer,Clear,155,115,40
2011-04-26,2011,April,15,Tuesday,Summer,Clear,153,119,34
2011-04-26,2011,April,16,Tuesday,Summer,Clear,291,251,40
2011-04-26,2011,April,17,Tuesday,Summer,Clear,521,455,66
2011-04-26,2011,April,18,Tuesday,Summer,Clear,528,463,65
2011-04-26,2011,April,19,Tuesday,Summer,Clear,328,286,42
2011-04-26,2011,April,20,Tuesday,Summer,Clear,234,199,35
2011-04-26,2011,April,21,Tuesday,Summer,Clear,195,162,33
2011-04-26,2011,April,22,Tuesday,Summer,Cloudy,148,116,32
2011-04-26,2011,April,23,Tuesday,Summer,Cloudy,78,71,7
2011-04-27,2011,April,0,Wednesday,Summer,Clear,27,24,3
2011-04-27,2011,April,1,Wednesday,Summer,Clear,17,15,2
2011-04-27,2011,April,2,Wednesday,Summer,Clear,5,5,0
2011-04-27,2011,April,3,Wednesday,Summer,Cloudy,7,4,3
2011-04-27,2011,April,4,Wednesday,Summer,Clear,6,6,0
2011-04-27,2011,April,5,Wednesday,Summer,Cloudy,17,16,1
2011-04-27,2011,April,6,Wednesday,Summer,Clear,84,79,5
2011-04-27,2011,April,7,Wednesday,Summer,Cloudy,246,229,17
2011-04-27,2011,April,8,Wednesday,Summer,Cloudy,444,413,31
2011-04-27,2011,April,9,Wednesday,Summer,Cloudy,181,161,20
2011-04-27,2011,April,10,Wednesday,Summer,Cloudy,92,66,26
2011-04-27,2011,April,11,Wednesday,Summer,Cloudy,156,103,53
2011-04-27,2011,April,12,Wednesday,Summer,Clear,173,135,38
2011-04-27,2011,April,13,Wednesday,Summer,Clear,150,119,31
2011-04-27,2011,April,14,Wednesday,Summer,Clear,148,119,29
2011-04-27,2011,April,15,Wednesday,Summer,Clear,138,120,18
2011-04-27,2011,April,16,Wednesday,Summer,Clear,218,189,29
2011-04-27,2011,April,17,Wednesday,Summer,Light Snow/Rain,521,458,63
2011-04-27,2011,April,18,Wednesday,Summer,Light Snow/Rain,412,366,46
2011-04-27,2011,April,19,Wednesday,Summer,Clear,260,220,40
2011-04-27,2011,April,20,Wednesday,Summer,Clear,218,188,30
2011-04-27,2011,April,21,Wednesday,Summer,Clear,145,126,19
2011-04-27,2011,April,22,Wednesday,Summer,Cloudy,129,111,18
2011-04-27,2011,April,23,Wednesday,Summer,Cloudy,78,53,25
2011-04-28,2011,April,0,Thursday,Summer,Clear,54,41,13
2011-04-28,2011,April,1,Thursday,Summer,Cloudy,20,12,8
2011-04-28,2011,April,2,Thursday,Summer,Cloudy,21,7,14
2011-04-28,2011,April,3,Thursday,Summer,Cloudy,3,1,2
2011-04-28,2011,April,4,Thursday,Summer,Cloudy,9,5,4
2011-04-28,2011,April,5,Thursday,Summer,Cloudy,13,13,0
2011-04-28,2011,April,6,Thursday,Summer,Cloudy,86,79,7
2011-04-28,2011,April,7,Thursday,Summer,Cloudy,215,201,14
2011-04-28,2011,April,8,Thursday,Summer,Cloudy,398,367,31
2011-04-28,2011,April,9,Thursday,Summer,Light Snow/Rain,183,165,18
2011-04-28,2011,April,10,Thursday,Summer,Cloudy,54,45,9
2011-04-28,2011,April,11,Thursday,Summer,Cloudy,84,74,10
2011-04-28,2011,April,12,Thursday,Summer,Cloudy,107,84,23
2011-04-28,2011,April,13,Thursday,Summer,Cloudy,121,103,18
2011-04-28,2011,April,14,Thursday,Summer,Clear,142,121,21
2011-04-28,2011,April,15,Thursday,Summer,Clear,163,117,46
2011-04-28,2011,April,16,Thursday,Summer,Clear,270,228,42
2011-04-28,2011,April,17,Thursday,Summer,Clear,455,406,49
2011-04-28,2011,April,18,Thursday,Summer,Clear,530,486,44
2011-04-28,2011,April,19,Thursday,Summer,Clear,404,347,57
2011-04-28,2011,April,20,Thursday,Summer,Clear,269,220,49
2011-04-28,2011,April,21,Thursday,Summer,Clear,194,167,27
2011-04-28,2011,April,22,Thursday,Summer,Clear,153,119,34
2011-04-28,2011,April,23,Thursday,Summer,Clear,110,81,29
2011-04-29,2011,April,0,Friday,Summer,Clear,48,37,11
2011-04-29,2011,April,1,Friday,Summer,Clear,31,21,10
2011-04-29,2011,April,2,Friday,Summer,Clear,10,8,2
2011-04-29,2011,April,3,Friday,Summer,Clear,5,4,1
2011-04-29,2011,April,4,Friday,Summer,Clear,6,6,0
2011-04-29,2011,April,5,Friday,Summer,Clear,25,25,0
2011-04-29,2011,April,6,Friday,Summer,Clear,71,67,4
2011-04-29,2011,April,7,Friday,Summer,Clear,240,222,18
2011-04-29,2011,April,8,Friday,Summer,Clear,421,386,35
2011-04-29,2011,April,9,Friday,Summer,Clear,230,185,45
2011-04-29,2011,April,10,Friday,Summer,Clear,156,99,57
2011-04-29,2011,April,11,Friday,Summer,Clear,157,108,49
2011-04-29,2011,April,12,Friday,Summer,Clear,223,160,63
2011-04-29,2011,April,13,Friday,Summer,Clear,308,234,74
2011-04-29,2011,April,14,Friday,Summer,Clear,248,190,58
2011-04-29,2011,April,15,Friday,Summer,Cloudy,252,175,77
2011-04-29,2011,April,16,Friday,Summer,Cloudy,299,240,59
2011-04-29,2011,April,17,Friday,Summer,Cloudy,508,433,75
2011-04-29,2011,April,18,Friday,Summer,Clear,439,384,55
2011-04-29,2011,April,19,Friday,Summer,Clear,270,230,40
2011-04-29,2011,April,20,Friday,Summer,Clear,194,160,34
2011-04-29,2011,April,21,Friday,Summer,Clear,195,145,50
2011-04-29,2011,April,22,Friday,Summer,Clear,146,110,36
2011-04-29,2011,April,23,Friday,Summer,Cloudy,113,88,25
2011-04-30,2011,April,0,Saturday,Summer,Cloudy,106,73,33
2011-04-30,2011,April,1,Saturday,Summer,Cloudy,74,59,15
2011-04-30,2011,April,2,Saturday,Summer,Cloudy,65,53,12
2011-04-30,2011,April,3,Saturday,Summer,Cloudy,17,13,4
2011-04-30,2011,April,4,Saturday,Summer,Cloudy,7,5,2
2011-04-30,2011,April,5,Saturday,Summer,Clear,7,4,3
2011-04-30,2011,April,6,Saturday,Summer,Clear,21,11,10
2011-04-30,2011,April,7,Saturday,Summer,Clear,48,27,21
2011-04-30,2011,April,8,Saturday,Summer,Clear,91,70,21
2011-04-30,2011,April,9,Saturday,Summer,Clear,156,121,35
2011-04-30,2011,April,10,Saturday,Summer,Clear,279,185,94
2011-04-30,2011,April,11,Saturday,Summer,Clear,321,201,120
2011-04-30,2011,April,12,Saturday,Summer,Clear,416,238,178
2011-04-30,2011,April,13,Saturday,Summer,Clear,455,270,185
2011-04-30,2011,April,14,Saturday,Summer,Clear,452,268,184
2011-04-30,2011,April,15,Saturday,Summer,Clear,499,282,217
2011-04-30,2011,April,16,Saturday,Summer,Clear,464,273,191
2011-04-30,2011,April,17,Saturday,Summer,Clear,407,245,162
2011-04-30,2011,April,18,Saturday,Summer,Clear,371,237,134
2011-04-30,2011,April,19,Saturday,Summer,Clear,387,237,150
2011-04-30,2011,April,20,Saturday,Summer,Clear,224,159,65
2011-04-30,2011,April,21,Saturday,Summer,Clear,177,119,58
2011-04-30,2011,April,22,Saturday,Summer,Clear,143,106,37
2011-04-30,2011,April,23,Saturday,Summer,Clear,125,91,34
2011-05-01,2011,May,0,Sunday,Summer,Clear,96,77,19
2011-05-01,2011,May,1,Sunday,Summer,Clear,59,50,9
2011-05-01,2011,May,2,Sunday,Summer,Clear,50,43,7
2011-05-01,2011,May,3,Sunday,Summer,Clear,23,15,8
2011-05-01,2011,May,4,Sunday,Summer,Clear,17,11,6
2011-05-01,2011,May,5,Sunday,Summer,Clear,10,10,0
2011-05-01,2011,May,6,Sunday,Summer,Cloudy,13,9,4
2011-05-01,2011,May,7,Sunday,Summer,Cloudy,33,26,7
2011-05-01,2011,May,8,Sunday,Summer,Cloudy,59,43,16
2011-05-01,2011,May,9,Sunday,Summer,Cloudy,141,96,45
2011-05-01,2011,May,10,Sunday,Summer,Cloudy,264,155,109
2011-05-01,2011,May,11,Sunday,Summer,Clear,250,141,109
2011-05-01,2011,May,12,Sunday,Summer,Cloudy,281,172,109
2011-05-01,2011,May,13,Sunday,Summer,Cloudy,332,209,123
2011-05-01,2011,May,14,Sunday,Summer,Cloudy,238,153,85
2011-05-01,2011,May,15,Sunday,Summer,Cloudy,266,153,113
2011-05-01,2011,May,16,Sunday,Summer,Cloudy,214,139,75
2011-05-01,2011,May,17,Sunday,Summer,Cloudy,196,136,60
2011-05-01,2011,May,18,Sunday,Summer,Cloudy,159,126,33
2011-05-01,2011,May,19,Sunday,Summer,Cloudy,178,131,47
2011-05-01,2011,May,20,Sunday,Summer,Cloudy,121,86,35
2011-05-01,2011,May,21,Sunday,Summer,Cloudy,105,82,23
2011-05-01,2011,May,22,Sunday,Summer,Cloudy,100,68,32
2011-05-01,2011,May,23,Sunday,Summer,Clear,146,82,64
2011-05-02,2011,May,0,Monday,Summer,Clear,177,109,68
2011-05-02,2011,May,1,Monday,Summer,Clear,114,73,41
2011-05-02,2011,May,2,Monday,Summer,Cloudy,35,19,16
2011-05-02,2011,May,3,Monday,Summer,Clear,16,7,9
2011-05-02,2011,May,4,Monday,Summer,Clear,17,8,9
2011-05-02,2011,May,5,Monday,Summer,Cloudy,20,16,4
2011-05-02,2011,May,6,Monday,Summer,Clear,62,59,3
2011-05-02,2011,May,7,Monday,Summer,Cloudy,209,193,16
2011-05-02,2011,May,8,Monday,Summer,Cloudy,371,350,21
2011-05-02,2011,May,9,Monday,Summer,Cloudy,172,131,41
2011-05-02,2011,May,10,Monday,Summer,Cloudy,108,77,31
2011-05-02,2011,May,11,Monday,Summer,Clear,130,96,34
2011-05-02,2011,May,12,Monday,Summer,Clear,187,147,40
2011-05-02,2011,May,13,Monday,Summer,Cloudy,170,119,51
2011-05-02,2011,May,14,Monday,Summer,Clear,181,133,48
2011-05-02,2011,May,15,Monday,Summer,Clear,155,110,45
2011-05-02,2011,May,16,Monday,Summer,Clear,269,220,49
2011-05-02,2011,May,17,Monday,Summer,Clear,537,472,65
2011-05-02,2011,May,18,Monday,Summer,Cloudy,518,450,68
2011-05-02,2011,May,19,Monday,Summer,Cloudy,314,268,46
2011-05-02,2011,May,20,Monday,Summer,Cloudy,218,174,44
2011-05-02,2011,May,21,Monday,Summer,Cloudy,232,178,54
2011-05-02,2011,May,22,Monday,Summer,Cloudy,125,97,28
2011-05-02,2011,May,23,Monday,Summer,Cloudy,64,48,16
2011-05-03,2011,May,0,Tuesday,Summer,Cloudy,16,16,0
2011-05-03,2011,May,1,Tuesday,Summer,Cloudy,14,14,0
2011-05-03,2011,May,2,Tuesday,Summer,Cloudy,5,5,0
2011-05-03,2011,May,3,Tuesday,Summer,Clear,2,2,0
2011-05-03,2011,May,4,Tuesday,Summer,Clear,4,1,3
2011-05-03,2011,May,5,Tuesday,Summer,Clear,14,14,0
2011-05-03,2011,May,6,Tuesday,Summer,Cloudy,109,102,7
2011-05-03,2011,May,7,Tuesday,Summer,Cloudy,265,248,17
2011-05-03,2011,May,8,Tuesday,Summer,Cloudy,459,435,24
2011-05-03,2011,May,9,Tuesday,Summer,Cloudy,186,157,29
2011-05-03,2011,May,10,Tuesday,Summer,Cloudy,127,91,36
2011-05-03,2011,May,11,Tuesday,Summer,Cloudy,140,120,20
2011-05-03,2011,May,12,Tuesday,Summer,Cloudy,217,169,48
2011-05-03,2011,May,13,Tuesday,Summer,Cloudy,194,144,50
2011-05-03,2011,May,14,Tuesday,Summer,Cloudy,158,122,36
2011-05-03,2011,May,15,Tuesday,Summer,Cloudy,154,117,37
2011-05-03,2011,May,16,Tuesday,Summer,Clear,271,225,46
2011-05-03,2011,May,17,Tuesday,Summer,Clear,517,464,53
2011-05-03,2011,May,18,Tuesday,Summer,Clear,544,485,59
2011-05-03,2011,May,19,Tuesday,Summer,Clear,365,323,42
2011-05-03,2011,May,20,Tuesday,Summer,Clear,290,262,28
2011-05-03,2011,May,21,Tuesday,Summer,Cloudy,225,183,42
2011-05-03,2011,May,22,Tuesday,Summer,Cloudy,113,99,14
2011-05-03,2011,May,23,Tuesday,Summer,Cloudy,62,50,12
2011-05-04,2011,May,0,Wednesday,Summer,Light Snow/Rain,27,22,5
2011-05-04,2011,May,1,Wednesday,Summer,Light Snow/Rain,7,6,1
2011-05-04,2011,May,2,Wednesday,Summer,Light Snow/Rain,4,4,0
2011-05-04,2011,May,3,Wednesday,Summer,Light Snow/Rain,1,1,0
2011-05-04,2011,May,4,Wednesday,Summer,Light Snow/Rain,3,2,1
2011-05-04,2011,May,5,Wednesday,Summer,Light Snow/Rain,9,8,1
2011-05-04,2011,May,6,Wednesday,Summer,Light Snow/Rain,21,21,0
2011-05-04,2011,May,7,Wednesday,Summer,Light Snow/Rain,52,46,6
2011-05-04,2011,May,8,Wednesday,Summer,Light Snow/Rain,79,74,5
2011-05-04,2011,May,9,Wednesday,Summer,Light Snow/Rain,40,35,5
2011-05-04,2011,May,10,Wednesday,Summer,Cloudy,31,26,5
2011-05-04,2011,May,11,Wednesday,Summer,Clear,72,69,3
2011-05-04,2011,May,12,Wednesday,Summer,Cloudy,124,105,19
2011-05-04,2011,May,13,Wednesday,Summer,Cloudy,143,128,15
2011-05-04,2011,May,14,Wednesday,Summer,Clear,107,94,13
2011-05-04,2011,May,15,Wednesday,Summer,Clear,129,107,22
2011-05-04,2011,May,16,Wednesday,Summer,Clear,195,173,22
2011-05-04,2011,May,17,Wednesday,Summer,Clear,410,388,22
2011-05-04,2011,May,18,Wednesday,Summer,Clear,396,367,29
2011-05-04,2011,May,19,Wednesday,Summer,Clear,296,266,30
2011-05-04,2011,May,20,Wednesday,Summer,Clear,191,174,17
2011-05-04,2011,May,21,Wednesday,Summer,Clear,150,133,17
2011-05-04,2011,May,22,Wednesday,Summer,Clear,89,80,9
2011-05-04,2011,May,23,Wednesday,Summer,Clear,57,49,8
2011-05-05,2011,May,0,Thursday,Summer,Clear,27,23,4
2011-05-05,2011,May,1,Thursday,Summer,Clear,10,6,4
2011-05-05,2011,May,2,Thursday,Summer,Clear,5,4,1
2011-05-05,2011,May,3,Thursday,Summer,Clear,4,4,0
2011-05-05,2011,May,4,Thursday,Summer,Clear,7,3,4
2011-05-05,2011,May,5,Thursday,Summer,Clear,30,29,1
2011-05-05,2011,May,6,Thursday,Summer,Clear,89,86,3
2011-05-05,2011,May,7,Thursday,Summer,Clear,271,255,16
2011-05-05,2011,May,8,Thursday,Summer,Clear,440,415,25
2011-05-05,2011,May,9,Thursday,Summer,Clear,184,164,20
2011-05-05,2011,May,10,Thursday,Summer,Clear,128,98,30
2011-05-05,2011,May,11,Thursday,Summer,Clear,148,105,43
2011-05-05,2011,May,12,Thursday,Summer,Clear,196,169,27
2011-05-05,2011,May,13,Thursday,Summer,Clear,192,142,50
2011-05-05,2011,May,14,Thursday,Summer,Clear,154,135,19
2011-05-05,2011,May,15,Thursday,Summer,Clear,147,120,27
2011-05-05,2011,May,16,Thursday,Summer,Clear,269,233,36
2011-05-05,2011,May,17,Thursday,Summer,Clear,533,467,66
2011-05-05,2011,May,18,Thursday,Summer,Clear,520,456,64
2011-05-05,2011,May,19,Thursday,Summer,Clear,361,305,56
2011-05-05,2011,May,20,Thursday,Summer,Clear,258,225,33
2011-05-05,2011,May,21,Thursday,Summer,Clear,180,141,39
2011-05-05,2011,May,22,Thursday,Summer,Clear,165,135,30
2011-05-05,2011,May,23,Thursday,Summer,Clear,115,99,16
2011-05-06,2011,May,0,Friday,Summer,Clear,56,43,13
2011-05-06,2011,May,1,Friday,Summer,Clear,32,24,8
2011-05-06,2011,May,2,Friday,Summer,Clear,16,15,1
2011-05-06,2011,May,3,Friday,Summer,Clear,9,6,3
2011-05-06,2011,May,4,Friday,Summer,Clear,1,1,0
2011-05-06,2011,May,5,Friday,Summer,Clear,16,16,0
2011-05-06,2011,May,6,Friday,Summer,Clear,82,74,8
2011-05-06,2011,May,7,Friday,Summer,Clear,222,202,20
2011-05-06,2011,May,8,Friday,Summer,Clear,450,415,35
2011-05-06,2011,May,9,Friday,Summer,Clear,188,161,27
2011-05-06,2011,May,10,Friday,Summer,Cloudy,127,97,30
2011-05-06,2011,May,11,Friday,Summer,Cloudy,165,123,42
2011-05-06,2011,May,12,Friday,Summer,Clear,246,198,48
2011-05-06,2011,May,13,Friday,Summer,Clear,253,182,71
2011-05-06,2011,May,14,Friday,Summer,Clear,213,127,86
2011-05-06,2011,May,15,Friday,Summer,Clear,260,171,89
2011-05-06,2011,May,16,Friday,Summer,Clear,344,262,82
2011-05-06,2011,May,17,Friday,Summer,Clear,553,470,83
2011-05-06,2011,May,18,Friday,Summer,Light Snow/Rain,470,385,85
2011-05-06,2011,May,19,Friday,Summer,Light Snow/Rain,292,253,39
2011-05-06,2011,May,20,Friday,Summer,Clear,190,161,29
2011-05-06,2011,May,21,Friday,Summer,Clear,152,130,22
2011-05-06,2011,May,22,Friday,Summer,Clear,151,105,46
2011-05-06,2011,May,23,Friday,Summer,Clear,120,93,27
2011-05-07,2011,May,0,Saturday,Summer,Clear,86,76,10
2011-05-07,2011,May,1,Saturday,Summer,Clear,58,50,8
2011-05-07,2011,May,2,Saturday,Summer,Clear,52,47,5
2011-05-07,2011,May,3,Saturday,Summer,Clear,18,9,9
2011-05-07,2011,May,4,Saturday,Summer,Clear,5,4,1
2011-05-07,2011,May,5,Saturday,Summer,Clear,7,3,4
2011-05-07,2011,May,6,Saturday,Summer,Clear,13,12,1
2011-05-07,2011,May,7,Saturday,Summer,Clear,40,32,8
2011-05-07,2011,May,8,Saturday,Summer,Clear,115,96,19
2011-05-07,2011,May,9,Saturday,Summer,Clear,218,164,54
2011-05-07,2011,May,10,Saturday,Summer,Clear,298,208,90
2011-05-07,2011,May,11,Saturday,Summer,Clear,347,215,132
2011-05-07,2011,May,12,Saturday,Summer,Clear,373,244,129
2011-05-07,2011,May,13,Saturday,Summer,Clear,436,240,196
2011-05-07,2011,May,14,Saturday,Summer,Light Snow/Rain,378,235,143
2011-05-07,2011,May,15,Saturday,Summer,Clear,378,230,148
2011-05-07,2011,May,16,Saturday,Summer,Clear,342,223,119
2011-05-07,2011,May,17,Saturday,Summer,Clear,354,216,138
2011-05-07,2011,May,18,Saturday,Summer,Clear,289,175,114
2011-05-07,2011,May,19,Saturday,Summer,Clear,267,179,88
2011-05-07,2011,May,20,Saturday,Summer,Clear,219,137,82
2011-05-07,2011,May,21,Saturday,Summer,Clear,182,124,58
2011-05-07,2011,May,22,Saturday,Summer,Clear,120,94,26
2011-05-07,2011,May,23,Saturday,Summer,Clear,119,89,30
2011-05-08,2011,May,0,Sunday,Summer,Cloudy,100,78,22
2011-05-08,2011,May,1,Sunday,Summer,Cloudy,64,56,8
2011-05-08,2011,May,2,Sunday,Summer,Clear,59,42,17
2011-05-08,2011,May,3,Sunday,Summer,Clear,31,21,10
2011-05-08,2011,May,4,Sunday,Summer,Clear,10,8,2
2011-05-08,2011,May,5,Sunday,Summer,Cloudy,5,5,0
2011-05-08,2011,May,6,Sunday,Summer,Cloudy,6,4,2
2011-05-08,2011,May,7,Sunday,Summer,Cloudy,23,15,8
2011-05-08,2011,May,8,Sunday,Summer,Clear,86,58,28
2011-05-08,2011,May,9,Sunday,Summer,Clear,160,112,48
2011-05-08,2011,May,10,Sunday,Summer,Clear,244,153,91
2011-05-08,2011,May,11,Sunday,Summer,Clear,340,198,142
2011-05-08,2011,May,12,Sunday,Summer,Clear,382,243,139
2011-05-08,2011,May,13,Sunday,Summer,Clear,390,224,166
2011-05-08,2011,May,14,Sunday,Summer,Clear,366,240,126
2011-05-08,2011,May,15,Sunday,Summer,Clear,358,230,128
2011-05-08,2011,May,16,Sunday,Summer,Clear,385,263,122
2011-05-08,2011,May,17,Sunday,Summer,Light Snow/Rain,351,245,106
2011-05-08,2011,May,18,Sunday,Summer,Clear,268,205,63
2011-05-08,2011,May,19,Sunday,Summer,Clear,239,178,61
2011-05-08,2011,May,20,Sunday,Summer,Clear,174,132,42
2011-05-08,2011,May,21,Sunday,Summer,Clear,127,95,32
2011-05-08,2011,May,22,Sunday,Summer,Clear,115,86,29
2011-05-08,2011,May,23,Sunday,Summer,Clear,50,41,9
2011-05-09,2011,May,0,Monday,Summer,Clear,53,22,31
2011-05-09,2011,May,1,Monday,Summer,Clear,33,8,25
2011-05-09,2011,May,2,Monday,Summer,Clear,8,2,6
2011-05-09,2011,May,3,Monday,Summer,Clear,7,7,0
2011-05-09,2011,May,4,Monday,Summer,Clear,4,4,0
2011-05-09,2011,May,5,Monday,Summer,Clear,23,23,0
2011-05-09,2011,May,6,Monday,Summer,Clear,89,87,2
2011-05-09,2011,May,7,Monday,Summer,Clear,237,221,16
2011-05-09,2011,May,8,Monday,Summer,Clear,374,351,23
2011-05-09,2011,May,9,Monday,Summer,Clear,178,142,36
2011-05-09,2011,May,10,Monday,Summer,Clear,119,95,24
2011-05-09,2011,May,11,Monday,Summer,Clear,125,99,26
2011-05-09,2011,May,12,Monday,Summer,Clear,195,160,35
2011-05-09,2011,May,13,Monday,Summer,Clear,174,138,36
2011-05-09,2011,May,14,Monday,Summer,Clear,162,118,44
2011-05-09,2011,May,15,Monday,Summer,Clear,199,148,51
2011-05-09,2011,May,16,Monday,Summer,Clear,304,255,49
2011-05-09,2011,May,17,Monday,Summer,Clear,598,539,59
2011-05-09,2011,May,18,Monday,Summer,Clear,524,458,66
2011-05-09,2011,May,19,Monday,Summer,Clear,384,339,45
2011-05-09,2011,May,20,Monday,Summer,Clear,239,214,25
2011-05-09,2011,May,21,Monday,Summer,Clear,156,128,28
2011-05-09,2011,May,22,Monday,Summer,Clear,116,95,21
2011-05-09,2011,May,23,Monday,Summer,Clear,61,45,16
2011-05-10,2011,May,0,Tuesday,Summer,Clear,18,12,6
2011-05-10,2011,May,1,Tuesday,Summer,Clear,15,12,3
2011-05-10,2011,May,2,Tuesday,Summer,Clear,5,4,1
2011-05-10,2011,May,3,Tuesday,Summer,Clear,4,3,1
2011-05-10,2011,May,4,Tuesday,Summer,Clear,2,2,0
2011-05-10,2011,May,5,Tuesday,Summer,Clear,29,28,1
2011-05-10,2011,May,6,Tuesday,Summer,Clear,112,103,9
2011-05-10,2011,May,7,Tuesday,Summer,Cloudy,314,301,13
2011-05-10,2011,May,8,Tuesday,Summer,Cloudy,425,397,28
2011-05-10,2011,May,9,Tuesday,Summer,Cloudy,205,176,29
2011-05-10,2011,May,10,Tuesday,Summer,Cloudy,127,100,27
2011-05-10,2011,May,11,Tuesday,Summer,Cloudy,125,108,17
2011-05-10,2011,May,12,Tuesday,Summer,Cloudy,217,170,47
2011-05-10,2011,May,13,Tuesday,Summer,Cloudy,202,152,50
2011-05-10,2011,May,14,Tuesday,Summer,Cloudy,176,134,42
2011-05-10,2011,May,15,Tuesday,Summer,Cloudy,180,152,28
2011-05-10,2011,May,16,Tuesday,Summer,Clear,327,271,56
2011-05-10,2011,May,17,Tuesday,Summer,Clear,611,532,79
2011-05-10,2011,May,18,Tuesday,Summer,Clear,550,480,70
2011-05-10,2011,May,19,Tuesday,Summer,Clear,434,365,69
2011-05-10,2011,May,20,Tuesday,Summer,Clear,291,241,50
2011-05-10,2011,May,21,Tuesday,Summer,Clear,203,173,30
2011-05-10,2011,May,22,Tuesday,Summer,Clear,150,121,29
2011-05-10,2011,May,23,Tuesday,Summer,Cloudy,81,72,9
2011-05-11,2011,May,0,Wednesday,Summer,Cloudy,38,30,8
2011-05-11,2011,May,1,Wednesday,Summer,Cloudy,20,16,4
2011-05-11,2011,May,2,Wednesday,Summer,Clear,10,4,6
2011-05-11,2011,May,3,Wednesday,Summer,Clear,3,3,0
2011-05-11,2011,May,4,Wednesday,Summer,Cloudy,2,2,0
2011-05-11,2011,May,5,Wednesday,Summer,Clear,20,20,0
2011-05-11,2011,May,6,Wednesday,Summer,Clear,99,93,6
2011-05-11,2011,May,7,Wednesday,Summer,Clear,318,293,25
2011-05-11,2011,May,8,Wednesday,Summer,Clear,442,421,21
2011-05-11,2011,May,9,Wednesday,Summer,Clear,203,182,21
2011-05-11,2011,May,10,Wednesday,Summer,Clear,154,124,30
2011-05-11,2011,May,11,Wednesday,Summer,Clear,141,123,18
2011-05-11,2011,May,12,Wednesday,Summer,Clear,226,185,41
2011-05-11,2011,May,13,Wednesday,Summer,Clear,193,157,36
2011-05-11,2011,May,14,Wednesday,Summer,Clear,177,141,36
2011-05-11,2011,May,15,Wednesday,Summer,Clear,179,131,48
2011-05-11,2011,May,16,Wednesday,Summer,Clear,289,240,49
2011-05-11,2011,May,17,Wednesday,Summer,Clear,259,242,17
2011-05-11,2011,May,18,Wednesday,Summer,Clear,274,234,40
2011-05-11,2011,May,19,Wednesday,Summer,Clear,401,341,60
2011-05-11,2011,May,20,Wednesday,Summer,Clear,273,245,28
2011-05-11,2011,May,21,Wednesday,Summer,Clear,234,202,32
2011-05-11,2011,May,22,Wednesday,Summer,Clear,146,134,12
2011-05-11,2011,May,23,Wednesday,Summer,Clear,81,69,12
2011-05-12,2011,May,0,Thursday,Summer,Cloudy,44,39,5
2011-05-12,2011,May,1,Thursday,Summer,Clear,17,16,1
2011-05-12,2011,May,2,Thursday,Summer,Clear,15,14,1
2011-05-12,2011,May,3,Thursday,Summer,Clear,5,5,0
2011-05-12,2011,May,4,Thursday,Summer,Clear,6,5,1
2011-05-12,2011,May,5,Thursday,Summer,Clear,29,27,2
2011-05-12,2011,May,6,Thursday,Summer,Clear,112,103,9
2011-05-12,2011,May,7,Thursday,Summer,Clear,297,283,14
2011-05-12,2011,May,8,Thursday,Summer,Clear,421,394,27
2011-05-12,2011,May,9,Thursday,Summer,Cloudy,212,191,21
2011-05-12,2011,May,10,Thursday,Summer,Cloudy,147,119,28
2011-05-12,2011,May,11,Thursday,Summer,Clear,179,136,43
2011-05-12,2011,May,12,Thursday,Summer,Clear,207,164,43
2011-05-12,2011,May,13,Thursday,Summer,Cloudy,218,170,48
2011-05-12,2011,May,14,Thursday,Summer,Cloudy,191,148,43
2011-05-12,2011,May,15,Thursday,Summer,Cloudy,217,163,54
2011-05-12,2011,May,16,Thursday,Summer,Cloudy,288,238,50
2011-05-12,2011,May,17,Thursday,Summer,Cloudy,594,540,54
2011-05-12,2011,May,18,Thursday,Summer,Clear,527,463,64
2011-05-12,2011,May,19,Thursday,Summer,Cloudy,364,305,59
2011-05-12,2011,May,20,Thursday,Summer,Clear,276,220,56
2011-05-12,2011,May,21,Thursday,Summer,Clear,223,192,31
2011-05-12,2011,May,22,Thursday,Summer,Clear,172,147,25
2011-05-12,2011,May,23,Thursday,Summer,Cloudy,103,87,16
2011-05-13,2011,May,0,Friday,Summer,Cloudy,52,46,6
2011-05-13,2011,May,1,Friday,Summer,Clear,20,15,5
2011-05-13,2011,May,2,Friday,Summer,Cloudy,11,8,3
2011-05-13,2011,May,3,Friday,Summer,Cloudy,4,2,2
2011-05-13,2011,May,4,Friday,Summer,Light Snow/Rain,5,3,2
2011-05-13,2011,May,5,Friday,Summer,Cloudy,25,24,1
2011-05-13,2011,May,6,Friday,Summer,Light Snow/Rain,82,76,6
2011-05-13,2011,May,7,Friday,Summer,Light Snow/Rain,157,141,16
2011-05-13,2011,May,8,Friday,Summer,Cloudy,387,361,26
2011-05-13,2011,May,9,Friday,Summer,Cloudy,233,215,18
2011-05-13,2011,May,10,Friday,Summer,Cloudy,130,99,31
2011-05-13,2011,May,11,Friday,Summer,Cloudy,146,90,56
2011-05-13,2011,May,12,Friday,Summer,Cloudy,223,170,53
2011-05-13,2011,May,13,Friday,Summer,Cloudy,226,157,69
2011-05-13,2011,May,14,Friday,Summer,Cloudy,190,120,70
2011-05-13,2011,May,15,Friday,Summer,Cloudy,198,142,56
2011-05-13,2011,May,16,Friday,Summer,Cloudy,300,256,44
2011-05-13,2011,May,17,Friday,Summer,Light Snow/Rain,491,429,62
2011-05-13,2011,May,18,Friday,Summer,Light Snow/Rain,398,359,39
2011-05-13,2011,May,19,Friday,Summer,Cloudy,270,245,25
2011-05-13,2011,May,20,Friday,Summer,Cloudy,152,130,22
2011-05-13,2011,May,21,Friday,Summer,Cloudy,154,130,24
2011-05-13,2011,May,22,Friday,Summer,Cloudy,132,107,25
2011-05-13,2011,May,23,Friday,Summer,Light Snow/Rain,119,88,31
2011-05-14,2011,May,0,Saturday,Summer,Cloudy,102,78,24
2011-05-14,2011,May,1,Saturday,Summer,Cloudy,82,64,18
2011-05-14,2011,May,2,Saturday,Summer,Cloudy,52,37,15
2011-05-14,2011,May,3,Saturday,Summer,Cloudy,35,30,5
2011-05-14,2011,May,4,Saturday,Summer,Cloudy,5,4,1
2011-05-14,2011,May,5,Saturday,Summer,Cloudy,14,7,7
2011-05-14,2011,May,6,Saturday,Summer,Cloudy,11,9,2
2011-05-14,2011,May,7,Saturday,Summer,Light Snow/Rain,32,28,4
2011-05-14,2011,May,8,Saturday,Summer,Light Snow/Rain,88,72,16
2011-05-14,2011,May,9,Saturday,Summer,Cloudy,100,86,14
2011-05-14,2011,May,10,Saturday,Summer,Cloudy,167,133,34
2011-05-14,2011,May,11,Saturday,Summer,Cloudy,279,207,72
2011-05-14,2011,May,12,Saturday,Summer,Light Snow/Rain,279,204,75
2011-05-14,2011,May,13,Saturday,Summer,Light Snow/Rain,248,180,68
2011-05-14,2011,May,14,Saturday,Summer,Cloudy,216,159,57
2011-05-14,2011,May,15,Saturday,Summer,Cloudy,294,221,73
2011-05-14,2011,May,16,Saturday,Summer,Cloudy,295,188,107
2011-05-14,2011,May,17,Saturday,Summer,Cloudy,272,194,78
2011-05-14,2011,May,18,Saturday,Summer,Cloudy,304,216,88
2011-05-14,2011,May,19,Saturday,Summer,Light Snow/Rain,248,179,69
2011-05-14,2011,May,20,Saturday,Summer,Light Snow/Rain,157,115,42
2011-05-14,2011,May,21,Saturday,Summer,Light Snow/Rain,59,44,15
2011-05-14,2011,May,22,Saturday,Summer,Light Snow/Rain,26,19,7
2011-05-14,2011,May,23,Saturday,Summer,Light Snow/Rain,44,33,11
2011-05-15,2011,May,0,Sunday,Summer,Cloudy,39,34,5
2011-05-15,2011,May,1,Sunday,Summer,Cloudy,47,43,4
2011-05-15,2011,May,2,Sunday,Summer,Cloudy,50,37,13
2011-05-15,2011,May,3,Sunday,Summer,Cloudy,32,21,11
2011-05-15,2011,May,4,Sunday,Summer,Cloudy,13,8,5
2011-05-15,2011,May,5,Sunday,Summer,Light Snow/Rain,14,11,3
2011-05-15,2011,May,6,Sunday,Summer,Cloudy,17,14,3
2011-05-15,2011,May,7,Sunday,Summer,Cloudy,42,38,4
2011-05-15,2011,May,8,Sunday,Summer,Cloudy,70,46,24
2011-05-15,2011,May,9,Sunday,Summer,Clear,134,98,36
2011-05-15,2011,May,10,Sunday,Summer,Clear,226,153,73
2011-05-15,2011,May,11,Sunday,Summer,Clear,322,202,120
2011-05-15,2011,May,12,Sunday,Summer,Clear,367,247,120
2011-05-15,2011,May,13,Sunday,Summer,Clear,456,261,195
2011-05-15,2011,May,14,Sunday,Summer,Clear,437,254,183
2011-05-15,2011,May,15,Sunday,Summer,Clear,459,253,206
2011-05-15,2011,May,16,Sunday,Summer,Clear,440,282,158
2011-05-15,2011,May,17,Sunday,Summer,Light Snow/Rain,392,255,137
2011-05-15,2011,May,18,Sunday,Summer,Clear,237,177,60
2011-05-15,2011,May,19,Sunday,Summer,Clear,231,153,78
2011-05-15,2011,May,20,Sunday,Summer,Clear,191,138,53
2011-05-15,2011,May,21,Sunday,Summer,Clear,151,107,44
2011-05-15,2011,May,22,Sunday,Summer,Clear,117,88,29
2011-05-15,2011,May,23,Sunday,Summer,Clear,69,51,18
2011-05-16,2011,May,0,Monday,Summer,Clear,38,21,17
2011-05-16,2011,May,1,Monday,Summer,Clear,14,8,6
2011-05-16,2011,May,2,Monday,Summer,Clear,13,9,4
2011-05-16,2011,May,3,Monday,Summer,Clear,4,3,1
2011-05-16,2011,May,4,Monday,Summer,Clear,6,5,1
2011-05-16,2011,May,5,Monday,Summer,Clear,21,20,1
2011-05-16,2011,May,6,Monday,Summer,Clear,104,93,11
2011-05-16,2011,May,7,Monday,Summer,Clear,272,245,27
2011-05-16,2011,May,8,Monday,Summer,Clear,394,366,28
2011-05-16,2011,May,9,Monday,Summer,Clear,194,156,38
2011-05-16,2011,May,10,Monday,Summer,Clear,112,75,37
2011-05-16,2011,May,11,Monday,Summer,Clear,185,129,56
2011-05-16,2011,May,12,Monday,Summer,Clear,209,137,72
2011-05-16,2011,May,13,Monday,Summer,Clear,214,153,61
2011-05-16,2011,May,14,Monday,Summer,Clear,193,117,76
2011-05-16,2011,May,15,Monday,Summer,Clear,165,110,55
2011-05-16,2011,May,16,Monday,Summer,Light Snow/Rain,226,181,45
2011-05-16,2011,May,17,Monday,Summer,Clear,274,227,47
2011-05-16,2011,May,18,Monday,Summer,Light Snow/Rain,453,398,55
2011-05-16,2011,May,19,Monday,Summer,Clear,308,272,36
2011-05-16,2011,May,20,Monday,Summer,Clear,198,167,31
2011-05-16,2011,May,21,Monday,Summer,Clear,177,149,28
2011-05-16,2011,May,22,Monday,Summer,Clear,127,105,22
2011-05-16,2011,May,23,Monday,Summer,Clear,57,39,18
2011-05-17,2011,May,0,Tuesday,Summer,Cloudy,31,18,13
2011-05-17,2011,May,1,Tuesday,Summer,Light Snow/Rain,13,6,7
2011-05-17,2011,May,2,Tuesday,Summer,Light Snow/Rain,8,4,4
2011-05-17,2011,May,3,Tuesday,Summer,Light Snow/Rain,4,3,1
2011-05-17,2011,May,4,Tuesday,Summer,Light Snow/Rain,4,2,2
2011-05-17,2011,May,5,Tuesday,Summer,Light Snow/Rain,22,22,0
2011-05-17,2011,May,6,Tuesday,Summer,Light Snow/Rain,49,49,0
2011-05-17,2011,May,7,Tuesday,Summer,Cloudy,151,138,13
2011-05-17,2011,May,8,Tuesday,Summer,Cloudy,347,325,22
2011-05-17,2011,May,9,Tuesday,Summer,Cloudy,207,190,17
2011-05-17,2011,May,10,Tuesday,Summer,Light Snow/Rain,104,73,31
2011-05-17,2011,May,11,Tuesday,Summer,Cloudy,130,104,26
2011-05-17,2011,May,12,Tuesday,Summer,Light Snow/Rain,153,115,38
2011-05-17,2011,May,13,Tuesday,Summer,Cloudy,172,141,31
2011-05-17,2011,May,14,Tuesday,Summer,Clear,184,123,61
2011-05-17,2011,May,15,Tuesday,Summer,Clear,210,131,79
2011-05-17,2011,May,16,Tuesday,Summer,Clear,290,217,73
2011-05-17,2011,May,17,Tuesday,Summer,Clear,604,521,83
2011-05-17,2011,May,18,Tuesday,Summer,Clear,480,426,54
2011-05-17,2011,May,19,Tuesday,Summer,Clear,349,298,51
2011-05-17,2011,May,20,Tuesday,Summer,Clear,283,253,30
2011-05-17,2011,May,21,Tuesday,Summer,Clear,174,151,23
2011-05-17,2011,May,22,Tuesday,Summer,Cloudy,98,86,12
2011-05-17,2011,May,23,Tuesday,Summer,Cloudy,56,49,7
2011-05-18,2011,May,0,Wednesday,Summer,Cloudy,23,15,8
2011-05-18,2011,May,1,Wednesday,Summer,Cloudy,12,9,3
2011-05-18,2011,May,2,Wednesday,Summer,Light Snow/Rain,6,5,1
2011-05-18,2011,May,3,Wednesday,Summer,Light Snow/Rain,9,3,6
2011-05-18,2011,May,4,Wednesday,Summer,Light Snow/Rain,3,2,1
2011-05-18,2011,May,5,Wednesday,Summer,Clear,9,9,0
2011-05-18,2011,May,6,Wednesday,Summer,Clear,101,99,2
2011-05-18,2011,May,7,Wednesday,Summer,Clear,274,260,14
2011-05-18,2011,May,8,Wednesday,Summer,Clear,453,428,25
2011-05-18,2011,May,9,Wednesday,Summer,Light Snow/Rain,202,176,26
2011-05-18,2011,May,10,Wednesday,Summer,Light Snow/Rain,106,73,33
2011-05-18,2011,May,11,Wednesday,Summer,Cloudy,23,17,6
2011-05-18,2011,May,12,Wednesday,Summer,Clear,54,42,12
2011-05-18,2011,May,13,Wednesday,Summer,Cloudy,122,92,30
2011-05-18,2011,May,14,Wednesday,Summer,Cloudy,138,94,44
2011-05-18,2011,May,15,Wednesday,Summer,Clear,167,133,34
2011-05-18,2011,May,16,Wednesday,Summer,Clear,294,241,53
2011-05-18,2011,May,17,Wednesday,Summer,Clear,565,487,78
2011-05-18,2011,May,18,Wednesday,Summer,Clear,489,431,58
2011-05-18,2011,May,19,Wednesday,Summer,Light Snow/Rain,331,288,43
2011-05-18,2011,May,20,Wednesday,Summer,Light Snow/Rain,213,189,24
2011-05-18,2011,May,21,Wednesday,Summer,Clear,85,74,11
2011-05-18,2011,May,22,Wednesday,Summer,Clear,117,103,14
2011-05-18,2011,May,23,Wednesday,Summer,Clear,59,49,10
2011-05-19,2011,May,0,Thursday,Summer,Clear,29,23,6
2011-05-19,2011,May,1,Thursday,Summer,Clear,6,4,2
2011-05-19,2011,May,2,Thursday,Summer,Clear,15,12,3
2011-05-19,2011,May,3,Thursday,Summer,Clear,4,3,1
2011-05-19,2011,May,4,Thursday,Summer,Clear,5,3,2
2011-05-19,2011,May,5,Thursday,Summer,Clear,26,24,2
2011-05-19,2011,May,6,Thursday,Summer,Cloudy,103,86,17
2011-05-19,2011,May,7,Thursday,Summer,Cloudy,257,239,18
2011-05-19,2011,May,8,Thursday,Summer,Cloudy,487,453,34
2011-05-19,2011,May,9,Thursday,Summer,Cloudy,216,176,40
2011-05-19,2011,May,10,Thursday,Summer,Cloudy,130,95,35
2011-05-19,2011,May,11,Thursday,Summer,Light Snow/Rain,164,111,53
2011-05-19,2011,May,12,Thursday,Summer,Cloudy,168,130,38
2011-05-19,2011,May,13,Thursday,Summer,Light Snow/Rain,183,139,44
2011-05-19,2011,May,14,Thursday,Summer,Light Snow/Rain,180,137,43
2011-05-19,2011,May,15,Thursday,Summer,Clear,188,125,63
2011-05-19,2011,May,16,Thursday,Summer,Clear,302,247,55
2011-05-19,2011,May,17,Thursday,Summer,Clear,547,487,60
2011-05-19,2011,May,18,Thursday,Summer,Clear,513,454,59
2011-05-19,2011,May,19,Thursday,Summer,Clear,410,345,65
2011-05-19,2011,May,20,Thursday,Summer,Clear,282,236,46
2011-05-19,2011,May,21,Thursday,Summer,Clear,209,180,29
2011-05-19,2011,May,22,Thursday,Summer,Light Snow/Rain,79,68,11
2011-05-19,2011,May,23,Thursday,Summer,Clear,72,63,9
2011-05-20,2011,May,0,Friday,Summer,Clear,48,33,15
2011-05-20,2011,May,1,Friday,Summer,Clear,25,17,8
2011-05-20,2011,May,2,Friday,Summer,Clear,8,4,4
2011-05-20,2011,May,3,Friday,Summer,Clear,5,4,1
2011-05-20,2011,May,4,Friday,Summer,Clear,5,4,1
2011-05-20,2011,May,5,Friday,Summer,Clear,28,28,0
2011-05-20,2011,May,6,Friday,Summer,Clear,117,102,15
2011-05-20,2011,May,7,Friday,Summer,Clear,319,289,30
2011-05-20,2011,May,8,Friday,Summer,Clear,517,476,41
2011-05-20,2011,May,9,Friday,Summer,Clear,234,199,35
2011-05-20,2011,May,10,Friday,Summer,Clear,148,104,44
2011-05-20,2011,May,11,Friday,Summer,Cloudy,196,133,63
2011-05-20,2011,May,12,Friday,Summer,Cloudy,255,186,69
2011-05-20,2011,May,13,Friday,Summer,Light Snow/Rain,232,172,60
2011-05-20,2011,May,14,Friday,Summer,Clear,197,131,66
2011-05-20,2011,May,15,Friday,Summer,Cloudy,242,168,74
2011-05-20,2011,May,16,Friday,Summer,Cloudy,330,269,61
2011-05-20,2011,May,17,Friday,Summer,Clear,554,483,71
2011-05-20,2011,May,18,Friday,Summer,Clear,473,394,79
2011-05-20,2011,May,19,Friday,Summer,Clear,302,253,49
2011-05-20,2011,May,20,Friday,Summer,Clear,220,180,40
2011-05-20,2011,May,21,Friday,Summer,Clear,195,155,40
2011-05-20,2011,May,22,Friday,Summer,Clear,152,124,28
2011-05-20,2011,May,23,Friday,Summer,Clear,115,100,15
2011-05-21,2011,May,0,Saturday,Summer,Clear,98,78,20
2011-05-21,2011,May,1,Saturday,Summer,Clear,72,64,8
2011-05-21,2011,May,2,Saturday,Summer,Clear,40,35,5
2011-05-21,2011,May,3,Saturday,Summer,Clear,19,12,7
2011-05-21,2011,May,4,Saturday,Summer,Clear,7,6,1
2011-05-21,2011,May,5,Saturday,Summer,Clear,5,4,1
2011-05-21,2011,May,6,Saturday,Summer,Clear,28,22,6
2011-05-21,2011,May,7,Saturday,Summer,Clear,43,33,10
2011-05-21,2011,May,8,Saturday,Summer,Clear,126,97,29
2011-05-21,2011,May,9,Saturday,Summer,Clear,225,165,60
2011-05-21,2011,May,10,Saturday,Summer,Clear,323,201,122
2011-05-21,2011,May,11,Saturday,Summer,Clear,418,245,173
2011-05-21,2011,May,12,Saturday,Summer,Clear,493,271,222
2011-05-21,2011,May,13,Saturday,Summer,Clear,462,271,191
2011-05-21,2011,May,14,Saturday,Summer,Clear,456,269,187
2011-05-21,2011,May,15,Saturday,Summer,Clear,506,274,232
2011-05-21,2011,May,16,Saturday,Summer,Cloudy,471,267,204
2011-05-21,2011,May,17,Saturday,Summer,Cloudy,444,253,191
2011-05-21,2011,May,18,Saturday,Summer,Cloudy,444,253,191
2011-05-21,2011,May,19,Saturday,Summer,Clear,301,184,117
2011-05-21,2011,May,20,Saturday,Summer,Clear,248,164,84
2011-05-21,2011,May,21,Saturday,Summer,Clear,227,150,77
2011-05-21,2011,May,22,Saturday,Summer,Clear,204,126,78
2011-05-21,2011,May,23,Saturday,Summer,Clear,145,103,42
2011-05-22,2011,May,0,Sunday,Summer,Clear,131,100,31
2011-05-22,2011,May,1,Sunday,Summer,Clear,98,81,17
2011-05-22,2011,May,2,Sunday,Summer,Clear,68,50,18
2011-05-22,2011,May,3,Sunday,Summer,Clear,33,23,10
2011-05-22,2011,May,4,Sunday,Summer,Clear,12,9,3
2011-05-22,2011,May,5,Sunday,Summer,Clear,6,5,1
2011-05-22,2011,May,6,Sunday,Summer,Clear,18,13,5
2011-05-22,2011,May,7,Sunday,Summer,Clear,40,27,13
2011-05-22,2011,May,8,Sunday,Summer,Clear,94,65,29
2011-05-22,2011,May,9,Sunday,Summer,Clear,189,130,59
2011-05-22,2011,May,10,Sunday,Summer,Clear,305,170,135
2011-05-22,2011,May,11,Sunday,Summer,Clear,373,209,164
2011-05-22,2011,May,12,Sunday,Summer,Cloudy,401,255,146
2011-05-22,2011,May,13,Sunday,Summer,Cloudy,455,275,180
2011-05-22,2011,May,14,Sunday,Summer,Light Snow/Rain,316,191,125
2011-05-22,2011,May,15,Sunday,Summer,Cloudy,331,221,110
2011-05-22,2011,May,16,Sunday,Summer,Clear,273,201,72
2011-05-22,2011,May,17,Sunday,Summer,Clear,306,213,93
2011-05-22,2011,May,18,Sunday,Summer,Clear,358,238,120
2011-05-22,2011,May,19,Sunday,Summer,Clear,300,193,107
2011-05-22,2011,May,20,Sunday,Summer,Clear,231,174,57
2011-05-22,2011,May,21,Sunday,Summer,Clear,136,109,27
2011-05-22,2011,May,22,Sunday,Summer,Clear,121,86,35
2011-05-22,2011,May,23,Sunday,Summer,Cloudy,65,46,19
2011-05-23,2011,May,0,Monday,Summer,Cloudy,41,18,23
2011-05-23,2011,May,1,Monday,Summer,Clear,9,5,4
2011-05-23,2011,May,2,Monday,Summer,Light Snow/Rain,5,3,2
2011-05-23,2011,May,3,Monday,Summer,Light Snow/Rain,4,4,0
2011-05-23,2011,May,4,Monday,Summer,Cloudy,4,2,2
2011-05-23,2011,May,5,Monday,Summer,Cloudy,11,11,0
2011-05-23,2011,May,6,Monday,Summer,Cloudy,96,92,4
2011-05-23,2011,May,7,Monday,Summer,Cloudy,236,223,13
2011-05-23,2011,May,8,Monday,Summer,Clear,409,359,50
2011-05-23,2011,May,9,Monday,Summer,Clear,167,131,36
2011-05-23,2011,May,10,Monday,Summer,Clear,121,72,49
2011-05-23,2011,May,11,Monday,Summer,Clear,180,107,73
2011-05-23,2011,May,12,Monday,Summer,Clear,204,139,65
2011-05-23,2011,May,13,Monday,Summer,Cloudy,204,155,49
2011-05-23,2011,May,14,Monday,Summer,Cloudy,187,130,57
2011-05-23,2011,May,15,Monday,Summer,Cloudy,176,119,57
2011-05-23,2011,May,16,Monday,Summer,Cloudy,279,223,56
2011-05-23,2011,May,17,Monday,Summer,Light Snow/Rain,429,373,56
2011-05-23,2011,May,18,Monday,Summer,Clear,453,385,68
2011-05-23,2011,May,19,Monday,Summer,Clear,358,302,56
2011-05-23,2011,May,20,Monday,Summer,Clear,310,271,39
2011-05-23,2011,May,21,Monday,Summer,Clear,188,155,33
2011-05-23,2011,May,22,Monday,Summer,Clear,131,106,25
2011-05-23,2011,May,23,Monday,Summer,Cloudy,72,53,19
2011-05-24,2011,May,0,Tuesday,Summer,Cloudy,35,23,12
2011-05-24,2011,May,1,Tuesday,Summer,Cloudy,15,9,6
2011-05-24,2011,May,2,Tuesday,Summer,Cloudy,10,8,2
2011-05-24,2011,May,3,Tuesday,Summer,Cloudy,2,2,0
2011-05-24,2011,May,4,Tuesday,Summer,Clear,4,3,1
2011-05-24,2011,May,5,Tuesday,Summer,Cloudy,24,22,2
2011-05-24,2011,May,6,Tuesday,Summer,Cloudy,112,102,10
2011-05-24,2011,May,7,Tuesday,Summer,Light Snow/Rain,314,288,26
2011-05-24,2011,May,8,Tuesday,Summer,Light Snow/Rain,434,403,31
2011-05-24,2011,May,9,Tuesday,Summer,Cloudy,138,111,27
2011-05-24,2011,May,10,Tuesday,Summer,Clear,108,90,18
2011-05-24,2011,May,11,Tuesday,Summer,Clear,175,142,33
2011-05-24,2011,May,12,Tuesday,Summer,Clear,170,129,41
2011-05-24,2011,May,13,Tuesday,Summer,Clear,190,152,38
2011-05-24,2011,May,14,Tuesday,Summer,Clear,153,126,27
2011-05-24,2011,May,15,Tuesday,Summer,Light Snow/Rain,188,129,59
2011-05-24,2011,May,16,Tuesday,Summer,Clear,277,225,52
2011-05-24,2011,May,17,Tuesday,Summer,Clear,548,492,56
2011-05-24,2011,May,18,Tuesday,Summer,Clear,564,490,74
2011-05-24,2011,May,19,Tuesday,Summer,Clear,355,310,45
2011-05-24,2011,May,20,Tuesday,Summer,Clear,280,241,39
2011-05-24,2011,May,21,Tuesday,Summer,Clear,189,168,21
2011-05-24,2011,May,22,Tuesday,Summer,Light Snow/Rain,141,115,26
2011-05-24,2011,May,23,Tuesday,Summer,Light Snow/Rain,66,53,13
2011-05-25,2011,May,0,Wednesday,Summer,Light Snow/Rain,35,32,3
2011-05-25,2011,May,1,Wednesday,Summer,Light Snow/Rain,8,2,6
2011-05-25,2011,May,2,Wednesday,Summer,Cloudy,8,8,0
2011-05-25,2011,May,3,Wednesday,Summer,Clear,9,9,0
2011-05-25,2011,May,4,Wednesday,Summer,Clear,3,3,0
2011-05-25,2011,May,5,Wednesday,Summer,Clear,25,23,2
2011-05-25,2011,May,6,Wednesday,Summer,Clear,117,113,4
2011-05-25,2011,May,7,Wednesday,Summer,Clear,313,284,29
2011-05-25,2011,May,8,Wednesday,Summer,Clear,531,495,36
2011-05-25,2011,May,9,Wednesday,Summer,Clear,234,207,27
2011-05-25,2011,May,10,Wednesday,Summer,Clear,135,105,30
2011-05-25,2011,May,11,Wednesday,Summer,Clear,140,104,36
2011-05-25,2011,May,12,Wednesday,Summer,Clear,210,178,32
2011-05-25,2011,May,13,Wednesday,Summer,Clear,202,163,39
2011-05-25,2011,May,14,Wednesday,Summer,Clear,168,121,47
2011-05-25,2011,May,15,Wednesday,Summer,Clear,182,145,37
2011-05-25,2011,May,16,Wednesday,Summer,Clear,299,238,61
2011-05-25,2011,May,17,Wednesday,Summer,Clear,601,524,77
2011-05-25,2011,May,18,Wednesday,Summer,Clear,517,451,66
2011-05-25,2011,May,19,Wednesday,Summer,Clear,405,332,73
2011-05-25,2011,May,20,Wednesday,Summer,Clear,340,284,56
2011-05-25,2011,May,21,Wednesday,Summer,Clear,236,203,33
2011-05-25,2011,May,22,Wednesday,Summer,Clear,174,140,34
2011-05-25,2011,May,23,Wednesday,Summer,Clear,86,74,12
2011-05-26,2011,May,0,Thursday,Summer,Clear,45,34,11
2011-05-26,2011,May,1,Thursday,Summer,Clear,16,13,3
2011-05-26,2011,May,2,Thursday,Summer,Clear,14,7,7
2011-05-26,2011,May,3,Thursday,Summer,Clear,4,4,0
2011-05-26,2011,May,4,Thursday,Summer,Clear,2,2,0
2011-05-26,2011,May,5,Thursday,Summer,Cloudy,27,25,2
2011-05-26,2011,May,6,Thursday,Summer,Cloudy,98,94,4
2011-05-26,2011,May,7,Thursday,Summer,Cloudy,286,270,16
2011-05-26,2011,May,8,Thursday,Summer,Cloudy,489,458,31
2011-05-26,2011,May,9,Thursday,Summer,Clear,216,194,22
2011-05-26,2011,May,10,Thursday,Summer,Clear,143,94,49
2011-05-26,2011,May,11,Thursday,Summer,Clear,160,124,36
2011-05-26,2011,May,12,Thursday,Summer,Clear,194,141,53
2011-05-26,2011,May,13,Thursday,Summer,Clear,197,145,52
2011-05-26,2011,May,14,Thursday,Summer,Clear,189,145,44
2011-05-26,2011,May,15,Thursday,Summer,Cloudy,141,101,40
2011-05-26,2011,May,16,Thursday,Summer,Cloudy,291,233,58
2011-05-26,2011,May,17,Thursday,Summer,Clear,494,445,49
2011-05-26,2011,May,18,Thursday,Summer,Clear,478,404,74
2011-05-26,2011,May,19,Thursday,Summer,Clear,378,311,67
2011-05-26,2011,May,20,Thursday,Summer,Clear,322,267,55
2011-05-26,2011,May,21,Thursday,Summer,Clear,223,178,45
2011-05-26,2011,May,22,Thursday,Summer,Clear,180,157,23
2011-05-26,2011,May,23,Thursday,Summer,Clear,90,73,17
2011-05-27,2011,May,0,Friday,Summer,Clear,69,55,14
2011-05-27,2011,May,1,Friday,Summer,Clear,50,36,14
2011-05-27,2011,May,2,Friday,Summer,Clear,18,12,6
2011-05-27,2011,May,3,Friday,Summer,Clear,12,11,1
2011-05-27,2011,May,4,Friday,Summer,Clear,7,5,2
2011-05-27,2011,May,5,Friday,Summer,Clear,31,29,2
2011-05-27,2011,May,6,Friday,Summer,Clear,81,73,8
2011-05-27,2011,May,7,Friday,Summer,Clear,249,229,20
2011-05-27,2011,May,8,Friday,Summer,Clear,418,393,25
2011-05-27,2011,May,9,Friday,Summer,Clear,227,190,37
2011-05-27,2011,May,10,Friday,Summer,Clear,153,111,42
2011-05-27,2011,May,11,Friday,Summer,Cloudy,166,126,40
2011-05-27,2011,May,12,Friday,Summer,Cloudy,243,190,53
2011-05-27,2011,May,13,Friday,Summer,Clear,209,158,51
2011-05-27,2011,May,14,Friday,Summer,Clear,239,188,51
2011-05-27,2011,May,15,Friday,Summer,Clear,356,258,98
2011-05-27,2011,May,16,Friday,Summer,Cloudy,419,356,63
2011-05-27,2011,May,17,Friday,Summer,Clear,491,414,77
2011-05-27,2011,May,18,Friday,Summer,Cloudy,399,310,89
2011-05-27,2011,May,19,Friday,Summer,Light Snow/Rain,279,210,69
2011-05-27,2011,May,20,Friday,Summer,Cloudy,144,120,24
2011-05-27,2011,May,21,Friday,Summer,Clear,151,114,37
2011-05-27,2011,May,22,Friday,Summer,Clear,141,116,25
2011-05-27,2011,May,23,Friday,Summer,Clear,127,104,23
2011-05-28,2011,May,0,Saturday,Summer,Clear,94,79,15
2011-05-28,2011,May,1,Saturday,Summer,Clear,55,47,8
2011-05-28,2011,May,2,Saturday,Summer,Clear,48,35,13
2011-05-28,2011,May,3,Saturday,Summer,Clear,15,13,2
2011-05-28,2011,May,4,Saturday,Summer,Clear,4,4,0
2011-05-28,2011,May,5,Saturday,Summer,Clear,7,3,4
2011-05-28,2011,May,6,Saturday,Summer,Clear,19,16,3
2011-05-28,2011,May,7,Saturday,Summer,Clear,50,33,17
2011-05-28,2011,May,8,Saturday,Summer,Clear,102,75,27
2011-05-28,2011,May,9,Saturday,Summer,Clear,177,116,61
2011-05-28,2011,May,10,Saturday,Summer,Clear,276,166,110
2011-05-28,2011,May,11,Saturday,Summer,Clear,349,178,171
2011-05-28,2011,May,12,Saturday,Summer,Clear,358,213,145
2011-05-28,2011,May,13,Saturday,Summer,Clear,385,217,168
2011-05-28,2011,May,14,Saturday,Summer,Clear,382,210,172
2011-05-28,2011,May,15,Saturday,Summer,Clear,374,187,187
2011-05-28,2011,May,16,Saturday,Summer,Clear,402,201,201
2011-05-28,2011,May,17,Saturday,Summer,Clear,341,161,180
2011-05-28,2011,May,18,Saturday,Summer,Clear,385,212,173
2011-05-28,2011,May,19,Saturday,Summer,Clear,252,153,99
2011-05-28,2011,May,20,Saturday,Summer,Clear,196,128,68
2011-05-28,2011,May,21,Saturday,Summer,Clear,201,114,87
2011-05-28,2011,May,22,Saturday,Summer,Clear,161,115,46
2011-05-28,2011,May,23,Saturday,Summer,Clear,125,81,44
2011-05-29,2011,May,0,Sunday,Summer,Clear,83,51,32
2011-05-29,2011,May,1,Sunday,Summer,Clear,66,49,17
2011-05-29,2011,May,2,Sunday,Summer,Clear,61,49,12
2011-05-29,2011,May,3,Sunday,Summer,Clear,26,24,2
2011-05-29,2011,May,4,Sunday,Summer,Clear,23,10,13
2011-05-29,2011,May,5,Sunday,Summer,Clear,6,3,3
2011-05-29,2011,May,6,Sunday,Summer,Cloudy,15,10,5
2011-05-29,2011,May,7,Sunday,Summer,Cloudy,30,17,13
2011-05-29,2011,May,8,Sunday,Summer,Cloudy,96,62,34
2011-05-29,2011,May,9,Sunday,Summer,Cloudy,152,78,74
2011-05-29,2011,May,10,Sunday,Summer,Cloudy,251,121,130
2011-05-29,2011,May,11,Sunday,Summer,Cloudy,319,180,139
2011-05-29,2011,May,12,Sunday,Summer,Cloudy,402,186,216
2011-05-29,2011,May,13,Sunday,Summer,Clear,418,181,237
2011-05-29,2011,May,14,Sunday,Summer,Clear,351,168,183
2011-05-29,2011,May,15,Sunday,Summer,Clear,376,155,221
2011-05-29,2011,May,16,Sunday,Summer,Clear,361,167,194
2011-05-29,2011,May,17,Sunday,Summer,Clear,383,169,214
2011-05-29,2011,May,18,Sunday,Summer,Clear,328,177,151
2011-05-29,2011,May,19,Sunday,Summer,Clear,287,146,141
2011-05-29,2011,May,20,Sunday,Summer,Clear,219,128,91
2011-05-29,2011,May,21,Sunday,Summer,Clear,229,122,107
2011-05-29,2011,May,22,Sunday,Summer,Clear,171,93,78
2011-05-29,2011,May,23,Sunday,Summer,Clear,135,87,48
2011-05-30,2011,May,0,Monday,Summer,Clear,103,65,38
2011-05-30,2011,May,1,Monday,Summer,Clear,79,53,26
2011-05-30,2011,May,2,Monday,Summer,Clear,45,28,17
2011-05-30,2011,May,3,Monday,Summer,Clear,18,8,10
2011-05-30,2011,May,4,Monday,Summer,Clear,6,4,2
2011-05-30,2011,May,5,Monday,Summer,Cloudy,7,6,1
2011-05-30,2011,May,6,Monday,Summer,Cloudy,16,10,6
2011-05-30,2011,May,7,Monday,Summer,Cloudy,31,19,12
2011-05-30,2011,May,8,Monday,Summer,Cloudy,94,58,36
2011-05-30,2011,May,9,Monday,Summer,Clear,128,81,47
2011-05-30,2011,May,10,Monday,Summer,Clear,269,153,116
2011-05-30,2011,May,11,Monday,Summer,Clear,321,168,153
2011-05-30,2011,May,12,Monday,Summer,Clear,366,187,179
2011-05-30,2011,May,13,Monday,Summer,Clear,350,217,133
2011-05-30,2011,May,14,Monday,Summer,Clear,327,185,142
2011-05-30,2011,May,15,Monday,Summer,Clear,311,179,132
2011-05-30,2011,May,16,Monday,Summer,Clear,309,208,101
2011-05-30,2011,May,17,Monday,Summer,Clear,304,202,102
2011-05-30,2011,May,18,Monday,Summer,Clear,249,172,77
2011-05-30,2011,May,19,Monday,Summer,Cloudy,225,157,68
2011-05-30,2011,May,20,Monday,Summer,Clear,237,168,69
2011-05-30,2011,May,21,Monday,Summer,Clear,149,107,42
2011-05-30,2011,May,22,Monday,Summer,Clear,106,80,26
2011-05-30,2011,May,23,Monday,Summer,Clear,48,34,14
2011-05-31,2011,May,0,Tuesday,Summer,Clear,29,20,9
2011-05-31,2011,May,1,Tuesday,Summer,Clear,17,9,8
2011-05-31,2011,May,2,Tuesday,Summer,Cloudy,12,7,5
2011-05-31,2011,May,3,Tuesday,Summer,Cloudy,4,3,1
2011-05-31,2011,May,4,Tuesday,Summer,Clear,3,3,0
2011-05-31,2011,May,5,Tuesday,Summer,Clear,26,26,0
2011-05-31,2011,May,6,Tuesday,Summer,Clear,109,98,11
2011-05-31,2011,May,7,Tuesday,Summer,Clear,235,219,16
2011-05-31,2011,May,8,Tuesday,Summer,Clear,406,372,34
2011-05-31,2011,May,9,Tuesday,Summer,Clear,175,153,22
2011-05-31,2011,May,10,Tuesday,Summer,Clear,109,72,37
2011-05-31,2011,May,11,Tuesday,Summer,Clear,106,78,28
2011-05-31,2011,May,12,Tuesday,Summer,Clear,162,125,37
2011-05-31,2011,May,13,Tuesday,Summer,Clear,147,110,37
2011-05-31,2011,May,14,Tuesday,Summer,Clear,140,99,41
2011-05-31,2011,May,15,Tuesday,Summer,Clear,175,133,42
2011-05-31,2011,May,16,Tuesday,Summer,Clear,249,205,44
2011-05-31,2011,May,17,Tuesday,Summer,Clear,495,428,67
2011-05-31,2011,May,18,Tuesday,Summer,Clear,417,362,55
2011-05-31,2011,May,19,Tuesday,Summer,Clear,285,246,39
2011-05-31,2011,May,20,Tuesday,Summer,Clear,251,213,38
2011-05-31,2011,May,21,Tuesday,Summer,Clear,210,165,45
2011-05-31,2011,May,22,Tuesday,Summer,Clear,159,117,42
2011-05-31,2011,May,23,Tuesday,Summer,Clear,61,46,15
2011-06-01,2011,June,0,Wednesday,Summer,Clear,34,25,9
2011-06-01,2011,June,1,Wednesday,Summer,Clear,17,9,8
2011-06-01,2011,June,2,Wednesday,Summer,Clear,3,3,0
2011-06-01,2011,June,3,Wednesday,Summer,Clear,6,6,0
2011-06-01,2011,June,4,Wednesday,Summer,Cloudy,4,4,0
2011-06-01,2011,June,5,Wednesday,Summer,Cloudy,21,19,2
2011-06-01,2011,June,6,Wednesday,Summer,Cloudy,128,121,7
2011-06-01,2011,June,7,Wednesday,Summer,Cloudy,284,265,19
2011-06-01,2011,June,8,Wednesday,Summer,Cloudy,454,417,37
2011-06-01,2011,June,9,Wednesday,Summer,Cloudy,207,173,34
2011-06-01,2011,June,10,Wednesday,Summer,Cloudy,115,84,31
2011-06-01,2011,June,11,Wednesday,Summer,Cloudy,112,86,26
2011-06-01,2011,June,12,Wednesday,Summer,Clear,169,137,32
2011-06-01,2011,June,13,Wednesday,Summer,Clear,154,125,29
2011-06-01,2011,June,14,Wednesday,Summer,Clear,145,105,40
2011-06-01,2011,June,15,Wednesday,Summer,Clear,152,127,25
2011-06-01,2011,June,16,Wednesday,Summer,Clear,266,227,39
2011-06-01,2011,June,17,Wednesday,Summer,Clear,486,434,52
2011-06-01,2011,June,18,Wednesday,Summer,Light Snow/Rain,309,278,31
2011-06-01,2011,June,19,Wednesday,Summer,Cloudy,264,248,16
2011-06-01,2011,June,20,Wednesday,Summer,Cloudy,256,233,23
2011-06-01,2011,June,21,Wednesday,Summer,Clear,190,161,29
2011-06-01,2011,June,22,Wednesday,Summer,Clear,129,115,14
2011-06-01,2011,June,23,Wednesday,Summer,Clear,69,59,10
2011-06-02,2011,June,0,Thursday,Summer,Clear,42,31,11
2011-06-02,2011,June,1,Thursday,Summer,Clear,15,12,3
2011-06-02,2011,June,2,Thursday,Summer,Clear,6,6,0
2011-06-02,2011,June,3,Thursday,Summer,Clear,4,4,0
2011-06-02,2011,June,4,Thursday,Summer,Clear,3,3,0
2011-06-02,2011,June,5,Thursday,Summer,Clear,31,28,3
2011-06-02,2011,June,6,Thursday,Summer,Clear,113,106,7
2011-06-02,2011,June,7,Thursday,Summer,Clear,304,285,19
2011-06-02,2011,June,8,Thursday,Summer,Clear,467,442,25
2011-06-02,2011,June,9,Thursday,Summer,Clear,225,197,28
2011-06-02,2011,June,10,Thursday,Summer,Clear,139,106,33
2011-06-02,2011,June,11,Thursday,Summer,Clear,165,123,42
2011-06-02,2011,June,12,Thursday,Summer,Clear,232,193,39
2011-06-02,2011,June,13,Thursday,Summer,Clear,203,168,35
2011-06-02,2011,June,14,Thursday,Summer,Clear,185,142,43
2011-06-02,2011,June,15,Thursday,Summer,Clear,188,144,44
2011-06-02,2011,June,16,Thursday,Summer,Clear,318,255,63
2011-06-02,2011,June,17,Thursday,Summer,Clear,572,484,88
2011-06-02,2011,June,18,Thursday,Summer,Clear,525,451,74
2011-06-02,2011,June,19,Thursday,Summer,Clear,379,321,58
2011-06-02,2011,June,20,Thursday,Summer,Clear,337,286,51
2011-06-02,2011,June,21,Thursday,Summer,Clear,248,215,33
2011-06-02,2011,June,22,Thursday,Summer,Clear,155,141,14
2011-06-02,2011,June,23,Thursday,Summer,Clear,112,89,23
2011-06-03,2011,June,0,Friday,Summer,Clear,68,53,15
2011-06-03,2011,June,1,Friday,Summer,Clear,22,15,7
2011-06-03,2011,June,2,Friday,Summer,Clear,12,12,0
2011-06-03,2011,June,3,Friday,Summer,Clear,5,5,0
2011-06-03,2011,June,4,Friday,Summer,Clear,6,5,1
2011-06-03,2011,June,5,Friday,Summer,Clear,28,24,4
2011-06-03,2011,June,6,Friday,Summer,Clear,106,98,8
2011-06-03,2011,June,7,Friday,Summer,Clear,277,252,25
2011-06-03,2011,June,8,Friday,Summer,Cloudy,502,471,31
2011-06-03,2011,June,9,Friday,Summer,Clear,230,194,36
2011-06-03,2011,June,10,Friday,Summer,Clear,161,107,54
2011-06-03,2011,June,11,Friday,Summer,Clear,192,135,57
2011-06-03,2011,June,12,Friday,Summer,Clear,259,208,51
2011-06-03,2011,June,13,Friday,Summer,Clear,248,190,58
2011-06-03,2011,June,14,Friday,Summer,Clear,240,174,66
2011-06-03,2011,June,15,Friday,Summer,Clear,212,156,56
2011-06-03,2011,June,16,Friday,Summer,Clear,349,286,63
2011-06-03,2011,June,17,Friday,Summer,Clear,558,485,73
2011-06-03,2011,June,18,Friday,Summer,Clear,564,488,76
2011-06-03,2011,June,19,Friday,Summer,Clear,391,338,53
2011-06-03,2011,June,20,Friday,Summer,Clear,293,236,57
2011-06-03,2011,June,21,Friday,Summer,Clear,247,196,51
2011-06-03,2011,June,22,Friday,Summer,Clear,171,145,26
2011-06-03,2011,June,23,Friday,Summer,Clear,171,141,30
2011-06-04,2011,June,0,Saturday,Summer,Clear,93,69,24
2011-06-04,2011,June,1,Saturday,Summer,Clear,94,80,14
2011-06-04,2011,June,2,Saturday,Summer,Clear,59,41,18
2011-06-04,2011,June,3,Saturday,Summer,Clear,18,10,8
2011-06-04,2011,June,4,Saturday,Summer,Clear,15,11,4
2011-06-04,2011,June,5,Saturday,Summer,Clear,8,5,3
2011-06-04,2011,June,6,Saturday,Summer,Clear,28,17,11
2011-06-04,2011,June,7,Saturday,Summer,Clear,87,60,27
2011-06-04,2011,June,8,Saturday,Summer,Clear,125,96,29
2011-06-04,2011,June,9,Saturday,Summer,Clear,224,169,55
2011-06-04,2011,June,10,Saturday,Summer,Clear,317,202,115
2011-06-04,2011,June,11,Saturday,Summer,Clear,369,249,120
2011-06-04,2011,June,12,Saturday,Summer,Clear,420,270,150
2011-06-04,2011,June,13,Saturday,Summer,Clear,456,268,188
2011-06-04,2011,June,14,Saturday,Summer,Clear,451,258,193
2011-06-04,2011,June,15,Saturday,Summer,Cloudy,404,224,180
2011-06-04,2011,June,16,Saturday,Summer,Cloudy,440,272,168
2011-06-04,2011,June,17,Saturday,Summer,Cloudy,344,202,142
2011-06-04,2011,June,18,Saturday,Summer,Cloudy,341,214,127
2011-06-04,2011,June,19,Saturday,Summer,Cloudy,285,206,79
2011-06-04,2011,June,20,Saturday,Summer,Cloudy,239,149,90
2011-06-04,2011,June,21,Saturday,Summer,Cloudy,185,139,46
2011-06-04,2011,June,22,Saturday,Summer,Clear,190,141,49
2011-06-04,2011,June,23,Saturday,Summer,Cloudy,150,121,29
2011-06-05,2011,June,0,Sunday,Summer,Clear,113,90,23
2011-06-05,2011,June,1,Sunday,Summer,Cloudy,96,70,26
2011-06-05,2011,June,2,Sunday,Summer,Cloudy,64,48,16
2011-06-05,2011,June,3,Sunday,Summer,Cloudy,47,25,22
2011-06-05,2011,June,4,Sunday,Summer,Cloudy,12,8,4
2011-06-05,2011,June,5,Sunday,Summer,Cloudy,6,5,1
2011-06-05,2011,June,6,Sunday,Summer,Cloudy,21,11,10
2011-06-05,2011,June,7,Sunday,Summer,Cloudy,27,19,8
2011-06-05,2011,June,8,Sunday,Summer,Cloudy,98,74,24
2011-06-05,2011,June,9,Sunday,Summer,Cloudy,164,111,53
2011-06-05,2011,June,10,Sunday,Summer,Cloudy,251,168,83
2011-06-05,2011,June,11,Sunday,Summer,Cloudy,335,214,121
2011-06-05,2011,June,12,Sunday,Summer,Cloudy,335,212,123
2011-06-05,2011,June,13,Sunday,Summer,Clear,367,213,154
2011-06-05,2011,June,14,Sunday,Summer,Clear,385,224,161
2011-06-05,2011,June,15,Sunday,Summer,Clear,417,256,161
2011-06-05,2011,June,16,Sunday,Summer,Clear,398,260,138
2011-06-05,2011,June,17,Sunday,Summer,Clear,390,264,126
2011-06-05,2011,June,18,Sunday,Summer,Clear,363,239,124
2011-06-05,2011,June,19,Sunday,Summer,Clear,357,249,108
2011-06-05,2011,June,20,Sunday,Summer,Clear,279,195,84
2011-06-05,2011,June,21,Sunday,Summer,Clear,165,111,54
2011-06-05,2011,June,22,Sunday,Summer,Clear,130,94,36
2011-06-05,2011,June,23,Sunday,Summer,Clear,86,61,25
2011-06-06,2011,June,0,Monday,Summer,Clear,29,18,11
2011-06-06,2011,June,1,Monday,Summer,Clear,14,5,9
2011-06-06,2011,June,2,Monday,Summer,Clear,8,4,4
2011-06-06,2011,June,3,Monday,Summer,Clear,5,3,2
2011-06-06,2011,June,4,Monday,Summer,Clear,8,4,4
2011-06-06,2011,June,5,Monday,Summer,Clear,31,24,7
2011-06-06,2011,June,6,Monday,Summer,Clear,112,101,11
2011-06-06,2011,June,7,Monday,Summer,Clear,299,281,18
2011-06-06,2011,June,8,Monday,Summer,Clear,438,410,28
2011-06-06,2011,June,9,Monday,Summer,Clear,188,162,26
2011-06-06,2011,June,10,Monday,Summer,Clear,95,64,31
2011-06-06,2011,June,11,Monday,Summer,Clear,111,72,39
2011-06-06,2011,June,12,Monday,Summer,Clear,153,128,25
2011-06-06,2011,June,13,Monday,Summer,Clear,180,152,28
2011-06-06,2011,June,14,Monday,Summer,Clear,145,99,46
2011-06-06,2011,June,15,Monday,Summer,Clear,165,127,38
2011-06-06,2011,June,16,Monday,Summer,Clear,267,233,34
2011-06-06,2011,June,17,Monday,Summer,Clear,579,516,63
2011-06-06,2011,June,18,Monday,Summer,Clear,556,500,56
2011-06-06,2011,June,19,Monday,Summer,Clear,407,343,64
2011-06-06,2011,June,20,Monday,Summer,Clear,336,277,59
2011-06-06,2011,June,21,Monday,Summer,Clear,189,160,29
2011-06-06,2011,June,22,Monday,Summer,Clear,173,137,36
2011-06-06,2011,June,23,Monday,Summer,Clear,60,55,5
2011-06-07,2011,June,0,Tuesday,Summer,Clear,20,15,5
2011-06-07,2011,June,1,Tuesday,Summer,Clear,4,2,2
2011-06-07,2011,June,2,Tuesday,Summer,Clear,5,2,3
2011-06-07,2011,June,3,Tuesday,Summer,Clear,2,1,1
2011-06-07,2011,June,4,Tuesday,Summer,Clear,5,3,2
2011-06-07,2011,June,5,Tuesday,Summer,Clear,32,30,2
2011-06-07,2011,June,6,Tuesday,Summer,Clear,126,116,10
2011-06-07,2011,June,7,Tuesday,Summer,Cloudy,334,311,23
2011-06-07,2011,June,8,Tuesday,Summer,Cloudy,477,432,45
2011-06-07,2011,June,9,Tuesday,Summer,Cloudy,217,190,27
2011-06-07,2011,June,10,Tuesday,Summer,Cloudy,123,86,37
2011-06-07,2011,June,11,Tuesday,Summer,Cloudy,151,113,38
2011-06-07,2011,June,12,Tuesday,Summer,Cloudy,183,141,42
2011-06-07,2011,June,13,Tuesday,Summer,Cloudy,196,141,55
2011-06-07,2011,June,14,Tuesday,Summer,Cloudy,146,112,34
2011-06-07,2011,June,15,Tuesday,Summer,Cloudy,183,127,56
2011-06-07,2011,June,16,Tuesday,Summer,Clear,308,253,55
2011-06-07,2011,June,17,Tuesday,Summer,Clear,539,475,64
2011-06-07,2011,June,18,Tuesday,Summer,Clear,551,479,72
2011-06-07,2011,June,19,Tuesday,Summer,Clear,424,355,69
2011-06-07,2011,June,20,Tuesday,Summer,Clear,346,301,45
2011-06-07,2011,June,21,Tuesday,Summer,Clear,218,187,31
2011-06-07,2011,June,22,Tuesday,Summer,Clear,153,126,27
2011-06-07,2011,June,23,Tuesday,Summer,Clear,90,72,18
2011-06-08,2011,June,0,Wednesday,Summer,Clear,41,29,12
2011-06-08,2011,June,1,Wednesday,Summer,Clear,23,20,3
2011-06-08,2011,June,2,Wednesday,Summer,Clear,7,7,0
2011-06-08,2011,June,3,Wednesday,Summer,Clear,3,1,2
2011-06-08,2011,June,4,Wednesday,Summer,Clear,6,6,0
2011-06-08,2011,June,5,Wednesday,Summer,Clear,21,21,0
2011-06-08,2011,June,6,Wednesday,Summer,Clear,116,103,13
2011-06-08,2011,June,7,Wednesday,Summer,Clear,353,329,24
2011-06-08,2011,June,8,Wednesday,Summer,Clear,481,435,46
2011-06-08,2011,June,9,Wednesday,Summer,Clear,202,168,34
2011-06-08,2011,June,10,Wednesday,Summer,Clear,90,63,27
2011-06-08,2011,June,11,Wednesday,Summer,Clear,134,106,28
2011-06-08,2011,June,12,Wednesday,Summer,Clear,149,134,15
2011-06-08,2011,June,13,Wednesday,Summer,Clear,136,116,20
2011-06-08,2011,June,14,Wednesday,Summer,Clear,155,111,44
2011-06-08,2011,June,15,Wednesday,Summer,Clear,128,100,28
2011-06-08,2011,June,16,Wednesday,Summer,Clear,233,199,34
2011-06-08,2011,June,17,Wednesday,Summer,Clear,506,426,80
2011-06-08,2011,June,18,Wednesday,Summer,Clear,459,398,61
2011-06-08,2011,June,19,Wednesday,Summer,Clear,384,323,61
2011-06-08,2011,June,20,Wednesday,Summer,Clear,280,225,55
2011-06-08,2011,June,21,Wednesday,Summer,Clear,202,168,34
2011-06-08,2011,June,22,Wednesday,Summer,Clear,176,139,37
2011-06-08,2011,June,23,Wednesday,Summer,Clear,116,98,18
2011-06-09,2011,June,0,Thursday,Summer,Cloudy,47,40,7
2011-06-09,2011,June,1,Thursday,Summer,Clear,16,13,3
2011-06-09,2011,June,2,Thursday,Summer,Cloudy,6,6,0
2011-06-09,2011,June,3,Thursday,Summer,Cloudy,2,2,0
2011-06-09,2011,June,4,Thursday,Summer,Cloudy,6,4,2
2011-06-09,2011,June,5,Thursday,Summer,Cloudy,20,19,1
2011-06-09,2011,June,6,Thursday,Summer,Cloudy,118,105,13
2011-06-09,2011,June,7,Thursday,Summer,Cloudy,314,283,31
2011-06-09,2011,June,8,Thursday,Summer,Cloudy,432,400,32
2011-06-09,2011,June,9,Thursday,Summer,Clear,168,148,20
2011-06-09,2011,June,10,Thursday,Summer,Clear,94,74,20
2011-06-09,2011,June,11,Thursday,Summer,Clear,118,82,36
2011-06-09,2011,June,12,Thursday,Summer,Clear,140,100,40
2011-06-09,2011,June,13,Thursday,Summer,Clear,136,118,18
2011-06-09,2011,June,14,Thursday,Summer,Clear,118,93,25
2011-06-09,2011,June,15,Thursday,Summer,Clear,104,86,18
2011-06-09,2011,June,16,Thursday,Summer,Clear,200,170,30
2011-06-09,2011,June,17,Thursday,Summer,Clear,409,355,54
2011-06-09,2011,June,18,Thursday,Summer,Clear,466,414,52
2011-06-09,2011,June,19,Thursday,Summer,Cloudy,326,271,55
2011-06-09,2011,June,20,Thursday,Summer,Cloudy,254,214,40
2011-06-09,2011,June,21,Thursday,Summer,Light Snow/Rain,171,142,29
2011-06-09,2011,June,22,Thursday,Summer,Cloudy,153,131,22
2011-06-09,2011,June,23,Thursday,Summer,Cloudy,97,82,15
2011-06-10,2011,June,0,Friday,Summer,Light Snow/Rain,69,61,8
2011-06-10,2011,June,1,Friday,Summer,Light Snow/Rain,23,18,5
2011-06-10,2011,June,2,Friday,Summer,Clear,13,7,6
2011-06-10,2011,June,3,Friday,Summer,Clear,6,3,3
2011-06-10,2011,June,4,Friday,Summer,Clear,4,4,0
2011-06-10,2011,June,5,Friday,Summer,Clear,28,28,0
2011-06-10,2011,June,6,Friday,Summer,Clear,104,94,10
2011-06-10,2011,June,7,Friday,Summer,Clear,267,242,25
2011-06-10,2011,June,8,Friday,Summer,Clear,452,423,29
2011-06-10,2011,June,9,Friday,Summer,Clear,213,176,37
2011-06-10,2011,June,10,Friday,Summer,Clear,111,88,23
2011-06-10,2011,June,11,Friday,Summer,Clear,153,107,46
2011-06-10,2011,June,12,Friday,Summer,Clear,207,167,40
2011-06-10,2011,June,13,Friday,Summer,Clear,189,149,40
2011-06-10,2011,June,14,Friday,Summer,Clear,165,121,44
2011-06-10,2011,June,15,Friday,Summer,Clear,212,163,49
2011-06-10,2011,June,16,Friday,Summer,Clear,285,239,46
2011-06-10,2011,June,17,Friday,Summer,Clear,517,454,63
2011-06-10,2011,June,18,Friday,Summer,Clear,463,367,96
2011-06-10,2011,June,19,Friday,Summer,Clear,306,245,61
2011-06-10,2011,June,20,Friday,Summer,Clear,250,197,53
2011-06-10,2011,June,21,Friday,Summer,Clear,218,163,55
2011-06-10,2011,June,22,Friday,Summer,Clear,185,145,40
2011-06-10,2011,June,23,Friday,Summer,Clear,146,110,36
2011-06-11,2011,June,0,Saturday,Summer,Clear,117,89,28
2011-06-11,2011,June,1,Saturday,Summer,Clear,77,67,10
2011-06-11,2011,June,2,Saturday,Summer,Clear,60,50,10
2011-06-11,2011,June,3,Saturday,Summer,Clear,28,18,10
2011-06-11,2011,June,4,Saturday,Summer,Clear,13,9,4
2011-06-11,2011,June,5,Saturday,Summer,Clear,16,12,4
2011-06-11,2011,June,6,Saturday,Summer,Clear,40,31,9
2011-06-11,2011,June,7,Saturday,Summer,Clear,68,50,18
2011-06-11,2011,June,8,Saturday,Summer,Clear,143,111,32
2011-06-11,2011,June,9,Saturday,Summer,Clear,230,171,59
2011-06-11,2011,June,10,Saturday,Summer,Clear,264,173,91
2011-06-11,2011,June,11,Saturday,Summer,Clear,325,215,110
2011-06-11,2011,June,12,Saturday,Summer,Clear,347,235,112
2011-06-11,2011,June,13,Saturday,Summer,Clear,387,237,150
2011-06-11,2011,June,14,Saturday,Summer,Clear,380,232,148
2011-06-11,2011,June,15,Saturday,Summer,Clear,374,232,142
2011-06-11,2011,June,16,Saturday,Summer,Cloudy,394,225,169
2011-06-11,2011,June,17,Saturday,Summer,Cloudy,337,190,147
2011-06-11,2011,June,18,Saturday,Summer,Cloudy,286,155,131
2011-06-11,2011,June,19,Saturday,Summer,Clear,264,167,97
2011-06-11,2011,June,20,Saturday,Summer,Clear,275,180,95
2011-06-11,2011,June,21,Saturday,Summer,Clear,220,144,76
2011-06-11,2011,June,22,Saturday,Summer,Clear,190,137,53
2011-06-11,2011,June,23,Saturday,Summer,Clear,131,107,24
2011-06-12,2011,June,0,Sunday,Summer,Clear,119,100,19
2011-06-12,2011,June,1,Sunday,Summer,Clear,93,74,19
2011-06-12,2011,June,2,Sunday,Summer,Clear,66,57,9
2011-06-12,2011,June,3,Sunday,Summer,Clear,28,20,8
2011-06-12,2011,June,4,Sunday,Summer,Clear,14,6,8
2011-06-12,2011,June,5,Sunday,Summer,Clear,10,5,5
2011-06-12,2011,June,6,Sunday,Summer,Clear,14,9,5
2011-06-12,2011,June,7,Sunday,Summer,Clear,34,27,7
2011-06-12,2011,June,8,Sunday,Summer,Clear,92,64,28
2011-06-12,2011,June,9,Sunday,Summer,Clear,182,107,75
2011-06-12,2011,June,10,Sunday,Summer,Clear,311,191,120
2011-06-12,2011,June,11,Sunday,Summer,Clear,367,236,131
2011-06-12,2011,June,12,Sunday,Summer,Clear,420,244,176
2011-06-12,2011,June,13,Sunday,Summer,Clear,373,264,109
2011-06-12,2011,June,14,Sunday,Summer,Clear,315,219,96
2011-06-12,2011,June,15,Sunday,Summer,Clear,360,218,142
2011-06-12,2011,June,16,Sunday,Summer,Light Snow/Rain,350,235,115
2011-06-12,2011,June,17,Sunday,Summer,Light Snow/Rain,252,158,94
2011-06-12,2011,June,18,Sunday,Summer,Clear,256,187,69
2011-06-12,2011,June,19,Sunday,Summer,Clear,223,156,67
2011-06-12,2011,June,20,Sunday,Summer,Clear,206,144,62
2011-06-12,2011,June,21,Sunday,Summer,Clear,140,101,39
2011-06-12,2011,June,22,Sunday,Summer,Clear,128,97,31
2011-06-12,2011,June,23,Sunday,Summer,Clear,107,74,33
2011-06-13,2011,June,0,Monday,Summer,Clear,28,20,8
2011-06-13,2011,June,1,Monday,Summer,Clear,16,10,6
2011-06-13,2011,June,2,Monday,Summer,Clear,10,8,2
2011-06-13,2011,June,3,Monday,Summer,Clear,7,6,1
2011-06-13,2011,June,4,Monday,Summer,Clear,4,3,1
2011-06-13,2011,June,5,Monday,Summer,Clear,29,27,2
2011-06-13,2011,June,6,Monday,Summer,Clear,105,98,7
2011-06-13,2011,June,7,Monday,Summer,Clear,328,302,26
2011-06-13,2011,June,8,Monday,Summer,Clear,476,432,44
2011-06-13,2011,June,9,Monday,Summer,Clear,224,189,35
2011-06-13,2011,June,10,Monday,Summer,Clear,118,80,38
2011-06-13,2011,June,11,Monday,Summer,Clear,159,106,53
2011-06-13,2011,June,12,Monday,Summer,Clear,196,161,35
2011-06-13,2011,June,13,Monday,Summer,Clear,227,174,53
2011-06-13,2011,June,14,Monday,Summer,Clear,200,145,55
2011-06-13,2011,June,15,Monday,Summer,Clear,185,127,58
2011-06-13,2011,June,16,Monday,Summer,Clear,326,262,64
2011-06-13,2011,June,17,Monday,Summer,Clear,601,529,72
2011-06-13,2011,June,18,Monday,Summer,Clear,586,510,76
2011-06-13,2011,June,19,Monday,Summer,Clear,423,348,75
2011-06-13,2011,June,20,Monday,Summer,Clear,331,253,78
2011-06-13,2011,June,21,Monday,Summer,Clear,218,178,40
2011-06-13,2011,June,22,Monday,Summer,Clear,134,114,20
2011-06-13,2011,June,23,Monday,Summer,Clear,89,75,14
2011-06-14,2011,June,0,Tuesday,Summer,Clear,31,18,13
2011-06-14,2011,June,1,Tuesday,Summer,Clear,13,10,3
2011-06-14,2011,June,2,Tuesday,Summer,Clear,10,8,2
2011-06-14,2011,June,3,Tuesday,Summer,Clear,2,1,1
2011-06-14,2011,June,4,Tuesday,Summer,Clear,3,3,0
2011-06-14,2011,June,5,Tuesday,Summer,Clear,26,23,3
2011-06-14,2011,June,6,Tuesday,Summer,Clear,113,107,6
2011-06-14,2011,June,7,Tuesday,Summer,Clear,365,346,19
2011-06-14,2011,June,8,Tuesday,Summer,Clear,486,441,45
2011-06-14,2011,June,9,Tuesday,Summer,Clear,193,174,19
2011-06-14,2011,June,10,Tuesday,Summer,Clear,130,97,33
2011-06-14,2011,June,11,Tuesday,Summer,Clear,143,103,40
2011-06-14,2011,June,12,Tuesday,Summer,Clear,169,139,30
2011-06-14,2011,June,13,Tuesday,Summer,Clear,209,176,33
2011-06-14,2011,June,14,Tuesday,Summer,Cloudy,159,118,41
2011-06-14,2011,June,15,Tuesday,Summer,Clear,178,136,42
2011-06-14,2011,June,16,Tuesday,Summer,Clear,330,279,51
2011-06-14,2011,June,17,Tuesday,Summer,Light Snow/Rain,569,484,85
2011-06-14,2011,June,18,Tuesday,Summer,Clear,538,473,65
2011-06-14,2011,June,19,Tuesday,Summer,Clear,386,335,51
2011-06-14,2011,June,20,Tuesday,Summer,Clear,297,237,60
2011-06-14,2011,June,21,Tuesday,Summer,Clear,243,206,37
2011-06-14,2011,June,22,Tuesday,Summer,Clear,188,159,29
2011-06-14,2011,June,23,Tuesday,Summer,Clear,110,91,19
2011-06-15,2011,June,0,Wednesday,Summer,Clear,52,44,8
2011-06-15,2011,June,1,Wednesday,Summer,Clear,14,14,0
2011-06-15,2011,June,2,Wednesday,Summer,Clear,9,9,0
2011-06-15,2011,June,3,Wednesday,Summer,Clear,1,1,0
2011-06-15,2011,June,4,Wednesday,Summer,Clear,4,4,0
2011-06-15,2011,June,5,Wednesday,Summer,Clear,21,20,1
2011-06-15,2011,June,6,Wednesday,Summer,Clear,121,110,11
2011-06-15,2011,June,7,Wednesday,Summer,Clear,370,348,22
2011-06-15,2011,June,8,Wednesday,Summer,Clear,498,445,53
2011-06-15,2011,June,9,Wednesday,Summer,Clear,207,185,22
2011-06-15,2011,June,10,Wednesday,Summer,Clear,135,108,27
2011-06-15,2011,June,11,Wednesday,Summer,Clear,164,115,49
2011-06-15,2011,June,12,Wednesday,Summer,Clear,211,178,33
2011-06-15,2011,June,13,Wednesday,Summer,Clear,189,146,43
2011-06-15,2011,June,14,Wednesday,Summer,Clear,178,128,50
2011-06-15,2011,June,15,Wednesday,Summer,Clear,164,131,33
2011-06-15,2011,June,16,Wednesday,Summer,Clear,312,265,47
2011-06-15,2011,June,17,Wednesday,Summer,Clear,638,555,83
2011-06-15,2011,June,18,Wednesday,Summer,Clear,607,527,80
2011-06-15,2011,June,19,Wednesday,Summer,Clear,416,362,54
2011-06-15,2011,June,20,Wednesday,Summer,Clear,330,273,57
2011-06-15,2011,June,21,Wednesday,Summer,Clear,257,209,48
2011-06-15,2011,June,22,Wednesday,Summer,Clear,175,144,31
2011-06-15,2011,June,23,Wednesday,Summer,Clear,107,90,17
2011-06-16,2011,June,0,Thursday,Summer,Clear,47,38,9
2011-06-16,2011,June,1,Thursday,Summer,Clear,17,13,4
2011-06-16,2011,June,2,Thursday,Summer,Clear,5,4,1
2011-06-16,2011,June,3,Thursday,Summer,Cloudy,4,4,0
2011-06-16,2011,June,4,Thursday,Summer,Cloudy,6,6,0
2011-06-16,2011,June,5,Thursday,Summer,Clear,25,18,7
2011-06-16,2011,June,6,Thursday,Summer,Light Snow/Rain,112,104,8
2011-06-16,2011,June,7,Thursday,Summer,Light Snow/Rain,188,172,16
2011-06-16,2011,June,8,Thursday,Summer,Cloudy,388,364,24
2011-06-16,2011,June,9,Thursday,Summer,Cloudy,261,232,29
2011-06-16,2011,June,10,Thursday,Summer,Cloudy,121,103,18
2011-06-16,2011,June,11,Thursday,Summer,Cloudy,150,117,33
2011-06-16,2011,June,12,Thursday,Summer,Clear,206,165,41
2011-06-16,2011,June,13,Thursday,Summer,Cloudy,151,114,37
2011-06-16,2011,June,14,Thursday,Summer,Cloudy,153,114,39
2011-06-16,2011,June,15,Thursday,Summer,Cloudy,159,127,32
2011-06-16,2011,June,16,Thursday,Summer,Light Snow/Rain,294,258,36
2011-06-16,2011,June,17,Thursday,Summer,Cloudy,272,230,42
2011-06-16,2011,June,18,Thursday,Summer,Clear,325,299,26
2011-06-16,2011,June,19,Thursday,Summer,Clear,327,269,58
2011-06-16,2011,June,20,Thursday,Summer,Clear,201,176,25
2011-06-16,2011,June,21,Thursday,Summer,Light Snow/Rain,188,154,34
2011-06-16,2011,June,22,Thursday,Summer,Light Snow/Rain,151,127,24
2011-06-16,2011,June,23,Thursday,Summer,Light Snow/Rain,16,14,2
2011-06-17,2011,June,0,Friday,Summer,Clear,24,21,3
2011-06-17,2011,June,1,Friday,Summer,Clear,23,19,4
2011-06-17,2011,June,2,Friday,Summer,Clear,13,11,2
2011-06-17,2011,June,3,Friday,Summer,Clear,6,5,1
2011-06-17,2011,June,4,Friday,Summer,Clear,6,5,1
2011-06-17,2011,June,5,Friday,Summer,Clear,13,12,1
2011-06-17,2011,June,6,Friday,Summer,Clear,97,89,8
2011-06-17,2011,June,7,Friday,Summer,Clear,250,225,25
2011-06-17,2011,June,8,Friday,Summer,Cloudy,454,426,28
2011-06-17,2011,June,9,Friday,Summer,Clear,224,196,28
2011-06-17,2011,June,10,Friday,Summer,Clear,170,126,44
2011-06-17,2011,June,11,Friday,Summer,Clear,181,138,43
2011-06-17,2011,June,12,Friday,Summer,Clear,243,194,49
2011-06-17,2011,June,13,Friday,Summer,Clear,204,156,48
2011-06-17,2011,June,14,Friday,Summer,Clear,215,142,73
2011-06-17,2011,June,15,Friday,Summer,Clear,243,181,62
2011-06-17,2011,June,16,Friday,Summer,Clear,355,286,69
2011-06-17,2011,June,17,Friday,Summer,Light Snow/Rain,552,467,85
2011-06-17,2011,June,18,Friday,Summer,Light Snow/Rain,450,388,62
2011-06-17,2011,June,19,Friday,Summer,Light Snow/Rain,328,275,53
2011-06-17,2011,June,20,Friday,Summer,Clear,232,192,40
2011-06-17,2011,June,21,Friday,Summer,Clear,208,159,49
2011-06-17,2011,June,22,Friday,Summer,Clear,175,127,48
2011-06-17,2011,June,23,Friday,Summer,Clear,178,141,37
2011-06-18,2011,June,0,Saturday,Summer,Clear,104,83,21
2011-06-18,2011,June,1,Saturday,Summer,Clear,95,80,15
2011-06-18,2011,June,2,Saturday,Summer,Clear,53,37,16
2011-06-18,2011,June,3,Saturday,Summer,Clear,20,16,4
2011-06-18,2011,June,4,Saturday,Summer,Clear,5,4,1
2011-06-18,2011,June,5,Saturday,Summer,Clear,7,6,1
2011-06-18,2011,June,6,Saturday,Summer,Clear,27,18,9
2011-06-18,2011,June,7,Saturday,Summer,Clear,57,45,12
2011-06-18,2011,June,8,Saturday,Summer,Clear,131,103,28
2011-06-18,2011,June,9,Saturday,Summer,Clear,218,156,62
2011-06-18,2011,June,10,Saturday,Summer,Clear,244,176,68
2011-06-18,2011,June,11,Saturday,Summer,Clear,404,270,134
2011-06-18,2011,June,12,Saturday,Summer,Clear,420,258,162
2011-06-18,2011,June,13,Saturday,Summer,Clear,327,192,135
2011-06-18,2011,June,14,Saturday,Summer,Cloudy,334,196,138
2011-06-18,2011,June,15,Saturday,Summer,Cloudy,367,214,153
2011-06-18,2011,June,16,Saturday,Summer,Cloudy,468,275,193
2011-06-18,2011,June,17,Saturday,Summer,Cloudy,449,239,210
2011-06-18,2011,June,18,Saturday,Summer,Cloudy,381,263,118
2011-06-18,2011,June,19,Saturday,Summer,Cloudy,326,227,99
2011-06-18,2011,June,20,Saturday,Summer,Cloudy,188,127,61
2011-06-18,2011,June,21,Saturday,Summer,Cloudy,183,125,58
2011-06-18,2011,June,22,Saturday,Summer,Cloudy,161,105,56
2011-06-18,2011,June,23,Saturday,Summer,Cloudy,150,97,53
2011-06-19,2011,June,0,Sunday,Summer,Clear,89,71,18
2011-06-19,2011,June,1,Sunday,Summer,Cloudy,76,59,17
2011-06-19,2011,June,2,Sunday,Summer,Clear,72,59,13
2011-06-19,2011,June,3,Sunday,Summer,Cloudy,30,16,14
2011-06-19,2011,June,4,Sunday,Summer,Cloudy,17,10,7
2011-06-19,2011,June,5,Sunday,Summer,Cloudy,19,12,7
2011-06-19,2011,June,6,Sunday,Summer,Cloudy,33,22,11
2011-06-19,2011,June,7,Sunday,Summer,Cloudy,71,36,35
2011-06-19,2011,June,8,Sunday,Summer,Light Snow/Rain,84,59,25
2011-06-19,2011,June,9,Sunday,Summer,Cloudy,169,111,58
2011-06-19,2011,June,10,Sunday,Summer,Cloudy,244,158,86
2011-06-19,2011,June,11,Sunday,Summer,Cloudy,377,236,141
2011-06-19,2011,June,12,Sunday,Summer,Cloudy,396,255,141
2011-06-19,2011,June,13,Sunday,Summer,Cloudy,363,214,149
2011-06-19,2011,June,14,Sunday,Summer,Light Snow/Rain,317,193,124
2011-06-19,2011,June,15,Sunday,Summer,Cloudy,362,216,146
2011-06-19,2011,June,16,Sunday,Summer,Cloudy,378,257,121
2011-06-19,2011,June,17,Sunday,Summer,Clear,397,238,159
2011-06-19,2011,June,18,Sunday,Summer,Cloudy,296,218,78
2011-06-19,2011,June,19,Sunday,Summer,Clear,311,217,94
2011-06-19,2011,June,20,Sunday,Summer,Clear,232,146,86
2011-06-19,2011,June,21,Sunday,Summer,Clear,167,110,57
2011-06-19,2011,June,22,Sunday,Summer,Clear,152,114,38
2011-06-19,2011,June,23,Sunday,Summer,Clear,92,78,14
2011-06-20,2011,June,0,Monday,Summer,Clear,26,19,7
2011-06-20,2011,June,1,Monday,Summer,Clear,12,3,9
2011-06-20,2011,June,2,Monday,Summer,Clear,2,0,2
2011-06-20,2011,June,3,Monday,Summer,Light Snow/Rain,1,0,1
2011-06-20,2011,June,4,Monday,Summer,Light Snow/Rain,3,2,1
2011-06-20,2011,June,5,Monday,Summer,Light Snow/Rain,3,3,0
2011-06-20,2011,June,6,Monday,Summer,Light Snow/Rain,26,25,1
2011-06-20,2011,June,7,Monday,Summer,Light Snow/Rain,46,46,0
2011-06-20,2011,June,8,Monday,Summer,Light Snow/Rain,221,209,12
2011-06-20,2011,June,9,Monday,Summer,Cloudy,219,200,19
2011-06-20,2011,June,10,Monday,Summer,Cloudy,91,58,33
2011-06-20,2011,June,11,Monday,Summer,Cloudy,94,67,27
2011-06-20,2011,June,12,Monday,Summer,Cloudy,162,129,33
2011-06-20,2011,June,13,Monday,Summer,Clear,179,129,50
2011-06-20,2011,June,14,Monday,Summer,Clear,175,130,45
2011-06-20,2011,June,15,Monday,Summer,Clear,205,139,66
2011-06-20,2011,June,16,Monday,Summer,Clear,299,238,61
2011-06-20,2011,June,17,Monday,Summer,Clear,565,484,81
2011-06-20,2011,June,18,Monday,Summer,Clear,538,474,64
2011-06-20,2011,June,19,Monday,Summer,Clear,431,369,62
2011-06-20,2011,June,20,Monday,Summer,Clear,316,264,52
2011-06-20,2011,June,21,Monday,Summer,Clear,206,167,39
2011-06-20,2011,June,22,Monday,Summer,Cloudy,130,106,24
2011-06-20,2011,June,23,Monday,Summer,Clear,60,50,10
2011-06-21,2011,June,0,Tuesday,Fall,Clear,33,23,10
2011-06-21,2011,June,1,Tuesday,Fall,Light Snow/Rain,14,12,2
2011-06-21,2011,June,2,Tuesday,Fall,Light Snow/Rain,6,5,1
2011-06-21,2011,June,3,Tuesday,Fall,Light Snow/Rain,2,2,0
2011-06-21,2011,June,4,Tuesday,Fall,Cloudy,9,7,2
2011-06-21,2011,June,5,Tuesday,Fall,Cloudy,25,22,3
2011-06-21,2011,June,6,Tuesday,Fall,Cloudy,115,107,8
2011-06-21,2011,June,7,Tuesday,Fall,Cloudy,309,288,21
2011-06-21,2011,June,8,Tuesday,Fall,Cloudy,401,368,33
2011-06-21,2011,June,9,Tuesday,Fall,Cloudy,275,243,32
2011-06-21,2011,June,10,Tuesday,Fall,Cloudy,161,120,41
2011-06-21,2011,June,11,Tuesday,Fall,Clear,171,119,52
2011-06-21,2011,June,12,Tuesday,Fall,Clear,189,149,40
2011-06-21,2011,June,13,Tuesday,Fall,Clear,207,158,49
2011-06-21,2011,June,14,Tuesday,Fall,Clear,152,108,44
2011-06-21,2011,June,15,Tuesday,Fall,Clear,170,128,42
2011-06-21,2011,June,16,Tuesday,Fall,Clear,335,273,62
2011-06-21,2011,June,17,Tuesday,Fall,Clear,572,507,65
2011-06-21,2011,June,18,Tuesday,Fall,Cloudy,536,469,67
2011-06-21,2011,June,19,Tuesday,Fall,Cloudy,425,358,67
2011-06-21,2011,June,20,Tuesday,Fall,Light Snow/Rain,326,254,72
2011-06-21,2011,June,21,Tuesday,Fall,Clear,229,191,38
2011-06-21,2011,June,22,Tuesday,Fall,Clear,109,97,12
2011-06-21,2011,June,23,Tuesday,Fall,Clear,64,53,11
2011-06-22,2011,June,0,Wednesday,Fall,Clear,33,18,15
2011-06-22,2011,June,1,Wednesday,Fall,Clear,21,19,2
2011-06-22,2011,June,2,Wednesday,Fall,Clear,7,5,2
2011-06-22,2011,June,3,Wednesday,Fall,Clear,7,7,0
2011-06-22,2011,June,4,Wednesday,Fall,Clear,11,8,3
2011-06-22,2011,June,5,Wednesday,Fall,Clear,23,21,2
2011-06-22,2011,June,6,Wednesday,Fall,Clear,122,110,12
2011-06-22,2011,June,7,Wednesday,Fall,Clear,311,288,23
2011-06-22,2011,June,8,Wednesday,Fall,Clear,423,396,27
2011-06-22,2011,June,9,Wednesday,Fall,Clear,219,205,14
2011-06-22,2011,June,10,Wednesday,Fall,Clear,135,104,31
2011-06-22,2011,June,11,Wednesday,Fall,Clear,145,108,37
2011-06-22,2011,June,12,Wednesday,Fall,Cloudy,188,144,44
2011-06-22,2011,June,13,Wednesday,Fall,Cloudy,147,113,34
2011-06-22,2011,June,14,Wednesday,Fall,Cloudy,145,113,32
2011-06-22,2011,June,15,Wednesday,Fall,Cloudy,146,114,32
2011-06-22,2011,June,16,Wednesday,Fall,Cloudy,258,224,34
2011-06-22,2011,June,17,Wednesday,Fall,Cloudy,529,462,67
2011-06-22,2011,June,18,Wednesday,Fall,Cloudy,513,447,66
2011-06-22,2011,June,19,Wednesday,Fall,Cloudy,342,280,62
2011-06-22,2011,June,20,Wednesday,Fall,Clear,282,230,52
2011-06-22,2011,June,21,Wednesday,Fall,Clear,247,216,31
2011-06-22,2011,June,22,Wednesday,Fall,Cloudy,148,123,25
2011-06-22,2011,June,23,Wednesday,Fall,Cloudy,105,91,14
2011-06-23,2011,June,0,Thursday,Fall,Clear,49,44,5
2011-06-23,2011,June,1,Thursday,Fall,Clear,31,26,5
2011-06-23,2011,June,2,Thursday,Fall,Clear,4,4,0
2011-06-23,2011,June,3,Thursday,Fall,Cloudy,5,4,1
2011-06-23,2011,June,4,Thursday,Fall,Cloudy,7,7,0
2011-06-23,2011,June,5,Thursday,Fall,Clear,24,22,2
2011-06-23,2011,June,6,Thursday,Fall,Clear,100,92,8
2011-06-23,2011,June,7,Thursday,Fall,Cloudy,327,301,26
2011-06-23,2011,June,8,Thursday,Fall,Cloudy,432,412,20
2011-06-23,2011,June,9,Thursday,Fall,Cloudy,227,194,33
2011-06-23,2011,June,10,Thursday,Fall,Cloudy,127,88,39
2011-06-23,2011,June,11,Thursday,Fall,Light Snow/Rain,136,108,28
2011-06-23,2011,June,12,Thursday,Fall,Cloudy,160,130,30
2011-06-23,2011,June,13,Thursday,Fall,Cloudy,186,149,37
2011-06-23,2011,June,14,Thursday,Fall,Cloudy,149,103,46
2011-06-23,2011,June,15,Thursday,Fall,Cloudy,189,127,62
2011-06-23,2011,June,16,Thursday,Fall,Cloudy,275,217,58
2011-06-23,2011,June,17,Thursday,Fall,Cloudy,569,495,74
2011-06-23,2011,June,18,Thursday,Fall,Clear,540,483,57
2011-06-23,2011,June,19,Thursday,Fall,Clear,400,344,56
2011-06-23,2011,June,20,Thursday,Fall,Clear,352,277,75
2011-06-23,2011,June,21,Thursday,Fall,Clear,234,188,46
2011-06-23,2011,June,22,Thursday,Fall,Cloudy,162,139,23
2011-06-23,2011,June,23,Thursday,Fall,Clear,105,90,15
2011-06-24,2011,June,0,Friday,Fall,Clear,63,53,10
2011-06-24,2011,June,1,Friday,Fall,Clear,28,20,8
2011-06-24,2011,June,2,Friday,Fall,Clear,14,10,4
2011-06-24,2011,June,3,Friday,Fall,Clear,5,4,1
2011-06-24,2011,June,4,Friday,Fall,Clear,9,8,1
2011-06-24,2011,June,5,Friday,Fall,Clear,20,18,2
2011-06-24,2011,June,6,Friday,Fall,Clear,91,87,4
2011-06-24,2011,June,7,Friday,Fall,Cloudy,268,247,21
2011-06-24,2011,June,8,Friday,Fall,Clear,466,439,27
2011-06-24,2011,June,9,Friday,Fall,Clear,231,203,28
2011-06-24,2011,June,10,Friday,Fall,Clear,145,102,43
2011-06-24,2011,June,11,Friday,Fall,Clear,203,147,56
2011-06-24,2011,June,12,Friday,Fall,Clear,201,150,51
2011-06-24,2011,June,13,Friday,Fall,Clear,221,178,43
2011-06-24,2011,June,14,Friday,Fall,Clear,229,162,67
2011-06-24,2011,June,15,Friday,Fall,Clear,216,147,69
2011-06-24,2011,June,16,Friday,Fall,Clear,327,247,80
2011-06-24,2011,June,17,Friday,Fall,Clear,557,472,85
2011-06-24,2011,June,18,Friday,Fall,Clear,452,365,87
2011-06-24,2011,June,19,Friday,Fall,Clear,385,293,92
2011-06-24,2011,June,20,Friday,Fall,Clear,288,222,66
2011-06-24,2011,June,21,Friday,Fall,Clear,233,183,50
2011-06-24,2011,June,22,Friday,Fall,Clear,167,126,41
2011-06-24,2011,June,23,Friday,Fall,Clear,172,139,33
2011-06-25,2011,June,0,Saturday,Fall,Clear,116,97,19
2011-06-25,2011,June,1,Saturday,Fall,Clear,95,75,20
2011-06-25,2011,June,2,Saturday,Fall,Cloudy,59,51,8
2011-06-25,2011,June,3,Saturday,Fall,Clear,39,21,18
2011-06-25,2011,June,4,Saturday,Fall,Clear,11,4,7
2011-06-25,2011,June,5,Saturday,Fall,Clear,14,8,6
2011-06-25,2011,June,6,Saturday,Fall,Clear,29,17,12
2011-06-25,2011,June,7,Saturday,Fall,Clear,42,35,7
2011-06-25,2011,June,8,Saturday,Fall,Clear,112,85,27
2011-06-25,2011,June,9,Saturday,Fall,Clear,186,139,47
2011-06-25,2011,June,10,Saturday,Fall,Clear,302,203,99
2011-06-25,2011,June,11,Saturday,Fall,Clear,331,209,122
2011-06-25,2011,June,12,Saturday,Fall,Clear,392,252,140
2011-06-25,2011,June,13,Saturday,Fall,Clear,371,231,140
2011-06-25,2011,June,14,Saturday,Fall,Clear,383,232,151
2011-06-25,2011,June,15,Saturday,Fall,Clear,392,235,157
2011-06-25,2011,June,16,Saturday,Fall,Clear,410,235,175
2011-06-25,2011,June,17,Saturday,Fall,Clear,399,247,152
2011-06-25,2011,June,18,Saturday,Fall,Clear,307,199,108
2011-06-25,2011,June,19,Saturday,Fall,Clear,375,254,121
2011-06-25,2011,June,20,Saturday,Fall,Clear,269,195,74
2011-06-25,2011,June,21,Saturday,Fall,Clear,202,140,62
2011-06-25,2011,June,22,Saturday,Fall,Clear,187,126,61
2011-06-25,2011,June,23,Saturday,Fall,Cloudy,179,130,49
2011-06-26,2011,June,0,Sunday,Fall,Clear,115,85,30
2011-06-26,2011,June,1,Sunday,Fall,Clear,90,73,17
2011-06-26,2011,June,2,Sunday,Fall,Clear,87,70,17
2011-06-26,2011,June,3,Sunday,Fall,Clear,34,22,12
2011-06-26,2011,June,4,Sunday,Fall,Clear,11,8,3
2011-06-26,2011,June,5,Sunday,Fall,Clear,12,9,3
2011-06-26,2011,June,6,Sunday,Fall,Clear,20,13,7
2011-06-26,2011,June,7,Sunday,Fall,Clear,51,27,24
2011-06-26,2011,June,8,Sunday,Fall,Clear,107,78,29
2011-06-26,2011,June,9,Sunday,Fall,Clear,206,131,75
2011-06-26,2011,June,10,Sunday,Fall,Clear,332,196,136
2011-06-26,2011,June,11,Sunday,Fall,Clear,346,219,127
2011-06-26,2011,June,12,Sunday,Fall,Clear,443,268,175
2011-06-26,2011,June,13,Sunday,Fall,Clear,442,245,197
2011-06-26,2011,June,14,Sunday,Fall,Clear,443,246,197
2011-06-26,2011,June,15,Sunday,Fall,Clear,403,229,174
2011-06-26,2011,June,16,Sunday,Fall,Clear,455,278,177
2011-06-26,2011,June,17,Sunday,Fall,Cloudy,421,243,178
2011-06-26,2011,June,18,Sunday,Fall,Cloudy,382,265,117
2011-06-26,2011,June,19,Sunday,Fall,Cloudy,317,228,89
2011-06-26,2011,June,20,Sunday,Fall,Cloudy,213,158,55
2011-06-26,2011,June,21,Sunday,Fall,Cloudy,183,135,48
2011-06-26,2011,June,22,Sunday,Fall,Clear,114,95,19
2011-06-26,2011,June,23,Sunday,Fall,Clear,78,64,14
2011-06-27,2011,June,0,Monday,Fall,Light Snow/Rain,32,25,7
2011-06-27,2011,June,1,Monday,Fall,Cloudy,15,11,4
2011-06-27,2011,June,2,Monday,Fall,Light Snow/Rain,6,3,3
2011-06-27,2011,June,3,Monday,Fall,Light Snow/Rain,2,2,0
2011-06-27,2011,June,4,Monday,Fall,Cloudy,9,8,1
2011-06-27,2011,June,5,Monday,Fall,Cloudy,22,21,1
2011-06-27,2011,June,6,Monday,Fall,Cloudy,94,90,4
2011-06-27,2011,June,7,Monday,Fall,Cloudy,261,247,14
2011-06-27,2011,June,8,Monday,Fall,Clear,447,418,29
2011-06-27,2011,June,9,Monday,Fall,Cloudy,187,150,37
2011-06-27,2011,June,10,Monday,Fall,Cloudy,150,95,55
2011-06-27,2011,June,11,Monday,Fall,Cloudy,150,95,55
2011-06-27,2011,June,12,Monday,Fall,Cloudy,170,130,40
2011-06-27,2011,June,13,Monday,Fall,Cloudy,164,127,37
2011-06-27,2011,June,14,Monday,Fall,Cloudy,158,100,58
2011-06-27,2011,June,15,Monday,Fall,Cloudy,202,126,76
2011-06-27,2011,June,16,Monday,Fall,Clear,275,222,53
2011-06-27,2011,June,17,Monday,Fall,Clear,604,514,90
2011-06-27,2011,June,18,Monday,Fall,Clear,591,512,79
2011-06-27,2011,June,19,Monday,Fall,Clear,396,340,56
2011-06-27,2011,June,20,Monday,Fall,Clear,305,251,54
2011-06-27,2011,June,21,Monday,Fall,Clear,242,190,52
2011-06-27,2011,June,22,Monday,Fall,Clear,145,112,33
2011-06-27,2011,June,23,Monday,Fall,Clear,81,65,16
2011-06-28,2011,June,0,Tuesday,Fall,Cloudy,30,25,5
2011-06-28,2011,June,1,Tuesday,Fall,Clear,13,8,5
2011-06-28,2011,June,2,Tuesday,Fall,Cloudy,11,9,2
2011-06-28,2011,June,3,Tuesday,Fall,Cloudy,2,2,0
2011-06-28,2011,June,4,Tuesday,Fall,Clear,8,7,1
2011-06-28,2011,June,5,Tuesday,Fall,Clear,21,20,1
2011-06-28,2011,June,6,Tuesday,Fall,Clear,124,117,7
2011-06-28,2011,June,7,Tuesday,Fall,Clear,347,320,27
2011-06-28,2011,June,8,Tuesday,Fall,Clear,456,417,39
2011-06-28,2011,June,9,Tuesday,Fall,Clear,246,208,38
2011-06-28,2011,June,10,Tuesday,Fall,Clear,157,112,45
2011-06-28,2011,June,11,Tuesday,Fall,Clear,167,118,49
2011-06-28,2011,June,12,Tuesday,Fall,Clear,202,161,41
2011-06-28,2011,June,13,Tuesday,Fall,Clear,189,156,33
2011-06-28,2011,June,14,Tuesday,Fall,Clear,160,117,43
2011-06-28,2011,June,15,Tuesday,Fall,Clear,166,127,39
2011-06-28,2011,June,16,Tuesday,Fall,Clear,261,220,41
2011-06-28,2011,June,17,Tuesday,Fall,Light Snow/Rain,579,509,70
2011-06-28,2011,June,18,Tuesday,Fall,Light Snow/Rain,504,436,68
2011-06-28,2011,June,19,Tuesday,Fall,Cloudy,299,255,44
2011-06-28,2011,June,20,Tuesday,Fall,Clear,296,246,50
2011-06-28,2011,June,21,Tuesday,Fall,Clear,195,164,31
2011-06-28,2011,June,22,Tuesday,Fall,Clear,134,104,30
2011-06-28,2011,June,23,Tuesday,Fall,Clear,81,58,23
2011-06-29,2011,June,0,Wednesday,Fall,Cloudy,36,25,11
2011-06-29,2011,June,1,Wednesday,Fall,Clear,28,18,10
2011-06-29,2011,June,2,Wednesday,Fall,Clear,16,9,7
2011-06-29,2011,June,3,Wednesday,Fall,Cloudy,5,3,2
2011-06-29,2011,June,4,Wednesday,Fall,Clear,5,5,0
2011-06-29,2011,June,5,Wednesday,Fall,Clear,22,19,3
2011-06-29,2011,June,6,Wednesday,Fall,Clear,116,104,12
2011-06-29,2011,June,7,Wednesday,Fall,Clear,336,318,18
2011-06-29,2011,June,8,Wednesday,Fall,Clear,540,499,41
2011-06-29,2011,June,9,Wednesday,Fall,Clear,221,189,32
2011-06-29,2011,June,10,Wednesday,Fall,Clear,126,95,31
2011-06-29,2011,June,11,Wednesday,Fall,Clear,170,117,53
2011-06-29,2011,June,12,Wednesday,Fall,Clear,243,188,55
2011-06-29,2011,June,13,Wednesday,Fall,Clear,231,186,45
2011-06-29,2011,June,14,Wednesday,Fall,Clear,188,138,50
2011-06-29,2011,June,15,Wednesday,Fall,Clear,189,146,43
2011-06-29,2011,June,16,Wednesday,Fall,Clear,328,268,60
2011-06-29,2011,June,17,Wednesday,Fall,Clear,570,492,78
2011-06-29,2011,June,18,Wednesday,Fall,Clear,588,510,78
2011-06-29,2011,June,19,Wednesday,Fall,Clear,401,341,60
2011-06-29,2011,June,20,Wednesday,Fall,Clear,333,264,69
2011-06-29,2011,June,21,Wednesday,Fall,Clear,221,195,26
2011-06-29,2011,June,22,Wednesday,Fall,Clear,183,151,32
2011-06-29,2011,June,23,Wednesday,Fall,Clear,129,97,32
2011-06-30,2011,June,0,Thursday,Fall,Clear,54,39,15
2011-06-30,2011,June,1,Thursday,Fall,Clear,32,19,13
2011-06-30,2011,June,2,Thursday,Fall,Clear,8,6,2
2011-06-30,2011,June,3,Thursday,Fall,Clear,9,7,2
2011-06-30,2011,June,4,Thursday,Fall,Clear,6,4,2
2011-06-30,2011,June,5,Thursday,Fall,Clear,25,24,1
2011-06-30,2011,June,6,Thursday,Fall,Clear,123,119,4
2011-06-30,2011,June,7,Thursday,Fall,Clear,320,291,29
2011-06-30,2011,June,8,Thursday,Fall,Clear,555,511,44
2011-06-30,2011,June,9,Thursday,Fall,Clear,260,227,33
2011-06-30,2011,June,10,Thursday,Fall,Clear,132,97,35
2011-06-30,2011,June,11,Thursday,Fall,Clear,169,122,47
2011-06-30,2011,June,12,Thursday,Fall,Clear,233,183,50
2011-06-30,2011,June,13,Thursday,Fall,Clear,232,162,70
2011-06-30,2011,June,14,Thursday,Fall,Clear,163,117,46
2011-06-30,2011,June,15,Thursday,Fall,Clear,240,176,64
2011-06-30,2011,June,16,Thursday,Fall,Clear,323,260,63
2011-06-30,2011,June,17,Thursday,Fall,Clear,594,496,98
2011-06-30,2011,June,18,Thursday,Fall,Clear,586,472,114
2011-06-30,2011,June,19,Thursday,Fall,Clear,455,366,89
2011-06-30,2011,June,20,Thursday,Fall,Clear,340,285,55
2011-06-30,2011,June,21,Thursday,Fall,Clear,323,242,81
2011-06-30,2011,June,22,Thursday,Fall,Clear,207,164,43
2011-06-30,2011,June,23,Thursday,Fall,Clear,126,99,27
2011-07-01,2011,July,0,Friday,Fall,Clear,68,48,20
2011-07-01,2011,July,1,Friday,Fall,Clear,31,16,15
2011-07-01,2011,July,2,Friday,Fall,Clear,13,7,6
2011-07-01,2011,July,3,Friday,Fall,Clear,11,6,5
2011-07-01,2011,July,4,Friday,Fall,Clear,6,5,1
2011-07-01,2011,July,5,Friday,Fall,Clear,30,27,3
2011-07-01,2011,July,6,Friday,Fall,Clear,108,97,11
2011-07-01,2011,July,7,Friday,Fall,Clear,243,218,25
2011-07-01,2011,July,8,Friday,Fall,Clear,492,453,39
2011-07-01,2011,July,9,Friday,Fall,Clear,260,202,58
2011-07-01,2011,July,10,Friday,Fall,Clear,170,109,61
2011-07-01,2011,July,11,Friday,Fall,Clear,214,146,68
2011-07-01,2011,July,12,Friday,Fall,Clear,263,180,83
2011-07-01,2011,July,13,Friday,Fall,Clear,292,209,83
2011-07-01,2011,July,14,Friday,Fall,Clear,303,225,78
2011-07-01,2011,July,15,Friday,Fall,Clear,381,299,82
2011-07-01,2011,July,16,Friday,Fall,Clear,427,342,85
2011-07-01,2011,July,17,Friday,Fall,Clear,461,362,99
2011-07-01,2011,July,18,Friday,Fall,Clear,422,324,98
2011-07-01,2011,July,19,Friday,Fall,Clear,318,238,80
2011-07-01,2011,July,20,Friday,Fall,Clear,269,185,84
2011-07-01,2011,July,21,Friday,Fall,Clear,218,149,69
2011-07-01,2011,July,22,Friday,Fall,Clear,222,173,49
2011-07-01,2011,July,23,Friday,Fall,Clear,140,96,44
2011-07-02,2011,July,0,Saturday,Fall,Clear,115,84,31
2011-07-02,2011,July,1,Saturday,Fall,Clear,78,58,20
2011-07-02,2011,July,2,Saturday,Fall,Clear,52,43,9
2011-07-02,2011,July,3,Saturday,Fall,Clear,26,21,5
2011-07-02,2011,July,4,Saturday,Fall,Clear,11,8,3
2011-07-02,2011,July,5,Saturday,Fall,Clear,14,13,1
2011-07-02,2011,July,6,Saturday,Fall,Clear,32,21,11
2011-07-02,2011,July,7,Saturday,Fall,Clear,45,35,10
2011-07-02,2011,July,8,Saturday,Fall,Clear,132,94,38
2011-07-02,2011,July,9,Saturday,Fall,Clear,179,124,55
2011-07-02,2011,July,10,Saturday,Fall,Clear,271,168,103
2011-07-02,2011,July,11,Saturday,Fall,Clear,357,213,144
2011-07-02,2011,July,12,Saturday,Fall,Clear,374,232,142
2011-07-02,2011,July,13,Saturday,Fall,Clear,404,226,178
2011-07-02,2011,July,14,Saturday,Fall,Clear,392,215,177
2011-07-02,2011,July,15,Saturday,Fall,Clear,331,163,168
2011-07-02,2011,July,16,Saturday,Fall,Clear,398,192,206
2011-07-02,2011,July,17,Saturday,Fall,Clear,349,170,179
2011-07-02,2011,July,18,Saturday,Fall,Clear,383,190,193
2011-07-02,2011,July,19,Saturday,Fall,Clear,305,149,156
2011-07-02,2011,July,20,Saturday,Fall,Clear,284,148,136
2011-07-02,2011,July,21,Saturday,Fall,Clear,232,137,95
2011-07-02,2011,July,22,Saturday,Fall,Clear,201,123,78
2011-07-02,2011,July,23,Saturday,Fall,Clear,154,88,66
2011-07-03,2011,July,0,Sunday,Fall,Clear,144,97,47
2011-07-03,2011,July,1,Sunday,Fall,Cloudy,78,55,23
2011-07-03,2011,July,2,Sunday,Fall,Clear,69,50,19
2011-07-03,2011,July,3,Sunday,Fall,Light Snow/Rain,33,25,8
2011-07-03,2011,July,4,Sunday,Fall,Light Snow/Rain,5,2,3
2011-07-03,2011,July,5,Sunday,Fall,Light Snow/Rain,1,1,0
2011-07-03,2011,July,6,Sunday,Fall,Cloudy,3,3,0
2011-07-03,2011,July,7,Sunday,Fall,Cloudy,25,22,3
2011-07-03,2011,July,8,Sunday,Fall,Clear,92,53,39
2011-07-03,2011,July,9,Sunday,Fall,Clear,181,99,82
2011-07-03,2011,July,10,Sunday,Fall,Clear,264,133,131
2011-07-03,2011,July,11,Sunday,Fall,Clear,390,175,215
2011-07-03,2011,July,12,Sunday,Fall,Clear,404,206,198
2011-07-03,2011,July,13,Sunday,Fall,Clear,421,173,248
2011-07-03,2011,July,14,Sunday,Fall,Clear,375,150,225
2011-07-03,2011,July,15,Sunday,Fall,Clear,376,182,194
2011-07-03,2011,July,16,Sunday,Fall,Clear,414,219,195
2011-07-03,2011,July,17,Sunday,Fall,Light Snow/Rain,358,177,181
2011-07-03,2011,July,18,Sunday,Fall,Light Snow/Rain,181,107,74
2011-07-03,2011,July,19,Sunday,Fall,Cloudy,183,83,100
2011-07-03,2011,July,20,Sunday,Fall,Light Snow/Rain,176,93,83
2011-07-03,2011,July,21,Sunday,Fall,Cloudy,167,92,75
2011-07-03,2011,July,22,Sunday,Fall,Cloudy,162,93,69
2011-07-03,2011,July,23,Sunday,Fall,Clear,147,77,70
2011-07-04,2011,July,0,Monday,Fall,Clear,140,77,63
2011-07-04,2011,July,1,Monday,Fall,Clear,119,76,43
2011-07-04,2011,July,2,Monday,Fall,Clear,63,30,33
2011-07-04,2011,July,3,Monday,Fall,Clear,26,13,13
2011-07-04,2011,July,4,Monday,Fall,Cloudy,12,4,8
2011-07-04,2011,July,5,Monday,Fall,Cloudy,4,3,1
2011-07-04,2011,July,6,Monday,Fall,Clear,16,11,5
2011-07-04,2011,July,7,Monday,Fall,Clear,36,19,17
2011-07-04,2011,July,8,Monday,Fall,Clear,86,44,42
2011-07-04,2011,July,9,Monday,Fall,Cloudy,238,96,142
2011-07-04,2011,July,10,Monday,Fall,Cloudy,280,114,166
2011-07-04,2011,July,11,Monday,Fall,Cloudy,349,172,177
2011-07-04,2011,July,12,Monday,Fall,Cloudy,447,210,237
2011-07-04,2011,July,13,Monday,Fall,Cloudy,423,181,242
2011-07-04,2011,July,14,Monday,Fall,Clear,408,173,235
2011-07-04,2011,July,15,Monday,Fall,Clear,408,184,224
2011-07-04,2011,July,16,Monday,Fall,Clear,452,216,236
2011-07-04,2011,July,17,Monday,Fall,Clear,436,196,240
2011-07-04,2011,July,18,Monday,Fall,Clear,418,196,222
2011-07-04,2011,July,19,Monday,Fall,Cloudy,375,205,170
2011-07-04,2011,July,20,Monday,Fall,Cloudy,386,191,195
2011-07-04,2011,July,21,Monday,Fall,Cloudy,457,262,195
2011-07-04,2011,July,22,Monday,Fall,Cloudy,326,211,115
2011-07-04,2011,July,23,Monday,Fall,Cloudy,138,94,44
2011-07-05,2011,July,0,Tuesday,Fall,Cloudy,55,36,19
2011-07-05,2011,July,1,Tuesday,Fall,Clear,39,24,15
2011-07-05,2011,July,2,Tuesday,Fall,Clear,13,5,8
2011-07-05,2011,July,3,Tuesday,Fall,Clear,8,7,1
2011-07-05,2011,July,4,Tuesday,Fall,Clear,5,4,1
2011-07-05,2011,July,5,Tuesday,Fall,Clear,20,19,1
2011-07-05,2011,July,6,Tuesday,Fall,Clear,94,91,3
2011-07-05,2011,July,7,Tuesday,Fall,Clear,270,248,22
2011-07-05,2011,July,8,Tuesday,Fall,Clear,432,391,41
2011-07-05,2011,July,9,Tuesday,Fall,Clear,227,177,50
2011-07-05,2011,July,10,Tuesday,Fall,Clear,139,84,55
2011-07-05,2011,July,11,Tuesday,Fall,Clear,172,97,75
2011-07-05,2011,July,12,Tuesday,Fall,Clear,201,130,71
2011-07-05,2011,July,13,Tuesday,Fall,Clear,203,136,67
2011-07-05,2011,July,14,Tuesday,Fall,Clear,178,112,66
2011-07-05,2011,July,15,Tuesday,Fall,Clear,162,111,51
2011-07-05,2011,July,16,Tuesday,Fall,Clear,281,202,79
2011-07-05,2011,July,17,Tuesday,Fall,Clear,545,466,79
2011-07-05,2011,July,18,Tuesday,Fall,Clear,496,426,70
2011-07-05,2011,July,19,Tuesday,Fall,Clear,368,297,71
2011-07-05,2011,July,20,Tuesday,Fall,Clear,284,225,59
2011-07-05,2011,July,21,Tuesday,Fall,Clear,245,168,77
2011-07-05,2011,July,22,Tuesday,Fall,Clear,155,124,31
2011-07-05,2011,July,23,Tuesday,Fall,Clear,73,54,19
2011-07-06,2011,July,0,Wednesday,Fall,Clear,37,26,11
2011-07-06,2011,July,1,Wednesday,Fall,Clear,15,11,4
2011-07-06,2011,July,2,Wednesday,Fall,Clear,5,4,1
2011-07-06,2011,July,3,Wednesday,Fall,Clear,6,6,0
2011-07-06,2011,July,4,Wednesday,Fall,Cloudy,6,6,0
2011-07-06,2011,July,5,Wednesday,Fall,Clear,35,30,5
2011-07-06,2011,July,6,Wednesday,Fall,Clear,121,112,9
2011-07-06,2011,July,7,Wednesday,Fall,Cloudy,312,288,24
2011-07-06,2011,July,8,Wednesday,Fall,Cloudy,428,397,31
2011-07-06,2011,July,9,Wednesday,Fall,Light Snow/Rain,189,158,31
2011-07-06,2011,July,10,Wednesday,Fall,Light Snow/Rain,43,30,13
2011-07-06,2011,July,11,Wednesday,Fall,Cloudy,127,103,24
2011-07-06,2011,July,12,Wednesday,Fall,Cloudy,152,114,38
2011-07-06,2011,July,13,Wednesday,Fall,Cloudy,140,107,33
2011-07-06,2011,July,14,Wednesday,Fall,Clear,163,113,50
2011-07-06,2011,July,15,Wednesday,Fall,Clear,185,130,55
2011-07-06,2011,July,16,Wednesday,Fall,Clear,275,218,57
2011-07-06,2011,July,17,Wednesday,Fall,Clear,596,517,79
2011-07-06,2011,July,18,Wednesday,Fall,Clear,563,486,77
2011-07-06,2011,July,19,Wednesday,Fall,Clear,394,323,71
2011-07-06,2011,July,20,Wednesday,Fall,Clear,312,257,55
2011-07-06,2011,July,21,Wednesday,Fall,Clear,241,175,66
2011-07-06,2011,July,22,Wednesday,Fall,Clear,186,156,30
2011-07-06,2011,July,23,Wednesday,Fall,Clear,98,78,20
2011-07-07,2011,July,0,Thursday,Fall,Clear,35,29,6
2011-07-07,2011,July,1,Thursday,Fall,Clear,16,14,2
2011-07-07,2011,July,2,Thursday,Fall,Clear,8,7,1
2011-07-07,2011,July,3,Thursday,Fall,Clear,4,2,2
2011-07-07,2011,July,4,Thursday,Fall,Clear,4,4,0
2011-07-07,2011,July,5,Thursday,Fall,Clear,32,30,2
2011-07-07,2011,July,6,Thursday,Fall,Cloudy,118,107,11
2011-07-07,2011,July,7,Thursday,Fall,Cloudy,292,279,13
2011-07-07,2011,July,8,Thursday,Fall,Cloudy,443,415,28
2011-07-07,2011,July,9,Thursday,Fall,Clear,179,154,25
2011-07-07,2011,July,10,Thursday,Fall,Clear,101,72,29
2011-07-07,2011,July,11,Thursday,Fall,Clear,142,112,30
2011-07-07,2011,July,12,Thursday,Fall,Clear,171,139,32
2011-07-07,2011,July,13,Thursday,Fall,Clear,155,107,48
2011-07-07,2011,July,14,Thursday,Fall,Clear,160,121,39
2011-07-07,2011,July,15,Thursday,Fall,Clear,166,119,47
2011-07-07,2011,July,16,Thursday,Fall,Clear,265,218,47
2011-07-07,2011,July,17,Thursday,Fall,Clear,569,489,80
2011-07-07,2011,July,18,Thursday,Fall,Clear,562,492,70
2011-07-07,2011,July,19,Thursday,Fall,Clear,365,286,79
2011-07-07,2011,July,20,Thursday,Fall,Clear,285,224,61
2011-07-07,2011,July,21,Thursday,Fall,Clear,209,170,39
2011-07-07,2011,July,22,Thursday,Fall,Clear,182,150,32
2011-07-07,2011,July,23,Thursday,Fall,Clear,129,98,31
2011-07-08,2011,July,0,Friday,Fall,Clear,47,41,6
2011-07-08,2011,July,1,Friday,Fall,Clear,34,25,9
2011-07-08,2011,July,2,Friday,Fall,Cloudy,22,12,10
2011-07-08,2011,July,3,Friday,Fall,Clear,6,4,2
2011-07-08,2011,July,4,Friday,Fall,Clear,11,4,7
2011-07-08,2011,July,5,Friday,Fall,Clear,27,24,3
2011-07-08,2011,July,6,Friday,Fall,Clear,102,91,11
2011-07-08,2011,July,7,Friday,Fall,Cloudy,332,302,30
2011-07-08,2011,July,8,Friday,Fall,Cloudy,457,421,36
2011-07-08,2011,July,9,Friday,Fall,Cloudy,241,211,30
2011-07-08,2011,July,10,Friday,Fall,Cloudy,138,108,30
2011-07-08,2011,July,11,Friday,Fall,Cloudy,165,104,61
2011-07-08,2011,July,12,Friday,Fall,Cloudy,213,164,49
2011-07-08,2011,July,13,Friday,Fall,Cloudy,229,175,54
2011-07-08,2011,July,14,Friday,Fall,Cloudy,216,163,53
2011-07-08,2011,July,15,Friday,Fall,Cloudy,141,102,39
2011-07-08,2011,July,16,Friday,Fall,Light Snow/Rain,132,105,27
2011-07-08,2011,July,17,Friday,Fall,Light Snow/Rain,167,161,6
2011-07-08,2011,July,18,Friday,Fall,Clear,316,281,35
2011-07-08,2011,July,19,Friday,Fall,Clear,270,225,45
2011-07-08,2011,July,20,Friday,Fall,Clear,250,220,30
2011-07-08,2011,July,21,Friday,Fall,Cloudy,204,158,46
2011-07-08,2011,July,22,Friday,Fall,Cloudy,169,136,33
2011-07-08,2011,July,23,Friday,Fall,Cloudy,151,111,40
2011-07-09,2011,July,0,Saturday,Fall,Cloudy,121,90,31
2011-07-09,2011,July,1,Saturday,Fall,Cloudy,53,48,5
2011-07-09,2011,July,2,Saturday,Fall,Clear,55,43,12
2011-07-09,2011,July,3,Saturday,Fall,Clear,30,23,7
2011-07-09,2011,July,4,Saturday,Fall,Clear,6,4,2
2011-07-09,2011,July,5,Saturday,Fall,Cloudy,15,11,4
2011-07-09,2011,July,6,Saturday,Fall,Cloudy,38,27,11
2011-07-09,2011,July,7,Saturday,Fall,Clear,71,50,21
2011-07-09,2011,July,8,Saturday,Fall,Clear,182,114,68
2011-07-09,2011,July,9,Saturday,Fall,Clear,247,170,77
2011-07-09,2011,July,10,Saturday,Fall,Clear,264,177,87
2011-07-09,2011,July,11,Saturday,Fall,Clear,290,189,101
2011-07-09,2011,July,12,Saturday,Fall,Clear,366,221,145
2011-07-09,2011,July,13,Saturday,Fall,Clear,416,249,167
2011-07-09,2011,July,14,Saturday,Fall,Clear,373,215,158
2011-07-09,2011,July,15,Saturday,Fall,Clear,402,220,182
2011-07-09,2011,July,16,Saturday,Fall,Clear,416,245,171
2011-07-09,2011,July,17,Saturday,Fall,Clear,401,241,160
2011-07-09,2011,July,18,Saturday,Fall,Clear,378,246,132
2011-07-09,2011,July,19,Saturday,Fall,Clear,306,178,128
2011-07-09,2011,July,20,Saturday,Fall,Clear,314,185,129
2011-07-09,2011,July,21,Saturday,Fall,Clear,238,155,83
2011-07-09,2011,July,22,Saturday,Fall,Clear,214,154,60
2011-07-09,2011,July,23,Saturday,Fall,Clear,140,93,47
2011-07-10,2011,July,0,Sunday,Fall,Clear,154,112,42
2011-07-10,2011,July,1,Sunday,Fall,Clear,113,94,19
2011-07-10,2011,July,2,Sunday,Fall,Clear,96,68,28
2011-07-10,2011,July,3,Sunday,Fall,Clear,25,19,6
2011-07-10,2011,July,4,Sunday,Fall,Clear,5,5,0
2011-07-10,2011,July,5,Sunday,Fall,Clear,17,10,7
2011-07-10,2011,July,6,Sunday,Fall,Clear,25,17,8
2011-07-10,2011,July,7,Sunday,Fall,Clear,65,38,27
2011-07-10,2011,July,8,Sunday,Fall,Clear,92,65,27
2011-07-10,2011,July,9,Sunday,Fall,Clear,169,107,62
2011-07-10,2011,July,10,Sunday,Fall,Clear,268,173,95
2011-07-10,2011,July,11,Sunday,Fall,Clear,287,177,110
2011-07-10,2011,July,12,Sunday,Fall,Clear,377,244,133
2011-07-10,2011,July,13,Sunday,Fall,Clear,367,228,139
2011-07-10,2011,July,14,Sunday,Fall,Clear,349,227,122
2011-07-10,2011,July,15,Sunday,Fall,Clear,361,219,142
2011-07-10,2011,July,16,Sunday,Fall,Clear,372,244,128
2011-07-10,2011,July,17,Sunday,Fall,Clear,363,217,146
2011-07-10,2011,July,18,Sunday,Fall,Clear,363,222,141
2011-07-10,2011,July,19,Sunday,Fall,Clear,303,183,120
2011-07-10,2011,July,20,Sunday,Fall,Clear,268,167,101
2011-07-10,2011,July,21,Sunday,Fall,Clear,227,162,65
2011-07-10,2011,July,22,Sunday,Fall,Clear,143,87,56
2011-07-10,2011,July,23,Sunday,Fall,Clear,72,53,19
2011-07-11,2011,July,0,Monday,Fall,Clear,35,25,10
2011-07-11,2011,July,1,Monday,Fall,Clear,10,5,5
2011-07-11,2011,July,2,Monday,Fall,Clear,12,4,8
2011-07-11,2011,July,3,Monday,Fall,Clear,10,8,2
2011-07-11,2011,July,4,Monday,Fall,Clear,4,4,0
2011-07-11,2011,July,5,Monday,Fall,Clear,26,21,5
2011-07-11,2011,July,6,Monday,Fall,Clear,121,102,19
2011-07-11,2011,July,7,Monday,Fall,Clear,317,289,28
2011-07-11,2011,July,8,Monday,Fall,Clear,420,385,35
2011-07-11,2011,July,9,Monday,Fall,Clear,208,167,41
2011-07-11,2011,July,10,Monday,Fall,Clear,117,73,44
2011-07-11,2011,July,11,Monday,Fall,Clear,128,89,39
2011-07-11,2011,July,12,Monday,Fall,Clear,148,108,40
2011-07-11,2011,July,13,Monday,Fall,Clear,141,119,22
2011-07-11,2011,July,14,Monday,Fall,Clear,134,94,40
2011-07-11,2011,July,15,Monday,Fall,Clear,146,108,38
2011-07-11,2011,July,16,Monday,Fall,Clear,239,182,57
2011-07-11,2011,July,17,Monday,Fall,Clear,514,455,59
2011-07-11,2011,July,18,Monday,Fall,Clear,472,415,57
2011-07-11,2011,July,19,Monday,Fall,Clear,373,293,80
2011-07-11,2011,July,20,Monday,Fall,Clear,236,194,42
2011-07-11,2011,July,21,Monday,Fall,Clear,130,109,21
2011-07-11,2011,July,22,Monday,Fall,Clear,90,70,20
2011-07-11,2011,July,23,Monday,Fall,Clear,55,44,11
2011-07-12,2011,July,0,Tuesday,Fall,Clear,22,19,3
2011-07-12,2011,July,1,Tuesday,Fall,Clear,14,8,6
2011-07-12,2011,July,2,Tuesday,Fall,Clear,9,7,2
2011-07-12,2011,July,3,Tuesday,Fall,Cloudy,8,6,2
2011-07-12,2011,July,4,Tuesday,Fall,Clear,6,6,0
2011-07-12,2011,July,5,Tuesday,Fall,Clear,25,21,4
2011-07-12,2011,July,6,Tuesday,Fall,Clear,115,102,13
2011-07-12,2011,July,7,Tuesday,Fall,Clear,330,301,29
2011-07-12,2011,July,8,Tuesday,Fall,Clear,417,382,35
2011-07-12,2011,July,9,Tuesday,Fall,Clear,176,149,27
2011-07-12,2011,July,10,Tuesday,Fall,Clear,123,85,38
2011-07-12,2011,July,11,Tuesday,Fall,Clear,125,86,39
2011-07-12,2011,July,12,Tuesday,Fall,Clear,163,125,38
2011-07-12,2011,July,13,Tuesday,Fall,Clear,136,104,32
2011-07-12,2011,July,14,Tuesday,Fall,Clear,124,91,33
2011-07-12,2011,July,15,Tuesday,Fall,Clear,148,111,37
2011-07-12,2011,July,16,Tuesday,Fall,Clear,202,177,25
2011-07-12,2011,July,17,Tuesday,Fall,Clear,428,380,48
2011-07-12,2011,July,18,Tuesday,Fall,Clear,511,472,39
2011-07-12,2011,July,19,Tuesday,Fall,Clear,337,295,42
2011-07-12,2011,July,20,Tuesday,Fall,Clear,308,251,57
2011-07-12,2011,July,21,Tuesday,Fall,Clear,258,209,49
2011-07-12,2011,July,22,Tuesday,Fall,Clear,194,150,44
2011-07-12,2011,July,23,Tuesday,Fall,Clear,79,59,20
2011-07-13,2011,July,0,Wednesday,Fall,Clear,46,37,9
2011-07-13,2011,July,1,Wednesday,Fall,Clear,12,11,1
2011-07-13,2011,July,2,Wednesday,Fall,Clear,5,3,2
2011-07-13,2011,July,3,Wednesday,Fall,Clear,4,4,0
2011-07-13,2011,July,4,Wednesday,Fall,Clear,5,5,0
2011-07-13,2011,July,5,Wednesday,Fall,Clear,26,22,4
2011-07-13,2011,July,6,Wednesday,Fall,Clear,121,103,18
2011-07-13,2011,July,7,Wednesday,Fall,Clear,313,281,32
2011-07-13,2011,July,8,Wednesday,Fall,Clear,449,418,31
2011-07-13,2011,July,9,Wednesday,Fall,Clear,186,163,23
2011-07-13,2011,July,10,Wednesday,Fall,Clear,113,80,33
2011-07-13,2011,July,11,Wednesday,Fall,Clear,165,110,55
2011-07-13,2011,July,12,Wednesday,Fall,Clear,174,134,40
2011-07-13,2011,July,13,Wednesday,Fall,Light Snow/Rain,158,119,39
2011-07-13,2011,July,14,Wednesday,Fall,Light Snow/Rain,116,89,27
2011-07-13,2011,July,15,Wednesday,Fall,Light Snow/Rain,46,33,13
2011-07-13,2011,July,16,Wednesday,Fall,Cloudy,141,118,23
2011-07-13,2011,July,17,Wednesday,Fall,Clear,488,418,70
2011-07-13,2011,July,18,Wednesday,Fall,Clear,463,412,51
2011-07-13,2011,July,19,Wednesday,Fall,Clear,419,340,79
2011-07-13,2011,July,20,Wednesday,Fall,Clear,342,281,61
2011-07-13,2011,July,21,Wednesday,Fall,Clear,250,194,56
2011-07-13,2011,July,22,Wednesday,Fall,Clear,184,136,48
2011-07-13,2011,July,23,Wednesday,Fall,Clear,116,83,33
2011-07-14,2011,July,0,Thursday,Fall,Clear,46,32,14
2011-07-14,2011,July,1,Thursday,Fall,Clear,25,21,4
2011-07-14,2011,July,2,Thursday,Fall,Clear,10,7,3
2011-07-14,2011,July,3,Thursday,Fall,Clear,6,5,1
2011-07-14,2011,July,4,Thursday,Fall,Clear,6,6,0
2011-07-14,2011,July,5,Thursday,Fall,Clear,28,22,6
2011-07-14,2011,July,6,Thursday,Fall,Clear,130,116,14
2011-07-14,2011,July,7,Thursday,Fall,Clear,334,311,23
2011-07-14,2011,July,8,Thursday,Fall,Clear,486,433,53
2011-07-14,2011,July,9,Thursday,Fall,Clear,224,195,29
2011-07-14,2011,July,10,Thursday,Fall,Clear,127,95,32
2011-07-14,2011,July,11,Thursday,Fall,Clear,148,110,38
2011-07-14,2011,July,12,Thursday,Fall,Clear,223,172,51
2011-07-14,2011,July,13,Thursday,Fall,Clear,177,138,39
2011-07-14,2011,July,14,Thursday,Fall,Clear,178,129,49
2011-07-14,2011,July,15,Thursday,Fall,Clear,180,138,42
2011-07-14,2011,July,16,Thursday,Fall,Clear,274,231,43
2011-07-14,2011,July,17,Thursday,Fall,Clear,595,517,78
2011-07-14,2011,July,18,Thursday,Fall,Clear,578,484,94
2011-07-14,2011,July,19,Thursday,Fall,Clear,400,333,67
2011-07-14,2011,July,20,Thursday,Fall,Clear,348,267,81
2011-07-14,2011,July,21,Thursday,Fall,Clear,261,203,58
2011-07-14,2011,July,22,Thursday,Fall,Clear,176,134,42
2011-07-14,2011,July,23,Thursday,Fall,Clear,124,97,27
2011-07-15,2011,July,0,Friday,Fall,Clear,80,57,23
2011-07-15,2011,July,1,Friday,Fall,Clear,20,13,7
2011-07-15,2011,July,2,Friday,Fall,Clear,38,22,16
2011-07-15,2011,July,3,Friday,Fall,Clear,7,6,1
2011-07-15,2011,July,4,Friday,Fall,Clear,10,8,2
2011-07-15,2011,July,5,Friday,Fall,Clear,23,16,7
2011-07-15,2011,July,6,Friday,Fall,Cloudy,120,108,12
2011-07-15,2011,July,7,Friday,Fall,Clear,274,257,17
2011-07-15,2011,July,8,Friday,Fall,Clear,564,514,50
2011-07-15,2011,July,9,Friday,Fall,Clear,207,176,31
2011-07-15,2011,July,10,Friday,Fall,Cloudy,166,107,59
2011-07-15,2011,July,11,Friday,Fall,Clear,210,137,73
2011-07-15,2011,July,12,Friday,Fall,Clear,238,177,61
2011-07-15,2011,July,13,Friday,Fall,Clear,247,162,85
2011-07-15,2011,July,14,Friday,Fall,Clear,265,160,105
2011-07-15,2011,July,15,Friday,Fall,Clear,237,163,74
2011-07-15,2011,July,16,Friday,Fall,Clear,361,265,96
2011-07-15,2011,July,17,Friday,Fall,Clear,587,483,104
2011-07-15,2011,July,18,Friday,Fall,Clear,496,394,102
2011-07-15,2011,July,19,Friday,Fall,Clear,394,280,114
2011-07-15,2011,July,20,Friday,Fall,Clear,343,251,92
2011-07-15,2011,July,21,Friday,Fall,Clear,261,186,75
2011-07-15,2011,July,22,Friday,Fall,Clear,223,152,71
2011-07-15,2011,July,23,Friday,Fall,Clear,167,126,41
2011-07-16,2011,July,0,Saturday,Fall,Clear,110,68,42
2011-07-16,2011,July,1,Saturday,Fall,Clear,75,51,24
2011-07-16,2011,July,2,Saturday,Fall,Clear,58,48,10
2011-07-16,2011,July,3,Saturday,Fall,Clear,26,20,6
2011-07-16,2011,July,4,Saturday,Fall,Clear,16,7,9
2011-07-16,2011,July,5,Saturday,Fall,Clear,10,6,4
2011-07-16,2011,July,6,Saturday,Fall,Clear,37,21,16
2011-07-16,2011,July,7,Saturday,Fall,Clear,52,38,14
2011-07-16,2011,July,8,Saturday,Fall,Clear,127,90,37
2011-07-16,2011,July,9,Saturday,Fall,Clear,222,150,72
2011-07-16,2011,July,10,Saturday,Fall,Clear,322,208,114
2011-07-16,2011,July,11,Saturday,Fall,Clear,396,225,171
2011-07-16,2011,July,12,Saturday,Fall,Clear,463,276,187
2011-07-16,2011,July,13,Saturday,Fall,Clear,497,276,221
2011-07-16,2011,July,14,Saturday,Fall,Clear,433,232,201
2011-07-16,2011,July,15,Saturday,Fall,Clear,428,223,205
2011-07-16,2011,July,16,Saturday,Fall,Clear,425,242,183
2011-07-16,2011,July,17,Saturday,Fall,Clear,475,241,234
2011-07-16,2011,July,18,Saturday,Fall,Clear,428,243,185
2011-07-16,2011,July,19,Saturday,Fall,Clear,406,242,164
2011-07-16,2011,July,20,Saturday,Fall,Clear,296,188,108
2011-07-16,2011,July,21,Saturday,Fall,Clear,252,167,85
2011-07-16,2011,July,22,Saturday,Fall,Clear,201,136,65
2011-07-16,2011,July,23,Saturday,Fall,Clear,168,107,61
2011-07-17,2011,July,0,Sunday,Fall,Clear,125,91,34
2011-07-17,2011,July,1,Sunday,Fall,Clear,102,86,16
2011-07-17,2011,July,2,Sunday,Fall,Clear,94,66,28
2011-07-17,2011,July,3,Sunday,Fall,Clear,47,26,21
2011-07-17,2011,July,4,Sunday,Fall,Clear,10,6,4
2011-07-17,2011,July,5,Sunday,Fall,Clear,12,8,4
2011-07-17,2011,July,6,Sunday,Fall,Clear,21,11,10
2011-07-17,2011,July,7,Sunday,Fall,Clear,50,30,20
2011-07-17,2011,July,8,Sunday,Fall,Clear,118,73,45
2011-07-17,2011,July,9,Sunday,Fall,Clear,184,110,74
2011-07-17,2011,July,10,Sunday,Fall,Clear,304,177,127
2011-07-17,2011,July,11,Sunday,Fall,Clear,391,244,147
2011-07-17,2011,July,12,Sunday,Fall,Clear,420,243,177
2011-07-17,2011,July,13,Sunday,Fall,Clear,472,272,200
2011-07-17,2011,July,14,Sunday,Fall,Clear,430,262,168
2011-07-17,2011,July,15,Sunday,Fall,Clear,324,195,129
2011-07-17,2011,July,16,Sunday,Fall,Clear,317,188,129
2011-07-17,2011,July,17,Sunday,Fall,Clear,369,236,133
2011-07-17,2011,July,18,Sunday,Fall,Clear,390,243,147
2011-07-17,2011,July,19,Sunday,Fall,Clear,379,234,145
2011-07-17,2011,July,20,Sunday,Fall,Clear,262,177,85
2011-07-17,2011,July,21,Sunday,Fall,Clear,207,148,59
2011-07-17,2011,July,22,Sunday,Fall,Clear,181,116,65
2011-07-17,2011,July,23,Sunday,Fall,Clear,93,54,39
2011-07-18,2011,July,0,Monday,Fall,Clear,51,30,21
2011-07-18,2011,July,1,Monday,Fall,Clear,25,8,17
2011-07-18,2011,July,2,Monday,Fall,Clear,10,8,2
2011-07-18,2011,July,3,Monday,Fall,Clear,7,4,3
2011-07-18,2011,July,4,Monday,Fall,Clear,4,3,1
2011-07-18,2011,July,5,Monday,Fall,Clear,17,15,2
2011-07-18,2011,July,6,Monday,Fall,Clear,105,95,10
2011-07-18,2011,July,7,Monday,Fall,Clear,277,255,22
2011-07-18,2011,July,8,Monday,Fall,Clear,347,329,18
2011-07-18,2011,July,9,Monday,Fall,Clear,203,170,33
2011-07-18,2011,July,10,Monday,Fall,Clear,130,78,52
2011-07-18,2011,July,11,Monday,Fall,Clear,141,99,42
2011-07-18,2011,July,12,Monday,Fall,Clear,165,126,39
2011-07-18,2011,July,13,Monday,Fall,Clear,152,125,27
2011-07-18,2011,July,14,Monday,Fall,Clear,138,106,32
2011-07-18,2011,July,15,Monday,Fall,Clear,164,111,53
2011-07-18,2011,July,16,Monday,Fall,Clear,265,220,45
2011-07-18,2011,July,17,Monday,Fall,Clear,545,473,72
2011-07-18,2011,July,18,Monday,Fall,Clear,558,478,80
2011-07-18,2011,July,19,Monday,Fall,Clear,398,335,63
2011-07-18,2011,July,20,Monday,Fall,Clear,323,232,91
2011-07-18,2011,July,21,Monday,Fall,Clear,202,154,48
2011-07-18,2011,July,22,Monday,Fall,Clear,140,104,36
2011-07-18,2011,July,23,Monday,Fall,Clear,91,59,32
2011-07-19,2011,July,0,Tuesday,Fall,Clear,51,26,25
2011-07-19,2011,July,1,Tuesday,Fall,Cloudy,13,6,7
2011-07-19,2011,July,2,Tuesday,Fall,Clear,13,4,9
2011-07-19,2011,July,3,Tuesday,Fall,Clear,3,1,2
2011-07-19,2011,July,4,Tuesday,Fall,Clear,5,4,1
2011-07-19,2011,July,5,Tuesday,Fall,Cloudy,19,19,0
2011-07-19,2011,July,6,Tuesday,Fall,Cloudy,134,126,8
2011-07-19,2011,July,7,Tuesday,Fall,Cloudy,315,287,28
2011-07-19,2011,July,8,Tuesday,Fall,Cloudy,412,381,31
2011-07-19,2011,July,9,Tuesday,Fall,Cloudy,199,177,22
2011-07-19,2011,July,10,Tuesday,Fall,Cloudy,141,112,29
2011-07-19,2011,July,11,Tuesday,Fall,Clear,127,98,29
2011-07-19,2011,July,12,Tuesday,Fall,Clear,153,127,26
2011-07-19,2011,July,13,Tuesday,Fall,Clear,172,139,33
2011-07-19,2011,July,14,Tuesday,Fall,Clear,152,111,41
2011-07-19,2011,July,15,Tuesday,Fall,Clear,158,110,48
2011-07-19,2011,July,16,Tuesday,Fall,Clear,277,216,61
2011-07-19,2011,July,17,Tuesday,Fall,Clear,513,445,68
2011-07-19,2011,July,18,Tuesday,Fall,Clear,530,450,80
2011-07-19,2011,July,19,Tuesday,Fall,Clear,388,334,54
2011-07-19,2011,July,20,Tuesday,Fall,Clear,277,229,48
2011-07-19,2011,July,21,Tuesday,Fall,Clear,241,194,47
2011-07-19,2011,July,22,Tuesday,Fall,Clear,156,120,36
2011-07-19,2011,July,23,Tuesday,Fall,Light Snow/Rain,92,73,19
2011-07-20,2011,July,0,Wednesday,Fall,Clear,40,29,11
2011-07-20,2011,July,1,Wednesday,Fall,Clear,11,7,4
2011-07-20,2011,July,2,Wednesday,Fall,Clear,9,7,2
2011-07-20,2011,July,3,Wednesday,Fall,Clear,6,4,2
2011-07-20,2011,July,4,Wednesday,Fall,Clear,4,4,0
2011-07-20,2011,July,5,Wednesday,Fall,Clear,23,19,4
2011-07-20,2011,July,6,Wednesday,Fall,Cloudy,116,111,5
2011-07-20,2011,July,7,Wednesday,Fall,Cloudy,303,276,27
2011-07-20,2011,July,8,Wednesday,Fall,Clear,438,404,34
2011-07-20,2011,July,9,Wednesday,Fall,Clear,209,181,28
2011-07-20,2011,July,10,Wednesday,Fall,Clear,110,76,34
2011-07-20,2011,July,11,Wednesday,Fall,Clear,142,116,26
2011-07-20,2011,July,12,Wednesday,Fall,Clear,149,121,28
2011-07-20,2011,July,13,Wednesday,Fall,Clear,120,97,23
2011-07-20,2011,July,14,Wednesday,Fall,Clear,127,83,44
2011-07-20,2011,July,15,Wednesday,Fall,Clear,138,102,36
2011-07-20,2011,July,16,Wednesday,Fall,Clear,234,204,30
2011-07-20,2011,July,17,Wednesday,Fall,Clear,455,405,50
2011-07-20,2011,July,18,Wednesday,Fall,Clear,497,429,68
2011-07-20,2011,July,19,Wednesday,Fall,Clear,382,323,59
2011-07-20,2011,July,20,Wednesday,Fall,Clear,309,264,45
2011-07-20,2011,July,21,Wednesday,Fall,Clear,242,209,33
2011-07-20,2011,July,22,Wednesday,Fall,Clear,169,144,25
2011-07-20,2011,July,23,Wednesday,Fall,Clear,99,73,26
2011-07-21,2011,July,0,Thursday,Fall,Cloudy,42,29,13
2011-07-21,2011,July,1,Thursday,Fall,Cloudy,21,16,5
2011-07-21,2011,July,2,Thursday,Fall,Cloudy,6,4,2
2011-07-21,2011,July,3,Thursday,Fall,Cloudy,6,5,1
2011-07-21,2011,July,4,Thursday,Fall,Cloudy,4,4,0
2011-07-21,2011,July,5,Thursday,Fall,Cloudy,18,16,2
2011-07-21,2011,July,6,Thursday,Fall,Cloudy,117,111,6
2011-07-21,2011,July,7,Thursday,Fall,Cloudy,274,251,23
2011-07-21,2011,July,8,Thursday,Fall,Cloudy,381,358,23
2011-07-21,2011,July,9,Thursday,Fall,Cloudy,200,166,34
2011-07-21,2011,July,10,Thursday,Fall,Cloudy,78,47,31
2011-07-21,2011,July,11,Thursday,Fall,Cloudy,106,79,27
2011-07-21,2011,July,12,Thursday,Fall,Clear,135,106,29
2011-07-21,2011,July,13,Thursday,Fall,Clear,102,81,21
2011-07-21,2011,July,14,Thursday,Fall,Clear,147,97,50
2011-07-21,2011,July,15,Thursday,Fall,Clear,133,93,40
2011-07-21,2011,July,16,Thursday,Fall,Clear,210,167,43
2011-07-21,2011,July,17,Thursday,Fall,Clear,414,374,40
2011-07-21,2011,July,18,Thursday,Fall,Clear,382,343,39
2011-07-21,2011,July,19,Thursday,Fall,Clear,284,233,51
2011-07-21,2011,July,20,Thursday,Fall,Clear,237,199,38
2011-07-21,2011,July,21,Thursday,Fall,Clear,225,187,38
2011-07-21,2011,July,22,Thursday,Fall,Clear,149,113,36
2011-07-21,2011,July,23,Thursday,Fall,Clear,113,73,40
2011-07-22,2011,July,0,Friday,Fall,Clear,60,51,9
2011-07-22,2011,July,1,Friday,Fall,Clear,24,17,7
2011-07-22,2011,July,2,Friday,Fall,Clear,14,14,0
2011-07-22,2011,July,3,Friday,Fall,Clear,7,6,1
2011-07-22,2011,July,4,Friday,Fall,Clear,13,5,8
2011-07-22,2011,July,5,Friday,Fall,Clear,19,17,2
2011-07-22,2011,July,6,Friday,Fall,Clear,96,83,13
2011-07-22,2011,July,7,Friday,Fall,Cloudy,252,232,20
2011-07-22,2011,July,8,Friday,Fall,Cloudy,322,292,30
2011-07-22,2011,July,9,Friday,Fall,Clear,208,177,31
2011-07-22,2011,July,10,Friday,Fall,Clear,115,83,32
2011-07-22,2011,July,11,Friday,Fall,Clear,109,86,23
2011-07-22,2011,July,12,Friday,Fall,Clear,115,95,20
2011-07-22,2011,July,13,Friday,Fall,Clear,123,98,25
2011-07-22,2011,July,14,Friday,Fall,Clear,101,77,24
2011-07-22,2011,July,15,Friday,Fall,Clear,133,101,32
2011-07-22,2011,July,16,Friday,Fall,Light Snow/Rain,182,153,29
2011-07-22,2011,July,17,Friday,Fall,Clear,306,271,35
2011-07-22,2011,July,18,Friday,Fall,Clear,284,250,34
2011-07-22,2011,July,19,Friday,Fall,Cloudy,250,210,40
2011-07-22,2011,July,20,Friday,Fall,Clear,212,166,46
2011-07-22,2011,July,21,Friday,Fall,Clear,190,152,38
2011-07-22,2011,July,22,Friday,Fall,Cloudy,149,105,44
2011-07-22,2011,July,23,Friday,Fall,Clear,103,84,19
2011-07-23,2011,July,0,Saturday,Fall,Clear,101,85,16
2011-07-23,2011,July,1,Saturday,Fall,Clear,70,57,13
2011-07-23,2011,July,2,Saturday,Fall,Clear,61,48,13
2011-07-23,2011,July,3,Saturday,Fall,Clear,22,16,6
2011-07-23,2011,July,4,Saturday,Fall,Clear,9,4,5
2011-07-23,2011,July,5,Saturday,Fall,Clear,7,6,1
2011-07-23,2011,July,6,Saturday,Fall,Clear,25,19,6
2011-07-23,2011,July,7,Saturday,Fall,Clear,45,38,7
2011-07-23,2011,July,8,Saturday,Fall,Clear,109,85,24
2011-07-23,2011,July,9,Saturday,Fall,Clear,132,102,30
2011-07-23,2011,July,10,Saturday,Fall,Clear,198,137,61
2011-07-23,2011,July,11,Saturday,Fall,Clear,216,154,62
2011-07-23,2011,July,12,Saturday,Fall,Clear,235,164,71
2011-07-23,2011,July,13,Saturday,Fall,Clear,245,167,78
2011-07-23,2011,July,14,Saturday,Fall,Clear,236,152,84
2011-07-23,2011,July,15,Saturday,Fall,Clear,215,137,78
2011-07-23,2011,July,16,Saturday,Fall,Clear,221,151,70
2011-07-23,2011,July,17,Saturday,Fall,Clear,197,127,70
2011-07-23,2011,July,18,Saturday,Fall,Clear,196,134,62
2011-07-23,2011,July,19,Saturday,Fall,Cloudy,217,137,80
2011-07-23,2011,July,20,Saturday,Fall,Clear,145,98,47
2011-07-23,2011,July,21,Saturday,Fall,Clear,154,115,39
2011-07-23,2011,July,22,Saturday,Fall,Clear,125,88,37
2011-07-23,2011,July,23,Saturday,Fall,Clear,104,77,27
2011-07-24,2011,July,0,Sunday,Fall,Clear,119,77,42
2011-07-24,2011,July,1,Sunday,Fall,Clear,96,63,33
2011-07-24,2011,July,2,Sunday,Fall,Clear,60,48,12
2011-07-24,2011,July,3,Sunday,Fall,Clear,37,20,17
2011-07-24,2011,July,4,Sunday,Fall,Clear,6,5,1
2011-07-24,2011,July,5,Sunday,Fall,Clear,8,3,5
2011-07-24,2011,July,6,Sunday,Fall,Cloudy,22,13,9
2011-07-24,2011,July,7,Sunday,Fall,Clear,35,29,6
2011-07-24,2011,July,8,Sunday,Fall,Clear,104,82,22
2011-07-24,2011,July,9,Sunday,Fall,Clear,154,112,42
2011-07-24,2011,July,10,Sunday,Fall,Clear,226,165,61
2011-07-24,2011,July,11,Sunday,Fall,Clear,243,169,74
2011-07-24,2011,July,12,Sunday,Fall,Clear,246,161,85
2011-07-24,2011,July,13,Sunday,Fall,Clear,252,162,90
2011-07-24,2011,July,14,Sunday,Fall,Clear,283,204,79
2011-07-24,2011,July,15,Sunday,Fall,Clear,238,170,68
2011-07-24,2011,July,16,Sunday,Fall,Clear,249,187,62
2011-07-24,2011,July,17,Sunday,Fall,Clear,249,174,75
2011-07-24,2011,July,18,Sunday,Fall,Clear,243,176,67
2011-07-24,2011,July,19,Sunday,Fall,Clear,240,170,70
2011-07-24,2011,July,20,Sunday,Fall,Clear,195,143,52
2011-07-24,2011,July,21,Sunday,Fall,Clear,153,111,42
2011-07-24,2011,July,22,Sunday,Fall,Clear,98,75,23
2011-07-24,2011,July,23,Sunday,Fall,Cloudy,50,37,13
2011-07-25,2011,July,0,Monday,Fall,Cloudy,34,17,17
2011-07-25,2011,July,1,Monday,Fall,Cloudy,12,8,4
2011-07-25,2011,July,2,Monday,Fall,Cloudy,6,3,3
2011-07-25,2011,July,3,Monday,Fall,Clear,4,2,2
2011-07-25,2011,July,4,Monday,Fall,Clear,6,6,0
2011-07-25,2011,July,5,Monday,Fall,Clear,24,22,2
2011-07-25,2011,July,6,Monday,Fall,Cloudy,107,100,7
2011-07-25,2011,July,7,Monday,Fall,Cloudy,277,257,20
2011-07-25,2011,July,8,Monday,Fall,Cloudy,387,353,34
2011-07-25,2011,July,9,Monday,Fall,Clear,135,124,11
2011-07-25,2011,July,10,Monday,Fall,Clear,84,54,30
2011-07-25,2011,July,11,Monday,Fall,Cloudy,107,83,24
2011-07-25,2011,July,12,Monday,Fall,Cloudy,67,50,17
2011-07-25,2011,July,13,Monday,Fall,Cloudy,78,64,14
2011-07-25,2011,July,14,Monday,Fall,Cloudy,90,62,28
2011-07-25,2011,July,15,Monday,Fall,Clear,112,96,16
2011-07-25,2011,July,16,Monday,Fall,Clear,198,161,37
2011-07-25,2011,July,17,Monday,Fall,Clear,485,437,48
2011-07-25,2011,July,18,Monday,Fall,Clear,533,473,60
2011-07-25,2011,July,19,Monday,Fall,Clear,386,324,62
2011-07-25,2011,July,20,Monday,Fall,Clear,302,247,55
2011-07-25,2011,July,21,Monday,Fall,Clear,194,153,41
2011-07-25,2011,July,22,Monday,Fall,Clear,125,112,13
2011-07-25,2011,July,23,Monday,Fall,Clear,87,64,23
2011-07-26,2011,July,0,Tuesday,Fall,Clear,28,20,8
2011-07-26,2011,July,1,Tuesday,Fall,Clear,12,6,6
2011-07-26,2011,July,2,Tuesday,Fall,Clear,7,6,1
2011-07-26,2011,July,3,Tuesday,Fall,Clear,4,2,2
2011-07-26,2011,July,4,Tuesday,Fall,Clear,6,6,0
2011-07-26,2011,July,5,Tuesday,Fall,Clear,27,24,3
2011-07-26,2011,July,6,Tuesday,Fall,Clear,110,108,2
2011-07-26,2011,July,7,Tuesday,Fall,Clear,318,288,30
2011-07-26,2011,July,8,Tuesday,Fall,Clear,424,392,32
2011-07-26,2011,July,9,Tuesday,Fall,Clear,187,162,25
2011-07-26,2011,July,10,Tuesday,Fall,Clear,138,96,42
2011-07-26,2011,July,11,Tuesday,Fall,Clear,151,102,49
2011-07-26,2011,July,12,Tuesday,Fall,Clear,147,122,25
2011-07-26,2011,July,13,Tuesday,Fall,Clear,182,139,43
2011-07-26,2011,July,14,Tuesday,Fall,Clear,147,101,46
2011-07-26,2011,July,15,Tuesday,Fall,Clear,163,114,49
2011-07-26,2011,July,16,Tuesday,Fall,Clear,254,213,41
2011-07-26,2011,July,17,Tuesday,Fall,Clear,537,465,72
2011-07-26,2011,July,18,Tuesday,Fall,Clear,546,478,68
2011-07-26,2011,July,19,Tuesday,Fall,Clear,398,329,69
2011-07-26,2011,July,20,Tuesday,Fall,Clear,290,243,47
2011-07-26,2011,July,21,Tuesday,Fall,Clear,267,222,45
2011-07-26,2011,July,22,Tuesday,Fall,Clear,158,131,27
2011-07-26,2011,July,23,Tuesday,Fall,Clear,89,71,18
2011-07-27,2011,July,0,Wednesday,Fall,Cloudy,45,26,19
2011-07-27,2011,July,1,Wednesday,Fall,Clear,10,9,1
2011-07-27,2011,July,2,Wednesday,Fall,Clear,6,5,1
2011-07-27,2011,July,3,Wednesday,Fall,Clear,4,4,0
2011-07-27,2011,July,4,Wednesday,Fall,Clear,4,3,1
2011-07-27,2011,July,5,Wednesday,Fall,Clear,18,18,0
2011-07-27,2011,July,6,Wednesday,Fall,Clear,123,119,4
2011-07-27,2011,July,7,Wednesday,Fall,Clear,347,313,34
2011-07-27,2011,July,8,Wednesday,Fall,Clear,433,405,28
2011-07-27,2011,July,9,Wednesday,Fall,Clear,216,189,27
2011-07-27,2011,July,10,Wednesday,Fall,Clear,114,82,32
2011-07-27,2011,July,11,Wednesday,Fall,Clear,136,94,42
2011-07-27,2011,July,12,Wednesday,Fall,Clear,169,132,37
2011-07-27,2011,July,13,Wednesday,Fall,Clear,180,151,29
2011-07-27,2011,July,14,Wednesday,Fall,Clear,127,107,20
2011-07-27,2011,July,15,Wednesday,Fall,Clear,140,103,37
2011-07-27,2011,July,16,Wednesday,Fall,Clear,268,228,40
2011-07-27,2011,July,17,Wednesday,Fall,Clear,572,491,81
2011-07-27,2011,July,18,Wednesday,Fall,Clear,541,463,78
2011-07-27,2011,July,19,Wednesday,Fall,Clear,375,288,87
2011-07-27,2011,July,20,Wednesday,Fall,Clear,294,239,55
2011-07-27,2011,July,21,Wednesday,Fall,Clear,245,196,49
2011-07-27,2011,July,22,Wednesday,Fall,Clear,180,143,37
2011-07-27,2011,July,23,Wednesday,Fall,Clear,109,93,16
2011-07-28,2011,July,0,Thursday,Fall,Clear,45,31,14
2011-07-28,2011,July,1,Thursday,Fall,Clear,29,26,3
2011-07-28,2011,July,2,Thursday,Fall,Clear,7,5,2
2011-07-28,2011,July,3,Thursday,Fall,Clear,5,5,0
2011-07-28,2011,July,4,Thursday,Fall,Clear,6,6,0
2011-07-28,2011,July,5,Thursday,Fall,Clear,27,26,1
2011-07-28,2011,July,6,Thursday,Fall,Clear,116,110,6
2011-07-28,2011,July,7,Thursday,Fall,Clear,305,278,27
2011-07-28,2011,July,8,Thursday,Fall,Clear,456,409,47
2011-07-28,2011,July,9,Thursday,Fall,Clear,210,189,21
2011-07-28,2011,July,10,Thursday,Fall,Clear,116,86,30
2011-07-28,2011,July,11,Thursday,Fall,Clear,154,113,41
2011-07-28,2011,July,12,Thursday,Fall,Clear,186,151,35
2011-07-28,2011,July,13,Thursday,Fall,Clear,152,126,26
2011-07-28,2011,July,14,Thursday,Fall,Cloudy,138,111,27
2011-07-28,2011,July,15,Thursday,Fall,Clear,146,124,22
2011-07-28,2011,July,16,Thursday,Fall,Clear,256,214,42
2011-07-28,2011,July,17,Thursday,Fall,Clear,468,423,45
2011-07-28,2011,July,18,Thursday,Fall,Clear,483,428,55
2011-07-28,2011,July,19,Thursday,Fall,Clear,322,285,37
2011-07-28,2011,July,20,Thursday,Fall,Clear,270,229,41
2011-07-28,2011,July,21,Thursday,Fall,Clear,196,165,31
2011-07-28,2011,July,22,Thursday,Fall,Clear,174,149,25
2011-07-28,2011,July,23,Thursday,Fall,Clear,123,95,28
2011-07-29,2011,July,0,Friday,Fall,Clear,57,45,12
2011-07-29,2011,July,1,Friday,Fall,Clear,34,22,12
2011-07-29,2011,July,2,Friday,Fall,Clear,13,10,3
2011-07-29,2011,July,3,Friday,Fall,Clear,11,9,2
2011-07-29,2011,July,4,Friday,Fall,Clear,6,4,2
2011-07-29,2011,July,5,Friday,Fall,Clear,27,23,4
2011-07-29,2011,July,6,Friday,Fall,Cloudy,90,83,7
2011-07-29,2011,July,7,Friday,Fall,Cloudy,254,228,26
2011-07-29,2011,July,8,Friday,Fall,Cloudy,384,354,30
2011-07-29,2011,July,9,Friday,Fall,Clear,179,151,28
2011-07-29,2011,July,10,Friday,Fall,Clear,106,69,37
2011-07-29,2011,July,11,Friday,Fall,Clear,161,118,43
2011-07-29,2011,July,12,Friday,Fall,Clear,135,95,40
2011-07-29,2011,July,13,Friday,Fall,Clear,156,114,42
2011-07-29,2011,July,14,Friday,Fall,Clear,148,114,34
2011-07-29,2011,July,15,Friday,Fall,Clear,169,129,40
2011-07-29,2011,July,16,Friday,Fall,Clear,233,198,35
2011-07-29,2011,July,17,Friday,Fall,Clear,421,374,47
2011-07-29,2011,July,18,Friday,Fall,Clear,362,313,49
2011-07-29,2011,July,19,Friday,Fall,Clear,241,219,22
2011-07-29,2011,July,20,Friday,Fall,Clear,206,153,53
2011-07-29,2011,July,21,Friday,Fall,Clear,163,134,29
2011-07-29,2011,July,22,Friday,Fall,Clear,174,127,47
2011-07-29,2011,July,23,Friday,Fall,Clear,116,90,26
2011-07-30,2011,July,0,Saturday,Fall,Clear,133,73,60
2011-07-30,2011,July,1,Saturday,Fall,Clear,90,75,15
2011-07-30,2011,July,2,Saturday,Fall,Clear,42,31,11
2011-07-30,2011,July,3,Saturday,Fall,Clear,43,25,18
2011-07-30,2011,July,4,Saturday,Fall,Clear,10,6,4
2011-07-30,2011,July,5,Saturday,Fall,Clear,13,9,4
2011-07-30,2011,July,6,Saturday,Fall,Clear,24,18,6
2011-07-30,2011,July,7,Saturday,Fall,Clear,42,39,3
2011-07-30,2011,July,8,Saturday,Fall,Clear,114,87,27
2011-07-30,2011,July,9,Saturday,Fall,Clear,174,125,49
2011-07-30,2011,July,10,Saturday,Fall,Clear,261,182,79
2011-07-30,2011,July,11,Saturday,Fall,Clear,317,206,111
2011-07-30,2011,July,12,Saturday,Fall,Clear,341,230,111
2011-07-30,2011,July,13,Saturday,Fall,Clear,308,183,125
2011-07-30,2011,July,14,Saturday,Fall,Clear,305,193,112
2011-07-30,2011,July,15,Saturday,Fall,Clear,302,189,113
2011-07-30,2011,July,16,Saturday,Fall,Clear,302,176,126
2011-07-30,2011,July,17,Saturday,Fall,Clear,302,209,93
2011-07-30,2011,July,18,Saturday,Fall,Clear,299,207,92
2011-07-30,2011,July,19,Saturday,Fall,Clear,256,155,101
2011-07-30,2011,July,20,Saturday,Fall,Clear,206,132,74
2011-07-30,2011,July,21,Saturday,Fall,Clear,205,123,82
2011-07-30,2011,July,22,Saturday,Fall,Clear,209,129,80
2011-07-30,2011,July,23,Saturday,Fall,Clear,177,114,63
2011-07-31,2011,July,0,Sunday,Fall,Clear,113,80,33
2011-07-31,2011,July,1,Sunday,Fall,Clear,79,71,8
2011-07-31,2011,July,2,Sunday,Fall,Clear,67,48,19
2011-07-31,2011,July,3,Sunday,Fall,Clear,50,26,24
2011-07-31,2011,July,4,Sunday,Fall,Clear,13,7,6
2011-07-31,2011,July,5,Sunday,Fall,Clear,8,4,4
2011-07-31,2011,July,6,Sunday,Fall,Clear,13,8,5
2011-07-31,2011,July,7,Sunday,Fall,Clear,45,26,19
2011-07-31,2011,July,8,Sunday,Fall,Clear,142,88,54
2011-07-31,2011,July,9,Sunday,Fall,Clear,183,128,55
2011-07-31,2011,July,10,Sunday,Fall,Clear,254,163,91
2011-07-31,2011,July,11,Sunday,Fall,Clear,275,163,112
2011-07-31,2011,July,12,Sunday,Fall,Clear,338,192,146
2011-07-31,2011,July,13,Sunday,Fall,Clear,294,152,142
2011-07-31,2011,July,14,Sunday,Fall,Clear,326,196,130
2011-07-31,2011,July,15,Sunday,Fall,Clear,293,184,109
2011-07-31,2011,July,16,Sunday,Fall,Clear,306,208,98
2011-07-31,2011,July,17,Sunday,Fall,Clear,320,206,114
2011-07-31,2011,July,18,Sunday,Fall,Clear,304,213,91
2011-07-31,2011,July,19,Sunday,Fall,Clear,274,187,87
2011-07-31,2011,July,20,Sunday,Fall,Clear,275,205,70
2011-07-31,2011,July,21,Sunday,Fall,Clear,164,96,68
2011-07-31,2011,July,22,Sunday,Fall,Clear,96,71,25
2011-07-31,2011,July,23,Sunday,Fall,Clear,70,56,14
2011-08-01,2011,August,0,Monday,Fall,Clear,29,22,7
2011-08-01,2011,August,1,Monday,Fall,Clear,17,12,5
2011-08-01,2011,August,2,Monday,Fall,Clear,11,7,4
2011-08-01,2011,August,3,Monday,Fall,Clear,4,4,0
2011-08-01,2011,August,4,Monday,Fall,Clear,4,2,2
2011-08-01,2011,August,5,Monday,Fall,Clear,26,24,2
2011-08-01,2011,August,6,Monday,Fall,Clear,100,97,3
2011-08-01,2011,August,7,Monday,Fall,Clear,282,258,24
2011-08-01,2011,August,8,Monday,Fall,Clear,382,347,35
2011-08-01,2011,August,9,Monday,Fall,Clear,166,139,27
2011-08-01,2011,August,10,Monday,Fall,Clear,97,70,27
2011-08-01,2011,August,11,Monday,Fall,Clear,119,66,53
2011-08-01,2011,August,12,Monday,Fall,Clear,168,115,53
2011-08-01,2011,August,13,Monday,Fall,Clear,150,112,38
2011-08-01,2011,August,14,Monday,Fall,Clear,123,86,37
2011-08-01,2011,August,15,Monday,Fall,Clear,129,77,52
2011-08-01,2011,August,16,Monday,Fall,Clear,231,197,34
2011-08-01,2011,August,17,Monday,Fall,Clear,514,445,69
2011-08-01,2011,August,18,Monday,Fall,Clear,543,475,68
2011-08-01,2011,August,19,Monday,Fall,Clear,413,350,63
2011-08-01,2011,August,20,Monday,Fall,Clear,305,256,49
2011-08-01,2011,August,21,Monday,Fall,Clear,220,178,42
2011-08-01,2011,August,22,Monday,Fall,Clear,137,116,21
2011-08-01,2011,August,23,Monday,Fall,Clear,96,82,14
2011-08-02,2011,August,0,Tuesday,Fall,Clear,29,18,11
2011-08-02,2011,August,1,Tuesday,Fall,Clear,12,8,4
2011-08-02,2011,August,2,Tuesday,Fall,Clear,8,6,2
2011-08-02,2011,August,3,Tuesday,Fall,Clear,5,5,0
2011-08-02,2011,August,4,Tuesday,Fall,Clear,10,10,0
2011-08-02,2011,August,5,Tuesday,Fall,Clear,21,17,4
2011-08-02,2011,August,6,Tuesday,Fall,Clear,117,105,12
2011-08-02,2011,August,7,Tuesday,Fall,Clear,335,320,15
2011-08-02,2011,August,8,Tuesday,Fall,Clear,435,398,37
2011-08-02,2011,August,9,Tuesday,Fall,Clear,213,182,31
2011-08-02,2011,August,10,Tuesday,Fall,Clear,140,90,50
2011-08-02,2011,August,11,Tuesday,Fall,Clear,128,96,32
2011-08-02,2011,August,12,Tuesday,Fall,Clear,157,112,45
2011-08-02,2011,August,13,Tuesday,Fall,Clear,203,153,50
2011-08-02,2011,August,14,Tuesday,Fall,Clear,159,114,45
2011-08-02,2011,August,15,Tuesday,Fall,Clear,168,120,48
2011-08-02,2011,August,16,Tuesday,Fall,Clear,274,216,58
2011-08-02,2011,August,17,Tuesday,Fall,Cloudy,556,493,63
2011-08-02,2011,August,18,Tuesday,Fall,Cloudy,556,491,65
2011-08-02,2011,August,19,Tuesday,Fall,Cloudy,454,369,85
2011-08-02,2011,August,20,Tuesday,Fall,Cloudy,288,248,40
2011-08-02,2011,August,21,Tuesday,Fall,Clear,254,201,53
2011-08-02,2011,August,22,Tuesday,Fall,Cloudy,191,169,22
2011-08-02,2011,August,23,Tuesday,Fall,Cloudy,132,103,29
2011-08-03,2011,August,0,Wednesday,Fall,Cloudy,43,32,11
2011-08-03,2011,August,1,Wednesday,Fall,Cloudy,16,9,7
2011-08-03,2011,August,2,Wednesday,Fall,Cloudy,11,9,2
2011-08-03,2011,August,3,Wednesday,Fall,Cloudy,4,4,0
2011-08-03,2011,August,4,Wednesday,Fall,Cloudy,7,7,0
2011-08-03,2011,August,5,Wednesday,Fall,Cloudy,24,22,2
2011-08-03,2011,August,6,Wednesday,Fall,Light Snow/Rain,110,101,9
2011-08-03,2011,August,7,Wednesday,Fall,Cloudy,271,252,19
2011-08-03,2011,August,8,Wednesday,Fall,Cloudy,437,408,29
2011-08-03,2011,August,9,Wednesday,Fall,Cloudy,195,172,23
2011-08-03,2011,August,10,Wednesday,Fall,Light Snow/Rain,68,59,9
2011-08-03,2011,August,11,Wednesday,Fall,Cloudy,122,93,29
2011-08-03,2011,August,12,Wednesday,Fall,Light Snow/Rain,161,142,19
2011-08-03,2011,August,13,Wednesday,Fall,Cloudy,144,107,37
2011-08-03,2011,August,14,Wednesday,Fall,Cloudy,147,104,43
2011-08-03,2011,August,15,Wednesday,Fall,Cloudy,118,87,31
2011-08-03,2011,August,16,Wednesday,Fall,Light Snow/Rain,150,129,21
2011-08-03,2011,August,17,Wednesday,Fall,Cloudy,425,378,47
2011-08-03,2011,August,18,Wednesday,Fall,Light Snow/Rain,492,443,49
2011-08-03,2011,August,19,Wednesday,Fall,Light Snow/Rain,321,270,51
2011-08-03,2011,August,20,Wednesday,Fall,Light Snow/Rain,87,80,7
2011-08-03,2011,August,21,Wednesday,Fall,Cloudy,88,81,7
2011-08-03,2011,August,22,Wednesday,Fall,Light Snow/Rain,77,66,11
2011-08-03,2011,August,23,Wednesday,Fall,Cloudy,56,52,4
2011-08-04,2011,August,0,Thursday,Fall,Cloudy,17,15,2
2011-08-04,2011,August,1,Thursday,Fall,Cloudy,17,14,3
2011-08-04,2011,August,2,Thursday,Fall,Cloudy,7,5,2
2011-08-04,2011,August,3,Thursday,Fall,Light Snow/Rain,3,3,0
2011-08-04,2011,August,4,Thursday,Fall,Cloudy,7,7,0
2011-08-04,2011,August,5,Thursday,Fall,Cloudy,20,17,3
2011-08-04,2011,August,6,Thursday,Fall,Cloudy,97,90,7
2011-08-04,2011,August,7,Thursday,Fall,Cloudy,282,271,11
2011-08-04,2011,August,8,Thursday,Fall,Cloudy,398,369,29
2011-08-04,2011,August,9,Thursday,Fall,Clear,187,162,25
2011-08-04,2011,August,10,Thursday,Fall,Clear,113,89,24
2011-08-04,2011,August,11,Thursday,Fall,Cloudy,149,112,37
2011-08-04,2011,August,12,Thursday,Fall,Cloudy,205,152,53
2011-08-04,2011,August,13,Thursday,Fall,Clear,205,142,63
2011-08-04,2011,August,14,Thursday,Fall,Clear,167,114,53
2011-08-04,2011,August,15,Thursday,Fall,Clear,165,115,50
2011-08-04,2011,August,16,Thursday,Fall,Clear,290,220,70
2011-08-04,2011,August,17,Thursday,Fall,Clear,555,464,91
2011-08-04,2011,August,18,Thursday,Fall,Clear,523,435,88
2011-08-04,2011,August,19,Thursday,Fall,Clear,366,301,65
2011-08-04,2011,August,20,Thursday,Fall,Cloudy,286,245,41
2011-08-04,2011,August,21,Thursday,Fall,Cloudy,211,186,25
2011-08-04,2011,August,22,Thursday,Fall,Clear,174,141,33
2011-08-04,2011,August,23,Thursday,Fall,Clear,132,108,24
2011-08-05,2011,August,0,Friday,Fall,Clear,54,41,13
2011-08-05,2011,August,1,Friday,Fall,Clear,19,16,3
2011-08-05,2011,August,2,Friday,Fall,Clear,19,14,5
2011-08-05,2011,August,3,Friday,Fall,Clear,6,6,0
2011-08-05,2011,August,4,Friday,Fall,Clear,7,6,1
2011-08-05,2011,August,5,Friday,Fall,Clear,16,16,0
2011-08-05,2011,August,6,Friday,Fall,Clear,101,94,7
2011-08-05,2011,August,7,Friday,Fall,Clear,270,247,23
2011-08-05,2011,August,8,Friday,Fall,Clear,454,415,39
2011-08-05,2011,August,9,Friday,Fall,Clear,226,183,43
2011-08-05,2011,August,10,Friday,Fall,Clear,163,113,50
2011-08-05,2011,August,11,Friday,Fall,Cloudy,147,103,44
2011-08-05,2011,August,12,Friday,Fall,Clear,216,159,57
2011-08-05,2011,August,13,Friday,Fall,Clear,204,164,40
2011-08-05,2011,August,14,Friday,Fall,Cloudy,245,164,81
2011-08-05,2011,August,15,Friday,Fall,Clear,210,160,50
2011-08-05,2011,August,16,Friday,Fall,Clear,330,254,76
2011-08-05,2011,August,17,Friday,Fall,Clear,550,466,84
2011-08-05,2011,August,18,Friday,Fall,Clear,466,361,105
2011-08-05,2011,August,19,Friday,Fall,Clear,372,282,90
2011-08-05,2011,August,20,Friday,Fall,Clear,291,221,70
2011-08-05,2011,August,21,Friday,Fall,Clear,173,119,54
2011-08-05,2011,August,22,Friday,Fall,Clear,188,137,51
2011-08-05,2011,August,23,Friday,Fall,Clear,139,102,37
2011-08-06,2011,August,0,Saturday,Fall,Clear,133,104,29
2011-08-06,2011,August,1,Saturday,Fall,Clear,67,50,17
2011-08-06,2011,August,2,Saturday,Fall,Clear,53,39,14
2011-08-06,2011,August,3,Saturday,Fall,Cloudy,42,28,14
2011-08-06,2011,August,4,Saturday,Fall,Cloudy,10,5,5
2011-08-06,2011,August,5,Saturday,Fall,Clear,6,4,2
2011-08-06,2011,August,6,Saturday,Fall,Clear,27,22,5
2011-08-06,2011,August,7,Saturday,Fall,Clear,63,49,14
2011-08-06,2011,August,8,Saturday,Fall,Clear,121,94,27
2011-08-06,2011,August,9,Saturday,Fall,Clear,215,155,60
2011-08-06,2011,August,10,Saturday,Fall,Cloudy,290,199,91
2011-08-06,2011,August,11,Saturday,Fall,Clear,349,211,138
2011-08-06,2011,August,12,Saturday,Fall,Clear,382,252,130
2011-08-06,2011,August,13,Saturday,Fall,Cloudy,441,265,176
2011-08-06,2011,August,14,Saturday,Fall,Clear,380,204,176
2011-08-06,2011,August,15,Saturday,Fall,Cloudy,362,232,130
2011-08-06,2011,August,16,Saturday,Fall,Light Snow/Rain,343,188,155
2011-08-06,2011,August,17,Saturday,Fall,Light Snow/Rain,149,88,61
2011-08-06,2011,August,18,Saturday,Fall,Cloudy,211,130,81
2011-08-06,2011,August,19,Saturday,Fall,Light Snow/Rain,171,114,57
2011-08-06,2011,August,20,Saturday,Fall,Light Snow/Rain,137,79,58
2011-08-06,2011,August,21,Saturday,Fall,Cloudy,114,86,28
2011-08-06,2011,August,22,Saturday,Fall,Cloudy,120,96,24
2011-08-06,2011,August,23,Saturday,Fall,Light Snow/Rain,108,79,29
2011-08-07,2011,August,0,Sunday,Fall,Cloudy,80,66,14
2011-08-07,2011,August,1,Sunday,Fall,Cloudy,73,63,10
2011-08-07,2011,August,2,Sunday,Fall,Cloudy,66,48,18
2011-08-07,2011,August,3,Sunday,Fall,Cloudy,32,23,9
2011-08-07,2011,August,4,Sunday,Fall,Clear,6,5,1
2011-08-07,2011,August,5,Sunday,Fall,Clear,5,4,1
2011-08-07,2011,August,6,Sunday,Fall,Clear,13,10,3
2011-08-07,2011,August,7,Sunday,Fall,Clear,39,28,11
2011-08-07,2011,August,8,Sunday,Fall,Clear,89,66,23
2011-08-07,2011,August,9,Sunday,Fall,Clear,184,102,82
2011-08-07,2011,August,10,Sunday,Fall,Clear,266,178,88
2011-08-07,2011,August,11,Sunday,Fall,Clear,269,156,113
2011-08-07,2011,August,12,Sunday,Fall,Clear,370,209,161
2011-08-07,2011,August,13,Sunday,Fall,Clear,324,206,118
2011-08-07,2011,August,14,Sunday,Fall,Clear,322,192,130
2011-08-07,2011,August,15,Sunday,Fall,Light Snow/Rain,326,208,118
2011-08-07,2011,August,16,Sunday,Fall,Light Snow/Rain,193,119,74
2011-08-07,2011,August,17,Sunday,Fall,Light Snow/Rain,194,131,63
2011-08-07,2011,August,18,Sunday,Fall,Clear,229,155,74
2011-08-07,2011,August,19,Sunday,Fall,Clear,228,160,68
2011-08-07,2011,August,20,Sunday,Fall,Clear,183,133,50
2011-08-07,2011,August,21,Sunday,Fall,Clear,136,100,36
2011-08-07,2011,August,22,Sunday,Fall,Clear,103,82,21
2011-08-07,2011,August,23,Sunday,Fall,Clear,55,43,12
2011-08-08,2011,August,0,Monday,Fall,Clear,30,17,13
2011-08-08,2011,August,1,Monday,Fall,Clear,12,8,4
2011-08-08,2011,August,2,Monday,Fall,Clear,7,3,4
2011-08-08,2011,August,3,Monday,Fall,Clear,1,0,1
2011-08-08,2011,August,4,Monday,Fall,Clear,10,8,2
2011-08-08,2011,August,5,Monday,Fall,Clear,15,14,1
2011-08-08,2011,August,6,Monday,Fall,Clear,95,87,8
2011-08-08,2011,August,7,Monday,Fall,Clear,267,249,18
2011-08-08,2011,August,8,Monday,Fall,Clear,349,320,29
2011-08-08,2011,August,9,Monday,Fall,Clear,183,146,37
2011-08-08,2011,August,10,Monday,Fall,Clear,124,62,62
2011-08-08,2011,August,11,Monday,Fall,Clear,179,89,90
2011-08-08,2011,August,12,Monday,Fall,Clear,182,134,48
2011-08-08,2011,August,13,Monday,Fall,Clear,151,108,43
2011-08-08,2011,August,14,Monday,Fall,Clear,150,109,41
2011-08-08,2011,August,15,Monday,Fall,Clear,126,86,40
2011-08-08,2011,August,16,Monday,Fall,Clear,282,218,64
2011-08-08,2011,August,17,Monday,Fall,Clear,527,460,67
2011-08-08,2011,August,18,Monday,Fall,Clear,529,465,64
2011-08-08,2011,August,19,Monday,Fall,Clear,416,352,64
2011-08-08,2011,August,20,Monday,Fall,Clear,286,215,71
2011-08-08,2011,August,21,Monday,Fall,Clear,186,156,30
2011-08-08,2011,August,22,Monday,Fall,Clear,147,121,26
2011-08-08,2011,August,23,Monday,Fall,Clear,72,53,19
2011-08-09,2011,August,0,Tuesday,Fall,Clear,35,25,10
2011-08-09,2011,August,1,Tuesday,Fall,Clear,14,9,5
2011-08-09,2011,August,2,Tuesday,Fall,Clear,12,3,9
2011-08-09,2011,August,3,Tuesday,Fall,Clear,3,3,0
2011-08-09,2011,August,4,Tuesday,Fall,Clear,7,6,1
2011-08-09,2011,August,5,Tuesday,Fall,Clear,30,25,5
2011-08-09,2011,August,6,Tuesday,Fall,Clear,101,95,6
2011-08-09,2011,August,7,Tuesday,Fall,Clear,343,313,30
2011-08-09,2011,August,8,Tuesday,Fall,Clear,392,352,40
2011-08-09,2011,August,9,Tuesday,Fall,Cloudy,175,141,34
2011-08-09,2011,August,10,Tuesday,Fall,Cloudy,144,89,55
2011-08-09,2011,August,11,Tuesday,Fall,Clear,149,88,61
2011-08-09,2011,August,12,Tuesday,Fall,Clear,185,125,60
2011-08-09,2011,August,13,Tuesday,Fall,Clear,175,127,48
2011-08-09,2011,August,14,Tuesday,Fall,Clear,148,95,53
2011-08-09,2011,August,15,Tuesday,Fall,Clear,164,106,58
2011-08-09,2011,August,16,Tuesday,Fall,Clear,285,228,57
2011-08-09,2011,August,17,Tuesday,Fall,Clear,532,453,79
2011-08-09,2011,August,18,Tuesday,Fall,Clear,585,488,97
2011-08-09,2011,August,19,Tuesday,Fall,Clear,371,302,69
2011-08-09,2011,August,20,Tuesday,Fall,Clear,292,258,34
2011-08-09,2011,August,21,Tuesday,Fall,Clear,230,184,46
2011-08-09,2011,August,22,Tuesday,Fall,Clear,155,127,28
2011-08-09,2011,August,23,Tuesday,Fall,Clear,75,53,22
2011-08-10,2011,August,0,Wednesday,Fall,Clear,37,18,19
2011-08-10,2011,August,1,Wednesday,Fall,Clear,17,10,7
2011-08-10,2011,August,2,Wednesday,Fall,Clear,11,10,1
2011-08-10,2011,August,3,Wednesday,Fall,Clear,4,3,1
2011-08-10,2011,August,4,Wednesday,Fall,Clear,5,4,1
2011-08-10,2011,August,5,Wednesday,Fall,Clear,32,30,2
2011-08-10,2011,August,6,Wednesday,Fall,Clear,119,110,9
2011-08-10,2011,August,7,Wednesday,Fall,Clear,305,289,16
2011-08-10,2011,August,8,Wednesday,Fall,Clear,399,361,38
2011-08-10,2011,August,9,Wednesday,Fall,Clear,180,148,32
2011-08-10,2011,August,10,Wednesday,Fall,Clear,113,72,41
2011-08-10,2011,August,11,Wednesday,Fall,Clear,149,95,54
2011-08-10,2011,August,12,Wednesday,Fall,Clear,240,166,74
2011-08-10,2011,August,13,Wednesday,Fall,Clear,191,150,41
2011-08-10,2011,August,14,Wednesday,Fall,Clear,178,116,62
2011-08-10,2011,August,15,Wednesday,Fall,Clear,194,141,53
2011-08-10,2011,August,16,Wednesday,Fall,Clear,282,206,76
2011-08-10,2011,August,17,Wednesday,Fall,Clear,584,513,71
2011-08-10,2011,August,18,Wednesday,Fall,Clear,559,489,70
2011-08-10,2011,August,19,Wednesday,Fall,Clear,413,334,79
2011-08-10,2011,August,20,Wednesday,Fall,Clear,312,253,59
2011-08-10,2011,August,21,Wednesday,Fall,Clear,209,162,47
2011-08-10,2011,August,22,Wednesday,Fall,Clear,139,122,17
2011-08-10,2011,August,23,Wednesday,Fall,Clear,108,94,14
2011-08-11,2011,August,0,Thursday,Fall,Clear,46,40,6
2011-08-11,2011,August,1,Thursday,Fall,Clear,26,17,9
2011-08-11,2011,August,2,Thursday,Fall,Clear,11,8,3
2011-08-11,2011,August,3,Thursday,Fall,Clear,9,7,2
2011-08-11,2011,August,4,Thursday,Fall,Clear,5,4,1
2011-08-11,2011,August,5,Thursday,Fall,Clear,25,23,2
2011-08-11,2011,August,6,Thursday,Fall,Clear,106,101,5
2011-08-11,2011,August,7,Thursday,Fall,Clear,307,292,15
2011-08-11,2011,August,8,Thursday,Fall,Clear,390,361,29
2011-08-11,2011,August,9,Thursday,Fall,Clear,197,166,31
2011-08-11,2011,August,10,Thursday,Fall,Clear,132,96,36
2011-08-11,2011,August,11,Thursday,Fall,Clear,187,128,59
2011-08-11,2011,August,12,Thursday,Fall,Clear,214,164,50
2011-08-11,2011,August,13,Thursday,Fall,Clear,217,166,51
2011-08-11,2011,August,14,Thursday,Fall,Clear,142,103,39
2011-08-11,2011,August,15,Thursday,Fall,Clear,178,126,52
2011-08-11,2011,August,16,Thursday,Fall,Clear,298,241,57
2011-08-11,2011,August,17,Thursday,Fall,Clear,582,486,96
2011-08-11,2011,August,18,Thursday,Fall,Clear,571,497,74
2011-08-11,2011,August,19,Thursday,Fall,Clear,371,323,48
2011-08-11,2011,August,20,Thursday,Fall,Clear,288,232,56
2011-08-11,2011,August,21,Thursday,Fall,Clear,206,171,35
2011-08-11,2011,August,22,Thursday,Fall,Clear,157,123,34
2011-08-11,2011,August,23,Thursday,Fall,Clear,127,105,22
2011-08-12,2011,August,0,Friday,Fall,Clear,65,53,12
2011-08-12,2011,August,1,Friday,Fall,Clear,23,19,4
2011-08-12,2011,August,2,Friday,Fall,Clear,15,15,0
2011-08-12,2011,August,3,Friday,Fall,Clear,9,9,0
2011-08-12,2011,August,4,Friday,Fall,Clear,5,5,0
2011-08-12,2011,August,5,Friday,Fall,Clear,26,24,2
2011-08-12,2011,August,6,Friday,Fall,Clear,76,73,3
2011-08-12,2011,August,7,Friday,Fall,Clear,264,247,17
2011-08-12,2011,August,8,Friday,Fall,Clear,426,397,29
2011-08-12,2011,August,9,Friday,Fall,Clear,205,178,27
2011-08-12,2011,August,10,Friday,Fall,Clear,130,86,44
2011-08-12,2011,August,11,Friday,Fall,Clear,156,108,48
2011-08-12,2011,August,12,Friday,Fall,Clear,222,167,55
2011-08-12,2011,August,13,Friday,Fall,Clear,253,179,74
2011-08-12,2011,August,14,Friday,Fall,Clear,186,135,51
2011-08-12,2011,August,15,Friday,Fall,Clear,249,190,59
2011-08-12,2011,August,16,Friday,Fall,Clear,334,266,68
2011-08-12,2011,August,17,Friday,Fall,Clear,516,423,93
2011-08-12,2011,August,18,Friday,Fall,Clear,465,376,89
2011-08-12,2011,August,19,Friday,Fall,Clear,385,284,101
2011-08-12,2011,August,20,Friday,Fall,Clear,287,210,77
2011-08-12,2011,August,21,Friday,Fall,Clear,226,153,73
2011-08-12,2011,August,22,Friday,Fall,Clear,231,157,74
2011-08-12,2011,August,23,Friday,Fall,Clear,151,100,51
2011-08-13,2011,August,0,Saturday,Fall,Clear,84,69,15
2011-08-13,2011,August,1,Saturday,Fall,Cloudy,77,64,13
2011-08-13,2011,August,2,Saturday,Fall,Clear,74,58,16
2011-08-13,2011,August,3,Saturday,Fall,Clear,27,18,9
2011-08-13,2011,August,4,Saturday,Fall,Cloudy,10,5,5
2011-08-13,2011,August,5,Saturday,Fall,Clear,18,15,3
2011-08-13,2011,August,6,Saturday,Fall,Clear,22,19,3
2011-08-13,2011,August,7,Saturday,Fall,Cloudy,44,34,10
2011-08-13,2011,August,8,Saturday,Fall,Cloudy,118,90,28
2011-08-13,2011,August,9,Saturday,Fall,Cloudy,208,138,70
2011-08-13,2011,August,10,Saturday,Fall,Cloudy,260,163,97
2011-08-13,2011,August,11,Saturday,Fall,Cloudy,314,192,122
2011-08-13,2011,August,12,Saturday,Fall,Cloudy,421,246,175
2011-08-13,2011,August,13,Saturday,Fall,Cloudy,153,92,61
2011-08-13,2011,August,14,Saturday,Fall,Clear,259,146,113
2011-08-13,2011,August,15,Saturday,Fall,Light Snow/Rain,358,208,150
2011-08-13,2011,August,16,Saturday,Fall,Cloudy,281,133,148
2011-08-13,2011,August,17,Saturday,Fall,Cloudy,269,172,97
2011-08-13,2011,August,18,Saturday,Fall,Clear,292,169,123
2011-08-13,2011,August,19,Saturday,Fall,Cloudy,237,170,67
2011-08-13,2011,August,20,Saturday,Fall,Cloudy,183,105,78
2011-08-13,2011,August,21,Saturday,Fall,Cloudy,167,127,40
2011-08-13,2011,August,22,Saturday,Fall,Cloudy,154,118,36
2011-08-13,2011,August,23,Saturday,Fall,Cloudy,120,95,25
2011-08-14,2011,August,0,Sunday,Fall,Light Snow/Rain,90,71,19
2011-08-14,2011,August,1,Sunday,Fall,Light Snow/Rain,73,57,16
2011-08-14,2011,August,2,Sunday,Fall,Light Snow/Rain,62,49,13
2011-08-14,2011,August,3,Sunday,Fall,Cloudy,27,22,5
2011-08-14,2011,August,4,Sunday,Fall,Light Snow/Rain,3,2,1
2011-08-14,2011,August,5,Sunday,Fall,Cloudy,10,9,1
2011-08-14,2011,August,6,Sunday,Fall,Cloudy,6,4,2
2011-08-14,2011,August,7,Sunday,Fall,Cloudy,24,20,4
2011-08-14,2011,August,8,Sunday,Fall,Cloudy,41,21,20
2011-08-14,2011,August,9,Sunday,Fall,Light Snow/Rain,103,76,27
2011-08-14,2011,August,10,Sunday,Fall,Clear,183,116,67
2011-08-14,2011,August,11,Sunday,Fall,Clear,198,117,81
2011-08-14,2011,August,12,Sunday,Fall,Cloudy,281,183,98
2011-08-14,2011,August,13,Sunday,Fall,Clear,377,233,144
2011-08-14,2011,August,14,Sunday,Fall,Clear,370,244,126
2011-08-14,2011,August,15,Sunday,Fall,Clear,331,203,128
2011-08-14,2011,August,16,Sunday,Fall,Clear,292,176,116
2011-08-14,2011,August,17,Sunday,Fall,Clear,329,196,133
2011-08-14,2011,August,18,Sunday,Fall,Clear,347,222,125
2011-08-14,2011,August,19,Sunday,Fall,Clear,259,184,75
2011-08-14,2011,August,20,Sunday,Fall,Clear,193,126,67
2011-08-14,2011,August,21,Sunday,Fall,Light Snow/Rain,155,104,51
2011-08-14,2011,August,22,Sunday,Fall,Light Snow/Rain,39,25,14
2011-08-14,2011,August,23,Sunday,Fall,Light Snow/Rain,27,22,5
2011-08-15,2011,August,0,Monday,Fall,Light Snow/Rain,25,18,7
2011-08-15,2011,August,1,Monday,Fall,Cloudy,10,9,1
2011-08-15,2011,August,2,Monday,Fall,Cloudy,3,3,0
2011-08-15,2011,August,3,Monday,Fall,Clear,7,6,1
2011-08-15,2011,August,4,Monday,Fall,Clear,5,4,1
2011-08-15,2011,August,5,Monday,Fall,Cloudy,17,14,3
2011-08-15,2011,August,6,Monday,Fall,Clear,90,87,3
2011-08-15,2011,August,7,Monday,Fall,Clear,258,248,10
2011-08-15,2011,August,8,Monday,Fall,Clear,355,326,29
2011-08-15,2011,August,9,Monday,Fall,Clear,222,170,52
2011-08-15,2011,August,10,Monday,Fall,Clear,141,87,54
2011-08-15,2011,August,11,Monday,Fall,Cloudy,153,112,41
2011-08-15,2011,August,12,Monday,Fall,Clear,178,116,62
2011-08-15,2011,August,13,Monday,Fall,Clear,193,140,53
2011-08-15,2011,August,14,Monday,Fall,Clear,151,95,56
2011-08-15,2011,August,15,Monday,Fall,Light Snow/Rain,182,133,49
2011-08-15,2011,August,16,Monday,Fall,Clear,283,225,58
2011-08-15,2011,August,17,Monday,Fall,Clear,530,471,59
2011-08-15,2011,August,18,Monday,Fall,Clear,483,413,70
2011-08-15,2011,August,19,Monday,Fall,Clear,397,343,54
2011-08-15,2011,August,20,Monday,Fall,Clear,285,240,45
2011-08-15,2011,August,21,Monday,Fall,Clear,184,150,34
2011-08-15,2011,August,22,Monday,Fall,Clear,98,76,22
2011-08-15,2011,August,23,Monday,Fall,Clear,88,77,11
2011-08-16,2011,August,0,Tuesday,Fall,Clear,31,23,8
2011-08-16,2011,August,1,Tuesday,Fall,Clear,16,12,4
2011-08-16,2011,August,2,Tuesday,Fall,Clear,4,3,1
2011-08-16,2011,August,3,Tuesday,Fall,Clear,6,5,1
2011-08-16,2011,August,4,Tuesday,Fall,Clear,5,5,0
2011-08-16,2011,August,5,Tuesday,Fall,Clear,30,29,1
2011-08-16,2011,August,6,Tuesday,Fall,Clear,119,115,4
2011-08-16,2011,August,7,Tuesday,Fall,Clear,346,328,18
2011-08-16,2011,August,8,Tuesday,Fall,Clear,441,417,24
2011-08-16,2011,August,9,Tuesday,Fall,Clear,198,171,27
2011-08-16,2011,August,10,Tuesday,Fall,Clear,111,83,28
2011-08-16,2011,August,11,Tuesday,Fall,Clear,150,110,40
2011-08-16,2011,August,12,Tuesday,Fall,Clear,162,120,42
2011-08-16,2011,August,13,Tuesday,Fall,Clear,192,147,45
2011-08-16,2011,August,14,Tuesday,Fall,Clear,182,117,65
2011-08-16,2011,August,15,Tuesday,Fall,Clear,159,123,36
2011-08-16,2011,August,16,Tuesday,Fall,Clear,303,248,55
2011-08-16,2011,August,17,Tuesday,Fall,Clear,600,525,75
2011-08-16,2011,August,18,Tuesday,Fall,Clear,570,516,54
2011-08-16,2011,August,19,Tuesday,Fall,Clear,376,320,56
2011-08-16,2011,August,20,Tuesday,Fall,Clear,280,232,48
2011-08-16,2011,August,21,Tuesday,Fall,Clear,215,177,38
2011-08-16,2011,August,22,Tuesday,Fall,Clear,152,121,31
2011-08-16,2011,August,23,Tuesday,Fall,Clear,77,57,20
2011-08-17,2011,August,0,Wednesday,Fall,Clear,24,16,8
2011-08-17,2011,August,1,Wednesday,Fall,Clear,14,12,2
2011-08-17,2011,August,2,Wednesday,Fall,Clear,6,6,0
2011-08-17,2011,August,3,Wednesday,Fall,Clear,5,4,1
2011-08-17,2011,August,4,Wednesday,Fall,Clear,5,5,0
2011-08-17,2011,August,5,Wednesday,Fall,Clear,28,28,0
2011-08-17,2011,August,6,Wednesday,Fall,Clear,105,101,4
2011-08-17,2011,August,7,Wednesday,Fall,Clear,308,296,12
2011-08-17,2011,August,8,Wednesday,Fall,Clear,487,452,35
2011-08-17,2011,August,9,Wednesday,Fall,Clear,209,178,31
2011-08-17,2011,August,10,Wednesday,Fall,Clear,118,91,27
2011-08-17,2011,August,11,Wednesday,Fall,Clear,128,108,20
2011-08-17,2011,August,12,Wednesday,Fall,Clear,189,163,26
2011-08-17,2011,August,13,Wednesday,Fall,Clear,176,138,38
2011-08-17,2011,August,14,Wednesday,Fall,Clear,192,138,54
2011-08-17,2011,August,15,Wednesday,Fall,Clear,159,117,42
2011-08-17,2011,August,16,Wednesday,Fall,Clear,300,238,62
2011-08-17,2011,August,17,Wednesday,Fall,Clear,552,506,46
2011-08-17,2011,August,18,Wednesday,Fall,Clear,556,470,86
2011-08-17,2011,August,19,Wednesday,Fall,Clear,347,297,50
2011-08-17,2011,August,20,Wednesday,Fall,Clear,280,243,37
2011-08-17,2011,August,21,Wednesday,Fall,Clear,230,192,38
2011-08-17,2011,August,22,Wednesday,Fall,Clear,171,142,29
2011-08-17,2011,August,23,Wednesday,Fall,Clear,105,85,20
2011-08-18,2011,August,0,Thursday,Fall,Clear,56,38,18
2011-08-18,2011,August,1,Thursday,Fall,Cloudy,24,11,13
2011-08-18,2011,August,2,Thursday,Fall,Clear,6,4,2
2011-08-18,2011,August,3,Thursday,Fall,Clear,6,6,0
2011-08-18,2011,August,4,Thursday,Fall,Clear,9,9,0
2011-08-18,2011,August,5,Thursday,Fall,Clear,27,27,0
2011-08-18,2011,August,6,Thursday,Fall,Cloudy,103,97,6
2011-08-18,2011,August,7,Thursday,Fall,Clear,308,289,19
2011-08-18,2011,August,8,Thursday,Fall,Clear,420,393,27
2011-08-18,2011,August,9,Thursday,Fall,Clear,228,186,42
2011-08-18,2011,August,10,Thursday,Fall,Clear,129,92,37
2011-08-18,2011,August,11,Thursday,Fall,Clear,141,97,44
2011-08-18,2011,August,12,Thursday,Fall,Clear,173,139,34
2011-08-18,2011,August,13,Thursday,Fall,Clear,187,154,33
2011-08-18,2011,August,14,Thursday,Fall,Clear,182,115,67
2011-08-18,2011,August,15,Thursday,Fall,Clear,174,118,56
2011-08-18,2011,August,16,Thursday,Fall,Clear,245,196,49
2011-08-18,2011,August,17,Thursday,Fall,Light Snow/Rain,409,365,44
2011-08-18,2011,August,18,Thursday,Fall,Light Snow/Rain,274,226,48
2011-08-18,2011,August,19,Thursday,Fall,Clear,141,115,26
2011-08-18,2011,August,20,Thursday,Fall,Clear,165,141,24
2011-08-18,2011,August,21,Thursday,Fall,Cloudy,149,137,12
2011-08-18,2011,August,22,Thursday,Fall,Cloudy,135,117,18
2011-08-18,2011,August,23,Thursday,Fall,Cloudy,114,94,20
2011-08-19,2011,August,0,Friday,Fall,Light Snow/Rain,62,53,9
2011-08-19,2011,August,1,Friday,Fall,Light Snow/Rain,20,19,1
2011-08-19,2011,August,2,Friday,Fall,Light Snow/Rain,8,8,0
2011-08-19,2011,August,3,Friday,Fall,Clear,3,1,2
2011-08-19,2011,August,4,Friday,Fall,Clear,8,7,1
2011-08-19,2011,August,5,Friday,Fall,Clear,17,16,1
2011-08-19,2011,August,6,Friday,Fall,Clear,93,91,2
2011-08-19,2011,August,7,Friday,Fall,Cloudy,263,251,12
2011-08-19,2011,August,8,Friday,Fall,Cloudy,398,368,30
2011-08-19,2011,August,9,Friday,Fall,Clear,218,187,31
2011-08-19,2011,August,10,Friday,Fall,Clear,165,108,57
2011-08-19,2011,August,11,Friday,Fall,Cloudy,165,120,45
2011-08-19,2011,August,12,Friday,Fall,Cloudy,222,168,54
2011-08-19,2011,August,13,Friday,Fall,Cloudy,232,169,63
2011-08-19,2011,August,14,Friday,Fall,Clear,220,142,78
2011-08-19,2011,August,15,Friday,Fall,Clear,222,156,66
2011-08-19,2011,August,16,Friday,Fall,Clear,327,261,66
2011-08-19,2011,August,17,Friday,Fall,Clear,527,442,85
2011-08-19,2011,August,18,Friday,Fall,Clear,425,337,88
2011-08-19,2011,August,19,Friday,Fall,Light Snow/Rain,165,132,33
2011-08-19,2011,August,20,Friday,Fall,Light Snow/Rain,58,46,12
2011-08-19,2011,August,21,Friday,Fall,Clear,107,89,18
2011-08-19,2011,August,22,Friday,Fall,Clear,122,97,25
2011-08-19,2011,August,23,Friday,Fall,Cloudy,106,88,18
2011-08-20,2011,August,0,Saturday,Fall,Clear,128,107,21
2011-08-20,2011,August,1,Saturday,Fall,Clear,47,35,12
2011-08-20,2011,August,2,Saturday,Fall,Clear,69,59,10
2011-08-20,2011,August,3,Saturday,Fall,Clear,51,42,9
2011-08-20,2011,August,4,Saturday,Fall,Cloudy,7,6,1
2011-08-20,2011,August,5,Saturday,Fall,Clear,8,8,0
2011-08-20,2011,August,6,Saturday,Fall,Cloudy,24,18,6
2011-08-20,2011,August,7,Saturday,Fall,Clear,44,36,8
2011-08-20,2011,August,8,Saturday,Fall,Clear,133,106,27
2011-08-20,2011,August,9,Saturday,Fall,Clear,190,139,51
2011-08-20,2011,August,10,Saturday,Fall,Clear,306,192,114
2011-08-20,2011,August,11,Saturday,Fall,Clear,338,223,115
2011-08-20,2011,August,12,Saturday,Fall,Clear,409,253,156
2011-08-20,2011,August,13,Saturday,Fall,Clear,378,220,158
2011-08-20,2011,August,14,Saturday,Fall,Clear,375,228,147
2011-08-20,2011,August,15,Saturday,Fall,Clear,390,215,175
2011-08-20,2011,August,16,Saturday,Fall,Clear,373,222,151
2011-08-20,2011,August,17,Saturday,Fall,Clear,383,203,180
2011-08-20,2011,August,18,Saturday,Fall,Clear,394,225,169
2011-08-20,2011,August,19,Saturday,Fall,Clear,291,182,109
2011-08-20,2011,August,20,Saturday,Fall,Clear,248,170,78
2011-08-20,2011,August,21,Saturday,Fall,Clear,225,144,81
2011-08-20,2011,August,22,Saturday,Fall,Cloudy,223,146,77
2011-08-20,2011,August,23,Saturday,Fall,Clear,157,98,59
2011-08-21,2011,August,0,Sunday,Fall,Clear,74,68,6
2011-08-21,2011,August,1,Sunday,Fall,Clear,86,69,17
2011-08-21,2011,August,2,Sunday,Fall,Clear,64,51,13
2011-08-21,2011,August,3,Sunday,Fall,Clear,51,26,25
2011-08-21,2011,August,4,Sunday,Fall,Clear,6,5,1
2011-08-21,2011,August,5,Sunday,Fall,Clear,8,8,0
2011-08-21,2011,August,6,Sunday,Fall,Clear,14,10,4
2011-08-21,2011,August,7,Sunday,Fall,Clear,31,19,12
2011-08-21,2011,August,8,Sunday,Fall,Clear,92,62,30
2011-08-21,2011,August,9,Sunday,Fall,Clear,231,151,80
2011-08-21,2011,August,10,Sunday,Fall,Clear,274,177,97
2011-08-21,2011,August,11,Sunday,Fall,Clear,313,181,132
2011-08-21,2011,August,12,Sunday,Fall,Clear,374,239,135
2011-08-21,2011,August,13,Sunday,Fall,Clear,310,216,94
2011-08-21,2011,August,14,Sunday,Fall,Light Snow/Rain,235,157,78
2011-08-21,2011,August,15,Sunday,Fall,Clear,68,51,17
2011-08-21,2011,August,16,Sunday,Fall,Clear,258,161,97
2011-08-21,2011,August,17,Sunday,Fall,Clear,270,179,91
2011-08-21,2011,August,18,Sunday,Fall,Clear,311,215,96
2011-08-21,2011,August,19,Sunday,Fall,Clear,282,201,81
2011-08-21,2011,August,20,Sunday,Fall,Clear,181,140,41
2011-08-21,2011,August,21,Sunday,Fall,Clear,138,93,45
2011-08-21,2011,August,22,Sunday,Fall,Cloudy,134,97,37
2011-08-21,2011,August,23,Sunday,Fall,Clear,68,48,20
2011-08-22,2011,August,0,Monday,Fall,Clear,40,22,18
2011-08-22,2011,August,1,Monday,Fall,Clear,21,13,8
2011-08-22,2011,August,2,Monday,Fall,Cloudy,8,6,2
2011-08-22,2011,August,3,Monday,Fall,Light Snow/Rain,5,5,0
2011-08-22,2011,August,4,Monday,Fall,Clear,12,10,2
2011-08-22,2011,August,5,Monday,Fall,Clear,24,23,1
2011-08-22,2011,August,6,Monday,Fall,Clear,112,106,6
2011-08-22,2011,August,7,Monday,Fall,Clear,281,270,11
2011-08-22,2011,August,8,Monday,Fall,Clear,351,331,20
2011-08-22,2011,August,9,Monday,Fall,Clear,187,151,36
2011-08-22,2011,August,10,Monday,Fall,Clear,121,85,36
2011-08-22,2011,August,11,Monday,Fall,Clear,131,85,46
2011-08-22,2011,August,12,Monday,Fall,Clear,207,153,54
2011-08-22,2011,August,13,Monday,Fall,Clear,205,158,47
2011-08-22,2011,August,14,Monday,Fall,Clear,225,137,88
2011-08-22,2011,August,15,Monday,Fall,Clear,199,127,72
2011-08-22,2011,August,16,Monday,Fall,Clear,320,254,66
2011-08-22,2011,August,17,Monday,Fall,Clear,591,509,82
2011-08-22,2011,August,18,Monday,Fall,Clear,609,537,72
2011-08-22,2011,August,19,Monday,Fall,Clear,416,350,66
2011-08-22,2011,August,20,Monday,Fall,Clear,268,247,21
2011-08-22,2011,August,21,Monday,Fall,Clear,208,180,28
2011-08-22,2011,August,22,Monday,Fall,Clear,153,121,32
2011-08-22,2011,August,23,Monday,Fall,Clear,64,45,19
2011-08-23,2011,August,0,Tuesday,Fall,Clear,35,22,13
2011-08-23,2011,August,1,Tuesday,Fall,Clear,19,13,6
2011-08-23,2011,August,2,Tuesday,Fall,Clear,6,4,2
2011-08-23,2011,August,3,Tuesday,Fall,Clear,6,4,2
2011-08-23,2011,August,4,Tuesday,Fall,Clear,5,5,0
2011-08-23,2011,August,5,Tuesday,Fall,Clear,36,35,1
2011-08-23,2011,August,6,Tuesday,Fall,Clear,114,111,3
2011-08-23,2011,August,7,Tuesday,Fall,Clear,344,333,11
2011-08-23,2011,August,8,Tuesday,Fall,Cloudy,504,461,43
2011-08-23,2011,August,9,Tuesday,Fall,Cloudy,225,191,34
2011-08-23,2011,August,10,Tuesday,Fall,Clear,148,92,56
2011-08-23,2011,August,11,Tuesday,Fall,Clear,186,124,62
2011-08-23,2011,August,12,Tuesday,Fall,Clear,237,177,60
2011-08-23,2011,August,13,Tuesday,Fall,Clear,234,164,70
2011-08-23,2011,August,14,Tuesday,Fall,Clear,651,502,149
2011-08-23,2011,August,15,Tuesday,Fall,Clear,601,423,178
2011-08-23,2011,August,16,Tuesday,Fall,Clear,444,311,133
2011-08-23,2011,August,17,Tuesday,Fall,Clear,472,339,133
2011-08-23,2011,August,18,Tuesday,Fall,Clear,519,421,98
2011-08-23,2011,August,19,Tuesday,Fall,Clear,367,297,70
2011-08-23,2011,August,20,Tuesday,Fall,Clear,260,206,54
2011-08-23,2011,August,21,Tuesday,Fall,Clear,211,173,38
2011-08-23,2011,August,22,Tuesday,Fall,Clear,191,145,46
2011-08-23,2011,August,23,Tuesday,Fall,Clear,80,61,19
2011-08-24,2011,August,0,Wednesday,Fall,Clear,38,29,9
2011-08-24,2011,August,1,Wednesday,Fall,Clear,24,17,7
2011-08-24,2011,August,2,Wednesday,Fall,Clear,6,4,2
2011-08-24,2011,August,3,Wednesday,Fall,Clear,1,1,0
2011-08-24,2011,August,4,Wednesday,Fall,Clear,7,7,0
2011-08-24,2011,August,5,Wednesday,Fall,Clear,27,26,1
2011-08-24,2011,August,6,Wednesday,Fall,Clear,108,105,3
2011-08-24,2011,August,7,Wednesday,Fall,Clear,308,297,11
2011-08-24,2011,August,8,Wednesday,Fall,Clear,468,436,32
2011-08-24,2011,August,9,Wednesday,Fall,Clear,213,169,44
2011-08-24,2011,August,10,Wednesday,Fall,Clear,146,95,51
2011-08-24,2011,August,11,Wednesday,Fall,Clear,185,128,57
2011-08-24,2011,August,12,Wednesday,Fall,Clear,235,175,60
2011-08-24,2011,August,13,Wednesday,Fall,Clear,236,180,56
2011-08-24,2011,August,14,Wednesday,Fall,Clear,204,127,77
2011-08-24,2011,August,15,Wednesday,Fall,Clear,204,141,63
2011-08-24,2011,August,16,Wednesday,Fall,Clear,271,222,49
2011-08-24,2011,August,17,Wednesday,Fall,Clear,567,484,83
2011-08-24,2011,August,18,Wednesday,Fall,Clear,621,519,102
2011-08-24,2011,August,19,Wednesday,Fall,Clear,440,347,93
2011-08-24,2011,August,20,Wednesday,Fall,Clear,334,289,45
2011-08-24,2011,August,21,Wednesday,Fall,Clear,236,189,47
2011-08-24,2011,August,22,Wednesday,Fall,Clear,181,140,41
2011-08-24,2011,August,23,Wednesday,Fall,Clear,70,54,16
2011-08-25,2011,August,0,Thursday,Fall,Clear,52,41,11
2011-08-25,2011,August,1,Thursday,Fall,Clear,15,11,4
2011-08-25,2011,August,2,Thursday,Fall,Clear,5,2,3
2011-08-25,2011,August,3,Thursday,Fall,Clear,4,2,2
2011-08-25,2011,August,4,Thursday,Fall,Clear,7,6,1
2011-08-25,2011,August,5,Thursday,Fall,Clear,26,25,1
2011-08-25,2011,August,6,Thursday,Fall,Clear,102,101,1
2011-08-25,2011,August,7,Thursday,Fall,Cloudy,313,296,17
2011-08-25,2011,August,8,Thursday,Fall,Cloudy,484,461,23
2011-08-25,2011,August,9,Thursday,Fall,Cloudy,162,141,21
2011-08-25,2011,August,10,Thursday,Fall,Cloudy,142,105,37
2011-08-25,2011,August,11,Thursday,Fall,Light Snow/Rain,151,112,39
2011-08-25,2011,August,12,Thursday,Fall,Light Snow/Rain,41,32,9
2011-08-25,2011,August,13,Thursday,Fall,Clear,37,30,7
2011-08-25,2011,August,14,Thursday,Fall,Cloudy,113,86,27
2011-08-25,2011,August,15,Thursday,Fall,Cloudy,132,104,28
2011-08-25,2011,August,16,Thursday,Fall,Clear,121,105,16
2011-08-25,2011,August,17,Thursday,Fall,Clear,312,284,28
2011-08-25,2011,August,18,Thursday,Fall,Cloudy,408,377,31
2011-08-25,2011,August,19,Thursday,Fall,Cloudy,272,241,31
2011-08-25,2011,August,20,Thursday,Fall,Clear,225,192,33
2011-08-25,2011,August,21,Thursday,Fall,Clear,187,158,29
2011-08-25,2011,August,22,Thursday,Fall,Clear,147,126,21
2011-08-25,2011,August,23,Thursday,Fall,Clear,84,69,15
2011-08-26,2011,August,0,Friday,Fall,Clear,51,42,9
2011-08-26,2011,August,1,Friday,Fall,Clear,23,13,10
2011-08-26,2011,August,2,Friday,Fall,Clear,20,16,4
2011-08-26,2011,August,3,Friday,Fall,Clear,11,8,3
2011-08-26,2011,August,4,Friday,Fall,Clear,8,6,2
2011-08-26,2011,August,5,Friday,Fall,Cloudy,26,23,3
2011-08-26,2011,August,6,Friday,Fall,Clear,105,100,5
2011-08-26,2011,August,7,Friday,Fall,Clear,266,263,3
2011-08-26,2011,August,8,Friday,Fall,Clear,404,387,17
2011-08-26,2011,August,9,Friday,Fall,Clear,230,191,39
2011-08-26,2011,August,10,Friday,Fall,Clear,123,89,34
2011-08-26,2011,August,11,Friday,Fall,Cloudy,214,151,63
2011-08-26,2011,August,12,Friday,Fall,Cloudy,243,173,70
2011-08-26,2011,August,13,Friday,Fall,Cloudy,237,165,72
2011-08-26,2011,August,14,Friday,Fall,Clear,219,164,55
2011-08-26,2011,August,15,Friday,Fall,Cloudy,249,196,53
2011-08-26,2011,August,16,Friday,Fall,Clear,343,293,50
2011-08-26,2011,August,17,Friday,Fall,Clear,489,433,56
2011-08-26,2011,August,18,Friday,Fall,Cloudy,410,370,40
2011-08-26,2011,August,19,Friday,Fall,Clear,290,235,55
2011-08-26,2011,August,20,Friday,Fall,Clear,222,183,39
2011-08-26,2011,August,21,Friday,Fall,Clear,190,152,38
2011-08-26,2011,August,22,Friday,Fall,Clear,152,126,26
2011-08-26,2011,August,23,Friday,Fall,Clear,136,114,22
2011-08-27,2011,August,0,Saturday,Fall,Clear,145,112,33
2011-08-27,2011,August,1,Saturday,Fall,Clear,64,51,13
2011-08-27,2011,August,2,Saturday,Fall,Clear,77,59,18
2011-08-27,2011,August,3,Saturday,Fall,Cloudy,30,22,8
2011-08-27,2011,August,4,Saturday,Fall,Cloudy,4,3,1
2011-08-27,2011,August,5,Saturday,Fall,Cloudy,12,11,1
2011-08-27,2011,August,6,Saturday,Fall,Cloudy,18,15,3
2011-08-27,2011,August,7,Saturday,Fall,Cloudy,28,26,2
2011-08-27,2011,August,8,Saturday,Fall,Cloudy,76,62,14
2011-08-27,2011,August,9,Saturday,Fall,Cloudy,156,128,28
2011-08-27,2011,August,10,Saturday,Fall,Cloudy,205,154,51
2011-08-27,2011,August,11,Saturday,Fall,Light Snow/Rain,88,73,15
2011-08-27,2011,August,12,Saturday,Fall,Light Snow/Rain,76,65,11
2011-08-27,2011,August,13,Saturday,Fall,Light Snow/Rain,43,33,10
2011-08-27,2011,August,14,Saturday,Fall,Light Snow/Rain,23,19,4
2011-08-27,2011,August,15,Saturday,Fall,Light Snow/Rain,30,28,2
2011-08-27,2011,August,16,Saturday,Fall,Light Snow/Rain,24,14,10
2011-08-27,2011,August,17,Saturday,Fall,Light Snow/Rain,16,14,2
2011-08-28,2011,August,7,Sunday,Fall,Light Snow/Rain,1,1,0
2011-08-28,2011,August,8,Sunday,Fall,Light Snow/Rain,8,6,2
2011-08-28,2011,August,9,Sunday,Fall,Clear,53,46,7
2011-08-28,2011,August,10,Sunday,Fall,Clear,142,115,27
2011-08-28,2011,August,11,Sunday,Fall,Clear,237,178,59
2011-08-28,2011,August,12,Sunday,Fall,Clear,306,218,88
2011-08-28,2011,August,13,Sunday,Fall,Clear,431,302,129
2011-08-28,2011,August,14,Sunday,Fall,Clear,447,290,157
2011-08-28,2011,August,15,Sunday,Fall,Clear,469,314,155
2011-08-28,2011,August,16,Sunday,Fall,Clear,491,295,196
2011-08-28,2011,August,17,Sunday,Fall,Clear,398,253,145
2011-08-28,2011,August,18,Sunday,Fall,Clear,402,257,145
2011-08-28,2011,August,19,Sunday,Fall,Clear,387,247,140
2011-08-28,2011,August,20,Sunday,Fall,Clear,214,150,64
2011-08-28,2011,August,21,Sunday,Fall,Clear,186,126,60
2011-08-28,2011,August,22,Sunday,Fall,Clear,98,73,25
2011-08-28,2011,August,23,Sunday,Fall,Clear,64,48,16
2011-08-29,2011,August,0,Monday,Fall,Clear,34,21,13
2011-08-29,2011,August,1,Monday,Fall,Clear,20,15,5
2011-08-29,2011,August,2,Monday,Fall,Clear,13,5,8
2011-08-29,2011,August,3,Monday,Fall,Clear,6,5,1
2011-08-29,2011,August,4,Monday,Fall,Clear,3,3,0
2011-08-29,2011,August,5,Monday,Fall,Clear,17,17,0
2011-08-29,2011,August,6,Monday,Fall,Clear,102,99,3
2011-08-29,2011,August,7,Monday,Fall,Clear,284,273,11
2011-08-29,2011,August,8,Monday,Fall,Clear,404,384,20
2011-08-29,2011,August,9,Monday,Fall,Clear,188,166,22
2011-08-29,2011,August,10,Monday,Fall,Clear,115,73,42
2011-08-29,2011,August,11,Monday,Fall,Clear,138,100,38
2011-08-29,2011,August,12,Monday,Fall,Cloudy,207,159,48
2011-08-29,2011,August,13,Monday,Fall,Cloudy,218,170,48
2011-08-29,2011,August,14,Monday,Fall,Clear,182,127,55
2011-08-29,2011,August,15,Monday,Fall,Clear,220,164,56
2011-08-29,2011,August,16,Monday,Fall,Clear,282,226,56
2011-08-29,2011,August,17,Monday,Fall,Cloudy,591,524,67
2011-08-29,2011,August,18,Monday,Fall,Clear,547,487,60
2011-08-29,2011,August,19,Monday,Fall,Clear,367,317,50
2011-08-29,2011,August,20,Monday,Fall,Clear,277,227,50
2011-08-29,2011,August,21,Monday,Fall,Clear,202,168,34
2011-08-29,2011,August,22,Monday,Fall,Clear,142,119,23
2011-08-29,2011,August,23,Monday,Fall,Clear,75,56,19
2011-08-30,2011,August,0,Tuesday,Fall,Clear,27,17,10
2011-08-30,2011,August,1,Tuesday,Fall,Clear,13,7,6
2011-08-30,2011,August,2,Tuesday,Fall,Clear,10,8,2
2011-08-30,2011,August,3,Tuesday,Fall,Clear,4,2,2
2011-08-30,2011,August,4,Tuesday,Fall,Clear,6,6,0
2011-08-30,2011,August,5,Tuesday,Fall,Clear,28,27,1
2011-08-30,2011,August,6,Tuesday,Fall,Clear,119,115,4
2011-08-30,2011,August,7,Tuesday,Fall,Clear,357,338,19
2011-08-30,2011,August,8,Tuesday,Fall,Clear,493,459,34
2011-08-30,2011,August,9,Tuesday,Fall,Clear,218,180,38
2011-08-30,2011,August,10,Tuesday,Fall,Clear,137,109,28
2011-08-30,2011,August,11,Tuesday,Fall,Clear,175,115,60
2011-08-30,2011,August,12,Tuesday,Fall,Clear,237,172,65
2011-08-30,2011,August,13,Tuesday,Fall,Clear,229,170,59
2011-08-30,2011,August,14,Tuesday,Fall,Clear,209,151,58
2011-08-30,2011,August,15,Tuesday,Fall,Clear,196,162,34
2011-08-30,2011,August,16,Tuesday,Fall,Clear,337,295,42
2011-08-30,2011,August,17,Tuesday,Fall,Clear,611,549,62
2011-08-30,2011,August,18,Tuesday,Fall,Clear,576,516,60
2011-08-30,2011,August,19,Tuesday,Fall,Clear,465,397,68
2011-08-30,2011,August,20,Tuesday,Fall,Clear,298,259,39
2011-08-30,2011,August,21,Tuesday,Fall,Clear,223,180,43
2011-08-30,2011,August,22,Tuesday,Fall,Clear,143,121,22
2011-08-30,2011,August,23,Tuesday,Fall,Clear,93,74,19
2011-08-31,2011,August,0,Wednesday,Fall,Clear,32,24,8
2011-08-31,2011,August,1,Wednesday,Fall,Clear,15,13,2
2011-08-31,2011,August,2,Wednesday,Fall,Clear,6,5,1
2011-08-31,2011,August,3,Wednesday,Fall,Clear,6,4,2
2011-08-31,2011,August,4,Wednesday,Fall,Clear,5,5,0
2011-08-31,2011,August,5,Wednesday,Fall,Clear,27,25,2
2011-08-31,2011,August,6,Wednesday,Fall,Clear,111,107,4
2011-08-31,2011,August,7,Wednesday,Fall,Clear,328,316,12
2011-08-31,2011,August,8,Wednesday,Fall,Clear,467,440,27
2011-08-31,2011,August,9,Wednesday,Fall,Clear,244,217,27
2011-08-31,2011,August,10,Wednesday,Fall,Clear,138,105,33
2011-08-31,2011,August,11,Wednesday,Fall,Clear,171,143,28
2011-08-31,2011,August,12,Wednesday,Fall,Clear,260,192,68
2011-08-31,2011,August,13,Wednesday,Fall,Clear,221,182,39
2011-08-31,2011,August,14,Wednesday,Fall,Clear,196,148,48
2011-08-31,2011,August,15,Wednesday,Fall,Clear,172,138,34
2011-08-31,2011,August,16,Wednesday,Fall,Clear,309,263,46
2011-08-31,2011,August,17,Wednesday,Fall,Clear,608,525,83
2011-08-31,2011,August,18,Wednesday,Fall,Clear,565,495,70
2011-08-31,2011,August,19,Wednesday,Fall,Clear,446,393,53
2011-08-31,2011,August,20,Wednesday,Fall,Clear,289,259,30
2011-08-31,2011,August,21,Wednesday,Fall,Clear,201,174,27
2011-08-31,2011,August,22,Wednesday,Fall,Clear,157,137,20
2011-08-31,2011,August,23,Wednesday,Fall,Clear,84,60,24
2011-09-01,2011,September,0,Thursday,Fall,Clear,51,33,18
2011-09-01,2011,September,1,Thursday,Fall,Clear,21,14,7
2011-09-01,2011,September,2,Thursday,Fall,Clear,25,11,14
2011-09-01,2011,September,3,Thursday,Fall,Clear,14,7,7
2011-09-01,2011,September,4,Thursday,Fall,Clear,7,7,0
2011-09-01,2011,September,5,Thursday,Fall,Clear,23,22,1
2011-09-01,2011,September,6,Thursday,Fall,Clear,105,103,2
2011-09-01,2011,September,7,Thursday,Fall,Clear,342,335,7
2011-09-01,2011,September,8,Thursday,Fall,Clear,498,467,31
2011-09-01,2011,September,9,Thursday,Fall,Clear,207,178,29
2011-09-01,2011,September,10,Thursday,Fall,Clear,138,92,46
2011-09-01,2011,September,11,Thursday,Fall,Clear,192,141,51
2011-09-01,2011,September,12,Thursday,Fall,Cloudy,229,165,64
2011-09-01,2011,September,13,Thursday,Fall,Cloudy,219,169,50
2011-09-01,2011,September,14,Thursday,Fall,Light Snow/Rain,198,144,54
2011-09-01,2011,September,15,Thursday,Fall,Clear,174,135,39
2011-09-01,2011,September,16,Thursday,Fall,Clear,308,253,55
2011-09-01,2011,September,17,Thursday,Fall,Clear,628,567,61
2011-09-01,2011,September,18,Thursday,Fall,Clear,531,462,69
2011-09-01,2011,September,19,Thursday,Fall,Clear,443,364,79
2011-09-01,2011,September,20,Thursday,Fall,Clear,280,247,33
2011-09-01,2011,September,21,Thursday,Fall,Cloudy,177,160,17
2011-09-01,2011,September,22,Thursday,Fall,Cloudy,179,145,34
2011-09-01,2011,September,23,Thursday,Fall,Clear,126,111,15
2011-09-02,2011,September,0,Friday,Fall,Clear,64,58,6
2011-09-02,2011,September,1,Friday,Fall,Light Snow/Rain,32,28,4
2011-09-02,2011,September,2,Friday,Fall,Light Snow/Rain,20,11,9
2011-09-02,2011,September,3,Friday,Fall,Cloudy,8,4,4
2011-09-02,2011,September,4,Friday,Fall,Clear,4,2,2
2011-09-02,2011,September,5,Friday,Fall,Cloudy,20,20,0
2011-09-02,2011,September,6,Friday,Fall,Clear,76,73,3
2011-09-02,2011,September,7,Friday,Fall,Clear,259,253,6
2011-09-02,2011,September,8,Friday,Fall,Clear,456,434,22
2011-09-02,2011,September,9,Friday,Fall,Cloudy,220,190,30
2011-09-02,2011,September,10,Friday,Fall,Cloudy,140,106,34
2011-09-02,2011,September,11,Friday,Fall,Cloudy,192,141,51
2011-09-02,2011,September,12,Friday,Fall,Cloudy,260,178,82
2011-09-02,2011,September,13,Friday,Fall,Cloudy,279,207,72
2011-09-02,2011,September,14,Friday,Fall,Cloudy,283,208,75
2011-09-02,2011,September,15,Friday,Fall,Cloudy,346,277,69
2011-09-02,2011,September,16,Friday,Fall,Cloudy,381,299,82
2011-09-02,2011,September,17,Friday,Fall,Cloudy,455,377,78
2011-09-02,2011,September,18,Friday,Fall,Cloudy,355,305,50
2011-09-02,2011,September,19,Friday,Fall,Clear,287,220,67
2011-09-02,2011,September,20,Friday,Fall,Clear,196,158,38
2011-09-02,2011,September,21,Friday,Fall,Cloudy,149,121,28
2011-09-02,2011,September,22,Friday,Fall,Cloudy,147,114,33
2011-09-02,2011,September,23,Friday,Fall,Cloudy,98,68,30
2011-09-03,2011,September,0,Saturday,Fall,Cloudy,87,65,22
2011-09-03,2011,September,1,Saturday,Fall,Cloudy,74,57,17
2011-09-03,2011,September,2,Saturday,Fall,Cloudy,41,26,15
2011-09-03,2011,September,3,Saturday,Fall,Clear,35,18,17
2011-09-03,2011,September,4,Saturday,Fall,Clear,7,4,3
2011-09-03,2011,September,5,Saturday,Fall,Clear,12,9,3
2011-09-03,2011,September,6,Saturday,Fall,Clear,23,19,4
2011-09-03,2011,September,7,Saturday,Fall,Clear,38,33,5
2011-09-03,2011,September,8,Saturday,Fall,Clear,89,65,24
2011-09-03,2011,September,9,Saturday,Fall,Cloudy,201,118,83
2011-09-03,2011,September,10,Saturday,Fall,Light Snow/Rain,258,168,90
2011-09-03,2011,September,11,Saturday,Fall,Light Snow/Rain,194,128,66
2011-09-03,2011,September,12,Saturday,Fall,Clear,257,160,97
2011-09-03,2011,September,13,Saturday,Fall,Clear,353,200,153
2011-09-03,2011,September,14,Saturday,Fall,Cloudy,380,176,204
2011-09-03,2011,September,15,Saturday,Fall,Clear,388,201,187
2011-09-03,2011,September,16,Saturday,Fall,Clear,374,188,186
2011-09-03,2011,September,17,Saturday,Fall,Clear,371,201,170
2011-09-03,2011,September,18,Saturday,Fall,Clear,339,179,160
2011-09-03,2011,September,19,Saturday,Fall,Clear,295,148,147
2011-09-03,2011,September,20,Saturday,Fall,Clear,219,120,99
2011-09-03,2011,September,21,Saturday,Fall,Clear,164,93,71
2011-09-03,2011,September,22,Saturday,Fall,Clear,162,96,66
2011-09-03,2011,September,23,Saturday,Fall,Clear,123,77,46
2011-09-04,2011,September,0,Sunday,Fall,Clear,109,76,33
2011-09-04,2011,September,1,Sunday,Fall,Clear,75,38,37
2011-09-04,2011,September,2,Sunday,Fall,Clear,60,43,17
2011-09-04,2011,September,3,Sunday,Fall,Clear,43,23,20
2011-09-04,2011,September,4,Sunday,Fall,Clear,4,4,0
2011-09-04,2011,September,5,Sunday,Fall,Clear,6,5,1
2011-09-04,2011,September,6,Sunday,Fall,Clear,3,3,0
2011-09-04,2011,September,7,Sunday,Fall,Clear,30,20,10
2011-09-04,2011,September,8,Sunday,Fall,Clear,70,49,21
2011-09-04,2011,September,9,Sunday,Fall,Clear,189,102,87
2011-09-04,2011,September,10,Sunday,Fall,Clear,297,147,150
2011-09-04,2011,September,11,Sunday,Fall,Clear,337,163,174
2011-09-04,2011,September,12,Sunday,Fall,Clear,435,221,214
2011-09-04,2011,September,13,Sunday,Fall,Cloudy,419,174,245
2011-09-04,2011,September,14,Sunday,Fall,Clear,361,156,205
2011-09-04,2011,September,15,Sunday,Fall,Clear,410,192,218
2011-09-04,2011,September,16,Sunday,Fall,Clear,337,141,196
2011-09-04,2011,September,17,Sunday,Fall,Clear,376,172,204
2011-09-04,2011,September,18,Sunday,Fall,Clear,356,169,187
2011-09-04,2011,September,19,Sunday,Fall,Clear,328,150,178
2011-09-04,2011,September,20,Sunday,Fall,Clear,229,125,104
2011-09-04,2011,September,21,Sunday,Fall,Clear,207,103,104
2011-09-04,2011,September,22,Sunday,Fall,Cloudy,155,85,70
2011-09-04,2011,September,23,Sunday,Fall,Cloudy,104,58,46
2011-09-05,2011,September,0,Monday,Fall,Cloudy,97,66,31
2011-09-05,2011,September,1,Monday,Fall,Cloudy,54,35,19
2011-09-05,2011,September,2,Monday,Fall,Cloudy,39,22,17
2011-09-05,2011,September,3,Monday,Fall,Cloudy,16,12,4
2011-09-05,2011,September,4,Monday,Fall,Cloudy,8,5,3
2011-09-05,2011,September,5,Monday,Fall,Cloudy,6,4,2
2011-09-05,2011,September,6,Monday,Fall,Cloudy,11,5,6
2011-09-05,2011,September,7,Monday,Fall,Clear,41,30,11
2011-09-05,2011,September,8,Monday,Fall,Cloudy,101,56,45
2011-09-05,2011,September,9,Monday,Fall,Light Snow/Rain,152,89,63
2011-09-05,2011,September,10,Monday,Fall,Cloudy,244,137,107
2011-09-05,2011,September,11,Monday,Fall,Cloudy,308,207,101
2011-09-05,2011,September,12,Monday,Fall,Cloudy,353,212,141
2011-09-05,2011,September,13,Monday,Fall,Cloudy,389,235,154
2011-09-05,2011,September,14,Monday,Fall,Clear,357,212,145
2011-09-05,2011,September,15,Monday,Fall,Cloudy,253,142,111
2011-09-05,2011,September,16,Monday,Fall,Cloudy,284,192,92
2011-09-05,2011,September,17,Monday,Fall,Cloudy,114,77,37
2011-09-05,2011,September,18,Monday,Fall,Clear,123,92,31
2011-09-05,2011,September,19,Monday,Fall,Light Snow/Rain,175,123,52
2011-09-05,2011,September,20,Monday,Fall,Light Snow/Rain,82,56,26
2011-09-05,2011,September,21,Monday,Fall,Cloudy,60,40,20
2011-09-05,2011,September,22,Monday,Fall,Cloudy,64,49,15
2011-09-05,2011,September,23,Monday,Fall,Light Snow/Rain,20,17,3
2011-09-06,2011,September,0,Tuesday,Fall,Light Snow/Rain,8,7,1
2011-09-06,2011,September,2,Tuesday,Fall,Light Snow/Rain,2,2,0
2011-09-06,2011,September,3,Tuesday,Fall,Light Snow/Rain,1,0,1
2011-09-06,2011,September,4,Tuesday,Fall,Cloudy,4,3,1
2011-09-06,2011,September,5,Tuesday,Fall,Light Snow/Rain,21,20,1
2011-09-06,2011,September,6,Tuesday,Fall,Cloudy,72,72,0
2011-09-06,2011,September,7,Tuesday,Fall,Cloudy,172,166,6
2011-09-06,2011,September,8,Tuesday,Fall,Light Snow/Rain,364,349,15
2011-09-06,2011,September,9,Tuesday,Fall,Cloudy,185,167,18
2011-09-06,2011,September,10,Tuesday,Fall,Light Snow/Rain,106,90,16
2011-09-06,2011,September,11,Tuesday,Fall,Light Snow/Rain,89,78,11
2011-09-06,2011,September,12,Tuesday,Fall,Light Snow/Rain,67,51,16
2011-09-06,2011,September,13,Tuesday,Fall,Light Snow/Rain,29,24,5
2011-09-06,2011,September,14,Tuesday,Fall,Light Snow/Rain,24,21,3
2011-09-06,2011,September,15,Tuesday,Fall,Light Snow/Rain,89,71,18
2011-09-06,2011,September,16,Tuesday,Fall,Light Snow/Rain,106,95,11
2011-09-06,2011,September,17,Tuesday,Fall,Cloudy,291,276,15
2011-09-06,2011,September,18,Tuesday,Fall,Cloudy,373,351,22
2011-09-06,2011,September,19,Tuesday,Fall,Cloudy,281,269,12
2011-09-06,2011,September,20,Tuesday,Fall,Light Snow/Rain,163,150,13
2011-09-06,2011,September,21,Tuesday,Fall,Light Snow/Rain,121,109,12
2011-09-06,2011,September,22,Tuesday,Fall,Cloudy,84,79,5
2011-09-06,2011,September,23,Tuesday,Fall,Light Snow/Rain,58,56,2
2011-09-07,2011,September,0,Wednesday,Fall,Cloudy,13,12,1
2011-09-07,2011,September,1,Wednesday,Fall,Light Snow/Rain,5,3,2
2011-09-07,2011,September,2,Wednesday,Fall,Cloudy,6,4,2
2011-09-07,2011,September,3,Wednesday,Fall,Light Snow/Rain,2,1,1
2011-09-07,2011,September,4,Wednesday,Fall,Light Snow/Rain,4,4,0
2011-09-07,2011,September,5,Wednesday,Fall,Cloudy,16,15,1
2011-09-07,2011,September,6,Wednesday,Fall,Light Snow/Rain,75,74,1
2011-09-07,2011,September,7,Wednesday,Fall,Light Snow/Rain,86,83,3
2011-09-07,2011,September,8,Wednesday,Fall,Light Snow/Rain,328,319,9
2011-09-07,2011,September,9,Wednesday,Fall,Light Snow/Rain,190,176,14
2011-09-07,2011,September,10,Wednesday,Fall,Light Snow/Rain,66,63,3
2011-09-07,2011,September,11,Wednesday,Fall,Light Snow/Rain,10,9,1
2011-09-07,2011,September,12,Wednesday,Fall,Light Snow/Rain,22,21,1
2011-09-07,2011,September,13,Wednesday,Fall,Light Snow/Rain,11,9,2
2011-09-07,2011,September,14,Wednesday,Fall,Light Snow/Rain,25,24,1
2011-09-07,2011,September,15,Wednesday,Fall,Light Snow/Rain,58,55,3
2011-09-07,2011,September,16,Wednesday,Fall,Clear,144,137,7
2011-09-07,2011,September,17,Wednesday,Fall,Light Snow/Rain,285,264,21
2011-09-07,2011,September,18,Wednesday,Fall,Light Snow/Rain,237,219,18
2011-09-07,2011,September,19,Wednesday,Fall,Cloudy,226,212,14
2011-09-07,2011,September,20,Wednesday,Fall,Light Snow/Rain,96,93,3
2011-09-07,2011,September,21,Wednesday,Fall,Light Snow/Rain,38,34,4
2011-09-07,2011,September,22,Wednesday,Fall,Light Snow/Rain,29,26,3
2011-09-07,2011,September,23,Wednesday,Fall,Light Snow/Rain,24,21,3
2011-09-08,2011,September,0,Thursday,Fall,Light Snow/Rain,14,11,3
2011-09-08,2011,September,1,Thursday,Fall,Light Snow/Rain,4,4,0
2011-09-08,2011,September,3,Thursday,Fall,Light Snow/Rain,2,2,0
2011-09-08,2011,September,4,Thursday,Fall,Cloudy,3,3,0
2011-09-08,2011,September,5,Thursday,Fall,Light Snow/Rain,14,13,1
2011-09-08,2011,September,6,Thursday,Fall,Light Snow/Rain,56,55,1
2011-09-08,2011,September,7,Thursday,Fall,Light Snow/Rain,179,172,7
2011-09-08,2011,September,8,Thursday,Fall,Light Snow/Rain,195,188,7
2011-09-08,2011,September,9,Thursday,Fall,Cloudy,69,65,4
2011-09-08,2011,September,10,Thursday,Fall,Cloudy,65,57,8
2011-09-08,2011,September,11,Thursday,Fall,Cloudy,98,82,16
2011-09-08,2011,September,12,Thursday,Fall,Cloudy,102,85,17
2011-09-08,2011,September,13,Thursday,Fall,Cloudy,126,112,14
2011-09-08,2011,September,14,Thursday,Fall,Cloudy,120,105,15
2011-09-08,2011,September,15,Thursday,Fall,Light Snow/Rain,139,115,24
2011-09-08,2011,September,16,Thursday,Fall,Light Snow/Rain,156,151,5
2011-09-08,2011,September,17,Thursday,Fall,Light Snow/Rain,113,102,11
2011-09-08,2011,September,18,Thursday,Fall,Light Snow/Rain,68,66,2
2011-09-08,2011,September,19,Thursday,Fall,Light Snow/Rain,52,51,1
2011-09-08,2011,September,20,Thursday,Fall,Cloudy,89,83,6
2011-09-08,2011,September,21,Thursday,Fall,Light Snow/Rain,82,76,6
2011-09-08,2011,September,22,Thursday,Fall,Light Snow/Rain,70,65,5
2011-09-08,2011,September,23,Thursday,Fall,Light Snow/Rain,26,26,0
2011-09-09,2011,September,0,Friday,Fall,Light Snow/Rain,16,15,1
2011-09-09,2011,September,1,Friday,Fall,Cloudy,8,8,0
2011-09-09,2011,September,2,Friday,Fall,Cloudy,8,7,1
2011-09-09,2011,September,3,Friday,Fall,Cloudy,2,1,1
2011-09-09,2011,September,4,Friday,Fall,Light Snow/Rain,3,3,0
2011-09-09,2011,September,5,Friday,Fall,Cloudy,14,14,0
2011-09-09,2011,September,6,Friday,Fall,Cloudy,57,54,3
2011-09-09,2011,September,7,Friday,Fall,Light Snow/Rain,108,104,4
2011-09-09,2011,September,8,Friday,Fall,Light Snow/Rain,288,276,12
2011-09-09,2011,September,9,Friday,Fall,Light Snow/Rain,136,131,5
2011-09-09,2011,September,10,Friday,Fall,Cloudy,29,27,2
2011-09-09,2011,September,11,Friday,Fall,Cloudy,72,66,6
2011-09-09,2011,September,12,Friday,Fall,Clear,75,71,4
2011-09-09,2011,September,13,Friday,Fall,Clear,122,108,14
2011-09-09,2011,September,14,Friday,Fall,Clear,148,119,29
2011-09-09,2011,September,15,Friday,Fall,Clear,188,161,27
2011-09-09,2011,September,16,Friday,Fall,Clear,285,244,41
2011-09-09,2011,September,17,Friday,Fall,Clear,505,451,54
2011-09-09,2011,September,18,Friday,Fall,Clear,410,377,33
2011-09-09,2011,September,19,Friday,Fall,Clear,349,316,33
2011-09-09,2011,September,20,Friday,Fall,Clear,210,180,30
2011-09-09,2011,September,21,Friday,Fall,Clear,203,154,49
2011-09-09,2011,September,22,Friday,Fall,Clear,160,127,33
2011-09-09,2011,September,23,Friday,Fall,Clear,148,113,35
2011-09-10,2011,September,0,Saturday,Fall,Clear,116,84,32
2011-09-10,2011,September,1,Saturday,Fall,Cloudy,83,67,16
2011-09-10,2011,September,2,Saturday,Fall,Cloudy,64,46,18
2011-09-10,2011,September,3,Saturday,Fall,Clear,37,29,8
2011-09-10,2011,September,4,Saturday,Fall,Clear,7,4,3
2011-09-10,2011,September,5,Saturday,Fall,Clear,8,6,2
2011-09-10,2011,September,6,Saturday,Fall,Clear,6,6,0
2011-09-10,2011,September,7,Saturday,Fall,Clear,52,43,9
2011-09-10,2011,September,8,Saturday,Fall,Clear,119,103,16
2011-09-10,2011,September,9,Saturday,Fall,Clear,207,168,39
2011-09-10,2011,September,10,Saturday,Fall,Clear,318,233,85
2011-09-10,2011,September,11,Saturday,Fall,Clear,360,252,108
2011-09-10,2011,September,12,Saturday,Fall,Clear,404,260,144
2011-09-10,2011,September,13,Saturday,Fall,Clear,370,239,131
2011-09-10,2011,September,14,Saturday,Fall,Clear,359,230,129
2011-09-10,2011,September,15,Saturday,Fall,Clear,480,263,217
2011-09-10,2011,September,16,Saturday,Fall,Clear,431,261,170
2011-09-10,2011,September,17,Saturday,Fall,Clear,460,275,185
2011-09-10,2011,September,18,Saturday,Fall,Clear,360,241,119
2011-09-10,2011,September,19,Saturday,Fall,Clear,315,214,101
2011-09-10,2011,September,20,Saturday,Fall,Clear,245,167,78
2011-09-10,2011,September,21,Saturday,Fall,Clear,230,171,59
2011-09-10,2011,September,22,Saturday,Fall,Clear,175,126,49
2011-09-10,2011,September,23,Saturday,Fall,Cloudy,139,107,32
2011-09-11,2011,September,0,Sunday,Fall,Clear,108,79,29
2011-09-11,2011,September,1,Sunday,Fall,Cloudy,88,66,22
2011-09-11,2011,September,2,Sunday,Fall,Cloudy,76,60,16
2011-09-11,2011,September,3,Sunday,Fall,Cloudy,45,30,15
2011-09-11,2011,September,4,Sunday,Fall,Clear,9,6,3
2011-09-11,2011,September,5,Sunday,Fall,Clear,39,24,15
2011-09-11,2011,September,6,Sunday,Fall,Clear,20,16,4
2011-09-11,2011,September,7,Sunday,Fall,Clear,37,28,9
2011-09-11,2011,September,8,Sunday,Fall,Clear,94,69,25
2011-09-11,2011,September,9,Sunday,Fall,Clear,227,168,59
2011-09-11,2011,September,10,Sunday,Fall,Clear,334,214,120
2011-09-11,2011,September,11,Sunday,Fall,Clear,402,258,144
2011-09-11,2011,September,12,Sunday,Fall,Clear,411,298,113
2011-09-11,2011,September,13,Sunday,Fall,Clear,350,231,119
2011-09-11,2011,September,14,Sunday,Fall,Clear,342,222,120
2011-09-11,2011,September,15,Sunday,Fall,Clear,404,270,134
2011-09-11,2011,September,16,Sunday,Fall,Clear,483,303,180
2011-09-11,2011,September,17,Sunday,Fall,Clear,380,228,152
2011-09-11,2011,September,18,Sunday,Fall,Clear,339,229,110
2011-09-11,2011,September,19,Sunday,Fall,Clear,333,232,101
2011-09-11,2011,September,20,Sunday,Fall,Clear,226,161,65
2011-09-11,2011,September,21,Sunday,Fall,Clear,159,114,45
2011-09-11,2011,September,22,Sunday,Fall,Clear,95,74,21
2011-09-11,2011,September,23,Sunday,Fall,Light Snow/Rain,45,33,12
2011-09-12,2011,September,0,Monday,Fall,Clear,16,11,5
2011-09-12,2011,September,1,Monday,Fall,Clear,12,11,1
2011-09-12,2011,September,2,Monday,Fall,Clear,2,0,2
2011-09-12,2011,September,4,Monday,Fall,Clear,4,4,0
2011-09-12,2011,September,5,Monday,Fall,Clear,24,23,1
2011-09-12,2011,September,6,Monday,Fall,Clear,109,108,1
2011-09-12,2011,September,7,Monday,Fall,Clear,312,300,12
2011-09-12,2011,September,8,Monday,Fall,Clear,408,382,26
2011-09-12,2011,September,9,Monday,Fall,Clear,176,155,21
2011-09-12,2011,September,10,Monday,Fall,Clear,129,89,40
2011-09-12,2011,September,11,Monday,Fall,Clear,165,131,34
2011-09-12,2011,September,12,Monday,Fall,Clear,184,147,37
2011-09-12,2011,September,13,Monday,Fall,Clear,163,120,43
2011-09-12,2011,September,14,Monday,Fall,Clear,189,129,60
2011-09-12,2011,September,15,Monday,Fall,Clear,212,152,60
2011-09-12,2011,September,16,Monday,Fall,Clear,298,238,60
2011-09-12,2011,September,17,Monday,Fall,Clear,590,515,75
2011-09-12,2011,September,18,Monday,Fall,Clear,571,515,56
2011-09-12,2011,September,19,Monday,Fall,Clear,436,373,63
2011-09-12,2011,September,20,Monday,Fall,Clear,299,258,41
2011-09-12,2011,September,21,Monday,Fall,Clear,195,166,29
2011-09-12,2011,September,22,Monday,Fall,Clear,150,134,16
2011-09-12,2011,September,23,Monday,Fall,Clear,69,62,7
2011-09-13,2011,September,0,Tuesday,Fall,Clear,26,19,7
2011-09-13,2011,September,1,Tuesday,Fall,Clear,10,6,4
2011-09-13,2011,September,2,Tuesday,Fall,Clear,2,0,2
2011-09-13,2011,September,3,Tuesday,Fall,Clear,4,2,2
2011-09-13,2011,September,4,Tuesday,Fall,Clear,8,6,2
2011-09-13,2011,September,5,Tuesday,Fall,Clear,20,19,1
2011-09-13,2011,September,6,Tuesday,Fall,Clear,122,116,6
2011-09-13,2011,September,7,Tuesday,Fall,Clear,362,348,14
2011-09-13,2011,September,8,Tuesday,Fall,Clear,425,399,26
2011-09-13,2011,September,9,Tuesday,Fall,Clear,214,179,35
2011-09-13,2011,September,10,Tuesday,Fall,Clear,135,93,42
2011-09-13,2011,September,11,Tuesday,Fall,Clear,153,120,33
2011-09-13,2011,September,12,Tuesday,Fall,Clear,187,144,43
2011-09-13,2011,September,13,Tuesday,Fall,Clear,184,136,48
2011-09-13,2011,September,14,Tuesday,Fall,Clear,190,139,51
2011-09-13,2011,September,15,Tuesday,Fall,Clear,180,145,35
2011-09-13,2011,September,16,Tuesday,Fall,Clear,292,251,41
2011-09-13,2011,September,17,Tuesday,Fall,Clear,579,507,72
2011-09-13,2011,September,18,Tuesday,Fall,Clear,539,472,67
2011-09-13,2011,September,19,Tuesday,Fall,Clear,396,341,55
2011-09-13,2011,September,20,Tuesday,Fall,Clear,272,241,31
2011-09-13,2011,September,21,Tuesday,Fall,Clear,245,200,45
2011-09-13,2011,September,22,Tuesday,Fall,Clear,144,120,24
2011-09-13,2011,September,23,Tuesday,Fall,Clear,74,59,15
2011-09-14,2011,September,0,Wednesday,Fall,Clear,33,28,5
2011-09-14,2011,September,1,Wednesday,Fall,Clear,8,7,1
2011-09-14,2011,September,2,Wednesday,Fall,Clear,5,4,1
2011-09-14,2011,September,3,Wednesday,Fall,Clear,8,7,1
2011-09-14,2011,September,4,Wednesday,Fall,Clear,9,8,1
2011-09-14,2011,September,5,Wednesday,Fall,Clear,31,30,1
2011-09-14,2011,September,6,Wednesday,Fall,Clear,145,138,7
2011-09-14,2011,September,7,Wednesday,Fall,Clear,370,350,20
2011-09-14,2011,September,8,Wednesday,Fall,Clear,429,396,33
2011-09-14,2011,September,9,Wednesday,Fall,Clear,202,183,19
2011-09-14,2011,September,10,Wednesday,Fall,Clear,142,115,27
2011-09-14,2011,September,11,Wednesday,Fall,Clear,164,121,43
2011-09-14,2011,September,12,Wednesday,Fall,Clear,212,156,56
2011-09-14,2011,September,13,Wednesday,Fall,Clear,178,139,39
2011-09-14,2011,September,14,Wednesday,Fall,Clear,124,105,19
2011-09-14,2011,September,15,Wednesday,Fall,Clear,176,146,30
2011-09-14,2011,September,16,Wednesday,Fall,Clear,277,241,36
2011-09-14,2011,September,17,Wednesday,Fall,Clear,599,512,87
2011-09-14,2011,September,18,Wednesday,Fall,Clear,586,503,83
2011-09-14,2011,September,19,Wednesday,Fall,Cloudy,381,337,44
2011-09-14,2011,September,20,Wednesday,Fall,Cloudy,261,221,40
2011-09-14,2011,September,21,Wednesday,Fall,Cloudy,213,189,24
2011-09-14,2011,September,22,Wednesday,Fall,Cloudy,160,140,20
2011-09-14,2011,September,23,Wednesday,Fall,Cloudy,72,62,10
2011-09-15,2011,September,0,Thursday,Fall,Clear,37,34,3
2011-09-15,2011,September,1,Thursday,Fall,Clear,20,20,0
2011-09-15,2011,September,2,Thursday,Fall,Clear,5,5,0
2011-09-15,2011,September,3,Thursday,Fall,Clear,8,5,3
2011-09-15,2011,September,4,Thursday,Fall,Clear,7,5,2
2011-09-15,2011,September,5,Thursday,Fall,Clear,31,30,1
2011-09-15,2011,September,6,Thursday,Fall,Cloudy,124,119,5
2011-09-15,2011,September,7,Thursday,Fall,Cloudy,338,321,17
2011-09-15,2011,September,8,Thursday,Fall,Clear,391,364,27
2011-09-15,2011,September,9,Thursday,Fall,Cloudy,209,186,23
2011-09-15,2011,September,10,Thursday,Fall,Cloudy,121,96,25
2011-09-15,2011,September,11,Thursday,Fall,Cloudy,159,120,39
2011-09-15,2011,September,12,Thursday,Fall,Cloudy,179,148,31
2011-09-15,2011,September,13,Thursday,Fall,Cloudy,189,151,38
2011-09-15,2011,September,14,Thursday,Fall,Cloudy,170,134,36
2011-09-15,2011,September,15,Thursday,Fall,Cloudy,135,110,25
2011-09-15,2011,September,16,Thursday,Fall,Cloudy,222,193,29
2011-09-15,2011,September,17,Thursday,Fall,Light Snow/Rain,261,230,31
2011-09-15,2011,September,18,Thursday,Fall,Light Snow/Rain,244,222,22
2011-09-15,2011,September,19,Thursday,Fall,Clear,232,212,20
2011-09-15,2011,September,20,Thursday,Fall,Clear,248,223,25
2011-09-15,2011,September,21,Thursday,Fall,Clear,145,134,11
2011-09-15,2011,September,22,Thursday,Fall,Clear,115,108,7
2011-09-15,2011,September,23,Thursday,Fall,Clear,69,61,8
2011-09-16,2011,September,0,Friday,Fall,Clear,48,43,5
2011-09-16,2011,September,1,Friday,Fall,Clear,26,19,7
2011-09-16,2011,September,2,Friday,Fall,Clear,10,7,3
2011-09-16,2011,September,3,Friday,Fall,Clear,6,4,2
2011-09-16,2011,September,4,Friday,Fall,Clear,4,3,1
2011-09-16,2011,September,5,Friday,Fall,Clear,32,30,2
2011-09-16,2011,September,6,Friday,Fall,Clear,93,87,6
2011-09-16,2011,September,7,Friday,Fall,Clear,299,283,16
2011-09-16,2011,September,8,Friday,Fall,Clear,409,386,23
2011-09-16,2011,September,9,Friday,Fall,Clear,210,189,21
2011-09-16,2011,September,10,Friday,Fall,Cloudy,140,104,36
2011-09-16,2011,September,11,Friday,Fall,Cloudy,179,139,40
2011-09-16,2011,September,12,Friday,Fall,Cloudy,251,212,39
2011-09-16,2011,September,13,Friday,Fall,Cloudy,223,168,55
2011-09-16,2011,September,14,Friday,Fall,Cloudy,225,176,49
2011-09-16,2011,September,15,Friday,Fall,Cloudy,203,165,38
2011-09-16,2011,September,16,Friday,Fall,Cloudy,358,291,67
2011-09-16,2011,September,17,Friday,Fall,Cloudy,566,480,86
2011-09-16,2011,September,18,Friday,Fall,Cloudy,482,427,55
2011-09-16,2011,September,19,Friday,Fall,Cloudy,315,256,59
2011-09-16,2011,September,20,Friday,Fall,Cloudy,225,184,41
2011-09-16,2011,September,21,Friday,Fall,Cloudy,163,124,39
2011-09-16,2011,September,22,Friday,Fall,Clear,167,135,32
2011-09-16,2011,September,23,Friday,Fall,Clear,126,106,20
2011-09-17,2011,September,0,Saturday,Fall,Clear,108,80,28
2011-09-17,2011,September,1,Saturday,Fall,Clear,80,52,28
2011-09-17,2011,September,2,Saturday,Fall,Clear,79,61,18
2011-09-17,2011,September,3,Saturday,Fall,Clear,28,21,7
2011-09-17,2011,September,4,Saturday,Fall,Clear,5,4,1
2011-09-17,2011,September,5,Saturday,Fall,Clear,5,3,2
2011-09-17,2011,September,6,Saturday,Fall,Cloudy,22,17,5
2011-09-17,2011,September,7,Saturday,Fall,Cloudy,37,33,4
2011-09-17,2011,September,8,Saturday,Fall,Cloudy,108,81,27
2011-09-17,2011,September,9,Saturday,Fall,Cloudy,177,145,32
2011-09-17,2011,September,10,Saturday,Fall,Cloudy,249,177,72
2011-09-17,2011,September,11,Saturday,Fall,Cloudy,367,248,119
2011-09-17,2011,September,12,Saturday,Fall,Cloudy,372,257,115
2011-09-17,2011,September,13,Saturday,Fall,Cloudy,349,225,124
2011-09-17,2011,September,14,Saturday,Fall,Cloudy,297,174,123
2011-09-17,2011,September,15,Saturday,Fall,Cloudy,354,206,148
2011-09-17,2011,September,16,Saturday,Fall,Clear,305,189,116
2011-09-17,2011,September,17,Saturday,Fall,Clear,359,218,141
2011-09-17,2011,September,18,Saturday,Fall,Cloudy,329,234,95
2011-09-17,2011,September,19,Saturday,Fall,Clear,256,186,70
2011-09-17,2011,September,20,Saturday,Fall,Clear,176,133,43
2011-09-17,2011,September,21,Saturday,Fall,Cloudy,170,121,49
2011-09-17,2011,September,22,Saturday,Fall,Clear,143,112,31
2011-09-17,2011,September,23,Saturday,Fall,Clear,136,100,36
2011-09-18,2011,September,0,Sunday,Fall,Clear,112,88,24
2011-09-18,2011,September,1,Sunday,Fall,Clear,79,66,13
2011-09-18,2011,September,2,Sunday,Fall,Clear,89,68,21
2011-09-18,2011,September,3,Sunday,Fall,Clear,36,25,11
2011-09-18,2011,September,4,Sunday,Fall,Clear,1,0,1
2011-09-18,2011,September,5,Sunday,Fall,Clear,6,5,1
2011-09-18,2011,September,6,Sunday,Fall,Clear,12,10,2
2011-09-18,2011,September,7,Sunday,Fall,Clear,44,29,15
2011-09-18,2011,September,8,Sunday,Fall,Clear,69,53,16
2011-09-18,2011,September,9,Sunday,Fall,Clear,140,94,46
2011-09-18,2011,September,10,Sunday,Fall,Clear,260,178,82
2011-09-18,2011,September,11,Sunday,Fall,Clear,317,201,116
2011-09-18,2011,September,12,Sunday,Fall,Clear,364,229,135
2011-09-18,2011,September,13,Sunday,Fall,Clear,376,214,162
2011-09-18,2011,September,14,Sunday,Fall,Cloudy,311,184,127
2011-09-18,2011,September,15,Sunday,Fall,Cloudy,365,233,132
2011-09-18,2011,September,16,Sunday,Fall,Cloudy,369,235,134
2011-09-18,2011,September,17,Sunday,Fall,Cloudy,325,230,95
2011-09-18,2011,September,18,Sunday,Fall,Cloudy,289,223,66
2011-09-18,2011,September,19,Sunday,Fall,Cloudy,245,191,54
2011-09-18,2011,September,20,Sunday,Fall,Cloudy,180,136,44
2011-09-18,2011,September,21,Sunday,Fall,Cloudy,147,110,37
2011-09-18,2011,September,22,Sunday,Fall,Cloudy,84,75,9
2011-09-18,2011,September,23,Sunday,Fall,Clear,54,44,10
2011-09-19,2011,September,0,Monday,Fall,Cloudy,37,23,14
2011-09-19,2011,September,1,Monday,Fall,Cloudy,10,7,3
2011-09-19,2011,September,2,Monday,Fall,Cloudy,13,7,6
2011-09-19,2011,September,3,Monday,Fall,Cloudy,5,4,1
2011-09-19,2011,September,4,Monday,Fall,Cloudy,8,6,2
2011-09-19,2011,September,5,Monday,Fall,Cloudy,28,26,2
2011-09-19,2011,September,6,Monday,Fall,Clear,113,107,6
2011-09-19,2011,September,7,Monday,Fall,Cloudy,332,312,20
2011-09-19,2011,September,8,Monday,Fall,Cloudy,420,391,29
2011-09-19,2011,September,9,Monday,Fall,Cloudy,215,183,32
2011-09-19,2011,September,10,Monday,Fall,Cloudy,105,84,21
2011-09-19,2011,September,11,Monday,Fall,Cloudy,139,98,41
2011-09-19,2011,September,12,Monday,Fall,Cloudy,189,138,51
2011-09-19,2011,September,13,Monday,Fall,Cloudy,177,124,53
2011-09-19,2011,September,14,Monday,Fall,Cloudy,188,143,45
2011-09-19,2011,September,15,Monday,Fall,Cloudy,187,143,44
2011-09-19,2011,September,16,Monday,Fall,Cloudy,263,208,55
2011-09-19,2011,September,17,Monday,Fall,Cloudy,568,483,85
2011-09-19,2011,September,18,Monday,Fall,Cloudy,540,484,56
2011-09-19,2011,September,19,Monday,Fall,Cloudy,374,333,41
2011-09-19,2011,September,20,Monday,Fall,Cloudy,231,204,27
2011-09-19,2011,September,21,Monday,Fall,Cloudy,200,181,19
2011-09-19,2011,September,22,Monday,Fall,Cloudy,129,104,25
2011-09-19,2011,September,23,Monday,Fall,Cloudy,68,55,13
2011-09-20,2011,September,0,Tuesday,Fall,Cloudy,25,21,4
2011-09-20,2011,September,1,Tuesday,Fall,Cloudy,14,11,3
2011-09-20,2011,September,2,Tuesday,Fall,Cloudy,5,4,1
2011-09-20,2011,September,3,Tuesday,Fall,Cloudy,3,3,0
2011-09-20,2011,September,4,Tuesday,Fall,Clear,6,4,2
2011-09-20,2011,September,5,Tuesday,Fall,Cloudy,22,21,1
2011-09-20,2011,September,6,Tuesday,Fall,Cloudy,114,111,3
2011-09-20,2011,September,7,Tuesday,Fall,Cloudy,329,306,23
2011-09-20,2011,September,8,Tuesday,Fall,Light Snow/Rain,209,196,13
2011-09-20,2011,September,9,Tuesday,Fall,Light Snow/Rain,69,64,5
2011-09-20,2011,September,10,Tuesday,Fall,Light Snow/Rain,30,26,4
2011-09-20,2011,September,11,Tuesday,Fall,Light Snow/Rain,56,48,8
2011-09-20,2011,September,12,Tuesday,Fall,Cloudy,60,47,13
2011-09-20,2011,September,13,Tuesday,Fall,Cloudy,103,81,22
2011-09-20,2011,September,14,Tuesday,Fall,Cloudy,112,85,27
2011-09-20,2011,September,15,Tuesday,Fall,Cloudy,192,158,34
2011-09-20,2011,September,16,Tuesday,Fall,Cloudy,264,241,23
2011-09-20,2011,September,17,Tuesday,Fall,Clear,511,445,66
2011-09-20,2011,September,18,Tuesday,Fall,Clear,492,453,39
2011-09-20,2011,September,19,Tuesday,Fall,Clear,337,294,43
2011-09-20,2011,September,20,Tuesday,Fall,Clear,253,212,41
2011-09-20,2011,September,21,Tuesday,Fall,Clear,206,177,29
2011-09-20,2011,September,22,Tuesday,Fall,Clear,148,125,23
2011-09-20,2011,September,23,Tuesday,Fall,Clear,81,70,11
2011-09-21,2011,September,0,Wednesday,Fall,Clear,27,20,7
2011-09-21,2011,September,1,Wednesday,Fall,Clear,17,17,0
2011-09-21,2011,September,2,Wednesday,Fall,Clear,6,5,1
2011-09-21,2011,September,3,Wednesday,Fall,Cloudy,6,6,0
2011-09-21,2011,September,4,Wednesday,Fall,Cloudy,7,5,2
2011-09-21,2011,September,5,Wednesday,Fall,Cloudy,31,30,1
2011-09-21,2011,September,6,Wednesday,Fall,Cloudy,117,112,5
2011-09-21,2011,September,7,Wednesday,Fall,Cloudy,330,312,18
2011-09-21,2011,September,8,Wednesday,Fall,Cloudy,462,444,18
2011-09-21,2011,September,9,Wednesday,Fall,Cloudy,208,187,21
2011-09-21,2011,September,10,Wednesday,Fall,Cloudy,133,103,30
2011-09-21,2011,September,11,Wednesday,Fall,Cloudy,180,138,42
2011-09-21,2011,September,12,Wednesday,Fall,Cloudy,193,151,42
2011-09-21,2011,September,13,Wednesday,Fall,Cloudy,181,144,37
2011-09-21,2011,September,14,Wednesday,Fall,Cloudy,179,139,40
2011-09-21,2011,September,15,Wednesday,Fall,Cloudy,185,142,43
2011-09-21,2011,September,16,Wednesday,Fall,Cloudy,281,230,51
2011-09-21,2011,September,17,Wednesday,Fall,Light Snow/Rain,536,475,61
2011-09-21,2011,September,18,Wednesday,Fall,Light Snow/Rain,408,384,24
2011-09-21,2011,September,19,Wednesday,Fall,Light Snow/Rain,283,253,30
2011-09-21,2011,September,20,Wednesday,Fall,Light Snow/Rain,160,149,11
2011-09-21,2011,September,21,Wednesday,Fall,Cloudy,200,175,25
2011-09-21,2011,September,22,Wednesday,Fall,Cloudy,127,112,15
2011-09-21,2011,September,23,Wednesday,Fall,Clear,95,80,15
2011-09-22,2011,September,0,Thursday,Fall,Clear,41,30,11
2011-09-22,2011,September,1,Thursday,Fall,Cloudy,11,6,5
2011-09-22,2011,September,2,Thursday,Fall,Cloudy,10,8,2
2011-09-22,2011,September,3,Thursday,Fall,Cloudy,12,7,5
2011-09-22,2011,September,4,Thursday,Fall,Cloudy,2,2,0
2011-09-22,2011,September,5,Thursday,Fall,Cloudy,30,28,2
2011-09-22,2011,September,6,Thursday,Fall,Cloudy,101,94,7
2011-09-22,2011,September,7,Thursday,Fall,Cloudy,311,295,16
2011-09-22,2011,September,8,Thursday,Fall,Cloudy,415,389,26
2011-09-22,2011,September,9,Thursday,Fall,Cloudy,203,168,35
2011-09-22,2011,September,10,Thursday,Fall,Cloudy,120,101,19
2011-09-22,2011,September,11,Thursday,Fall,Cloudy,165,142,23
2011-09-22,2011,September,12,Thursday,Fall,Cloudy,176,151,25
2011-09-22,2011,September,13,Thursday,Fall,Cloudy,193,155,38
2011-09-22,2011,September,14,Thursday,Fall,Cloudy,183,142,41
2011-09-22,2011,September,15,Thursday,Fall,Cloudy,181,149,32
2011-09-22,2011,September,16,Thursday,Fall,Cloudy,301,262,39
2011-09-22,2011,September,17,Thursday,Fall,Cloudy,563,513,50
2011-09-22,2011,September,18,Thursday,Fall,Cloudy,551,501,50
2011-09-22,2011,September,19,Thursday,Fall,Cloudy,420,388,32
2011-09-22,2011,September,20,Thursday,Fall,Cloudy,285,250,35
2011-09-22,2011,September,21,Thursday,Fall,Cloudy,221,194,27
2011-09-22,2011,September,22,Thursday,Fall,Cloudy,187,166,21
2011-09-22,2011,September,23,Thursday,Fall,Cloudy,113,99,14
2011-09-23,2011,September,0,Friday,Winter,Cloudy,52,41,11
2011-09-23,2011,September,1,Friday,Winter,Cloudy,31,29,2
2011-09-23,2011,September,2,Friday,Winter,Cloudy,20,14,6
2011-09-23,2011,September,3,Friday,Winter,Cloudy,8,5,3
2011-09-23,2011,September,4,Friday,Winter,Light Snow/Rain,13,7,6
2011-09-23,2011,September,5,Friday,Winter,Cloudy,22,20,2
2011-09-23,2011,September,6,Friday,Winter,Cloudy,104,99,5
2011-09-23,2011,September,7,Friday,Winter,Light Snow/Rain,254,240,14
2011-09-23,2011,September,8,Friday,Winter,Light Snow/Rain,317,297,20
2011-09-23,2011,September,9,Friday,Winter,Light Snow/Rain,111,108,3
2011-09-23,2011,September,10,Friday,Winter,Light Snow/Rain,35,28,7
2011-09-23,2011,September,11,Friday,Winter,Light Snow/Rain,21,20,1
2011-09-23,2011,September,12,Friday,Winter,Light Snow/Rain,29,28,1
2011-09-23,2011,September,13,Friday,Winter,Light Snow/Rain,34,27,7
2011-09-23,2011,September,14,Friday,Winter,Light Snow/Rain,24,21,3
2011-09-23,2011,September,15,Friday,Winter,Light Snow/Rain,61,52,9
2011-09-23,2011,September,16,Friday,Winter,Light Snow/Rain,56,51,5
2011-09-23,2011,September,17,Friday,Winter,Cloudy,99,86,13
2011-09-23,2011,September,18,Friday,Winter,Clear,234,220,14
2011-09-23,2011,September,19,Friday,Winter,Clear,248,232,16
2011-09-23,2011,September,20,Friday,Winter,Clear,179,158,21
2011-09-23,2011,September,21,Friday,Winter,Clear,138,121,17
2011-09-23,2011,September,22,Friday,Winter,Clear,157,126,31
2011-09-23,2011,September,23,Friday,Winter,Cloudy,148,107,41
2011-09-24,2011,September,0,Saturday,Winter,Clear,93,86,7
2011-09-24,2011,September,1,Saturday,Winter,Cloudy,79,61,18
2011-09-24,2011,September,2,Saturday,Winter,Cloudy,68,54,14
2011-09-24,2011,September,3,Saturday,Winter,Clear,31,27,4
2011-09-24,2011,September,4,Saturday,Winter,Clear,8,7,1
2011-09-24,2011,September,5,Saturday,Winter,Cloudy,5,3,2
2011-09-24,2011,September,6,Saturday,Winter,Cloudy,18,12,6
2011-09-24,2011,September,7,Saturday,Winter,Cloudy,46,34,12
2011-09-24,2011,September,8,Saturday,Winter,Cloudy,121,102,19
2011-09-24,2011,September,9,Saturday,Winter,Cloudy,175,134,41
2011-09-24,2011,September,10,Saturday,Winter,Cloudy,293,203,90
2011-09-24,2011,September,11,Saturday,Winter,Cloudy,386,268,118
2011-09-24,2011,September,12,Saturday,Winter,Cloudy,407,266,141
2011-09-24,2011,September,13,Saturday,Winter,Clear,460,290,170
2011-09-24,2011,September,14,Saturday,Winter,Cloudy,390,226,164
2011-09-24,2011,September,15,Saturday,Winter,Cloudy,452,284,168
2011-09-24,2011,September,16,Saturday,Winter,Cloudy,449,282,167
2011-09-24,2011,September,17,Saturday,Winter,Clear,426,246,180
2011-09-24,2011,September,18,Saturday,Winter,Clear,400,243,157
2011-09-24,2011,September,19,Saturday,Winter,Clear,308,231,77
2011-09-24,2011,September,20,Saturday,Winter,Clear,243,166,77
2011-09-24,2011,September,21,Saturday,Winter,Clear,222,156,66
2011-09-24,2011,September,22,Saturday,Winter,Cloudy,193,143,50
2011-09-24,2011,September,23,Saturday,Winter,Cloudy,150,123,27
2011-09-25,2011,September,0,Sunday,Winter,Cloudy,173,136,37
2011-09-25,2011,September,1,Sunday,Winter,Cloudy,124,93,31
2011-09-25,2011,September,2,Sunday,Winter,Light Snow/Rain,106,79,27
2011-09-25,2011,September,3,Sunday,Winter,Light Snow/Rain,59,39,20
2011-09-25,2011,September,4,Sunday,Winter,Light Snow/Rain,8,5,3
2011-09-25,2011,September,5,Sunday,Winter,Clear,3,2,1
2011-09-25,2011,September,6,Sunday,Winter,Cloudy,17,13,4
2011-09-25,2011,September,7,Sunday,Winter,Cloudy,38,23,15
2011-09-25,2011,September,8,Sunday,Winter,Cloudy,86,59,27
2011-09-25,2011,September,9,Sunday,Winter,Cloudy,155,100,55
2011-09-25,2011,September,10,Sunday,Winter,Cloudy,275,190,85
2011-09-25,2011,September,11,Sunday,Winter,Cloudy,361,230,131
2011-09-25,2011,September,12,Sunday,Winter,Cloudy,413,270,143
2011-09-25,2011,September,13,Sunday,Winter,Cloudy,369,247,122
2011-09-25,2011,September,14,Sunday,Winter,Cloudy,347,231,116
2011-09-25,2011,September,15,Sunday,Winter,Cloudy,353,234,119
2011-09-25,2011,September,16,Sunday,Winter,Clear,464,320,144
2011-09-25,2011,September,17,Sunday,Winter,Clear,420,275,145
2011-09-25,2011,September,18,Sunday,Winter,Clear,404,279,125
2011-09-25,2011,September,19,Sunday,Winter,Clear,329,242,87
2011-09-25,2011,September,20,Sunday,Winter,Clear,186,135,51
2011-09-25,2011,September,21,Sunday,Winter,Clear,137,113,24
2011-09-25,2011,September,22,Sunday,Winter,Clear,104,84,20
2011-09-25,2011,September,23,Sunday,Winter,Cloudy,79,67,12
2011-09-26,2011,September,0,Monday,Winter,Cloudy,29,23,6
2011-09-26,2011,September,1,Monday,Winter,Cloudy,17,14,3
2011-09-26,2011,September,2,Monday,Winter,Cloudy,8,4,4
2011-09-26,2011,September,3,Monday,Winter,Cloudy,5,5,0
2011-09-26,2011,September,4,Monday,Winter,Cloudy,6,4,2
2011-09-26,2011,September,5,Monday,Winter,Cloudy,25,25,0
2011-09-26,2011,September,6,Monday,Winter,Cloudy,113,107,6
2011-09-26,2011,September,7,Monday,Winter,Cloudy,332,315,17
2011-09-26,2011,September,8,Monday,Winter,Cloudy,355,326,29
2011-09-26,2011,September,9,Monday,Winter,Cloudy,205,161,44
2011-09-26,2011,September,10,Monday,Winter,Cloudy,154,117,37
2011-09-26,2011,September,11,Monday,Winter,Clear,159,116,43
2011-09-26,2011,September,12,Monday,Winter,Cloudy,209,161,48
2011-09-26,2011,September,13,Monday,Winter,Cloudy,187,139,48
2011-09-26,2011,September,14,Monday,Winter,Clear,154,110,44
2011-09-26,2011,September,15,Monday,Winter,Clear,209,157,52
2011-09-26,2011,September,16,Monday,Winter,Clear,313,239,74
2011-09-26,2011,September,17,Monday,Winter,Clear,570,509,61
2011-09-26,2011,September,18,Monday,Winter,Clear,553,490,63
2011-09-26,2011,September,19,Monday,Winter,Clear,383,347,36
2011-09-26,2011,September,20,Monday,Winter,Clear,251,227,24
2011-09-26,2011,September,21,Monday,Winter,Clear,182,164,18
2011-09-26,2011,September,22,Monday,Winter,Clear,136,122,14
2011-09-26,2011,September,23,Monday,Winter,Clear,75,64,11
2011-09-27,2011,September,0,Tuesday,Winter,Clear,37,28,9
2011-09-27,2011,September,1,Tuesday,Winter,Clear,10,6,4
2011-09-27,2011,September,2,Tuesday,Winter,Clear,11,4,7
2011-09-27,2011,September,3,Tuesday,Winter,Cloudy,10,5,5
2011-09-27,2011,September,4,Tuesday,Winter,Light Snow/Rain,8,3,5
2011-09-27,2011,September,5,Tuesday,Winter,Light Snow/Rain,24,24,0
2011-09-27,2011,September,6,Tuesday,Winter,Cloudy,124,116,8
2011-09-27,2011,September,7,Tuesday,Winter,Cloudy,249,234,15
2011-09-27,2011,September,8,Tuesday,Winter,Cloudy,427,400,27
2011-09-27,2011,September,9,Tuesday,Winter,Light Snow/Rain,193,173,20
2011-09-27,2011,September,10,Tuesday,Winter,Light Snow/Rain,122,101,21
2011-09-27,2011,September,11,Tuesday,Winter,Cloudy,123,97,26
2011-09-27,2011,September,12,Tuesday,Winter,Cloudy,162,129,33
2011-09-27,2011,September,13,Tuesday,Winter,Cloudy,151,122,29
2011-09-27,2011,September,14,Tuesday,Winter,Cloudy,152,123,29
2011-09-27,2011,September,15,Tuesday,Winter,Cloudy,205,170,35
2011-09-27,2011,September,16,Tuesday,Winter,Cloudy,258,225,33
2011-09-27,2011,September,17,Tuesday,Winter,Cloudy,530,480,50
2011-09-27,2011,September,18,Tuesday,Winter,Cloudy,356,325,31
2011-09-27,2011,September,19,Tuesday,Winter,Cloudy,320,294,26
2011-09-27,2011,September,20,Tuesday,Winter,Clear,238,221,17
2011-09-27,2011,September,21,Tuesday,Winter,Clear,196,179,17
2011-09-27,2011,September,22,Tuesday,Winter,Clear,121,102,19
2011-09-27,2011,September,23,Tuesday,Winter,Clear,93,82,11
2011-09-28,2011,September,0,Wednesday,Winter,Clear,36,29,7
2011-09-28,2011,September,1,Wednesday,Winter,Clear,14,13,1
2011-09-28,2011,September,2,Wednesday,Winter,Clear,9,9,0
2011-09-28,2011,September,3,Wednesday,Winter,Cloudy,3,3,0
2011-09-28,2011,September,4,Wednesday,Winter,Clear,4,3,1
2011-09-28,2011,September,5,Wednesday,Winter,Cloudy,22,20,2
2011-09-28,2011,September,6,Wednesday,Winter,Light Snow/Rain,114,111,3
2011-09-28,2011,September,7,Wednesday,Winter,Light Snow/Rain,185,177,8
2011-09-28,2011,September,8,Wednesday,Winter,Light Snow/Rain,287,270,17
2011-09-28,2011,September,9,Wednesday,Winter,Light Snow/Rain,155,141,14
2011-09-28,2011,September,10,Wednesday,Winter,Cloudy,129,109,20
2011-09-28,2011,September,11,Wednesday,Winter,Cloudy,151,127,24
2011-09-28,2011,September,12,Wednesday,Winter,Cloudy,184,159,25
2011-09-28,2011,September,13,Wednesday,Winter,Clear,162,138,24
2011-09-28,2011,September,14,Wednesday,Winter,Clear,170,145,25
2011-09-28,2011,September,15,Wednesday,Winter,Clear,181,146,35
2011-09-28,2011,September,16,Wednesday,Winter,Clear,280,241,39
2011-09-28,2011,September,17,Wednesday,Winter,Clear,591,527,64
2011-09-28,2011,September,18,Wednesday,Winter,Light Snow/Rain,524,459,65
2011-09-28,2011,September,19,Wednesday,Winter,Light Snow/Rain,372,315,57
2011-09-28,2011,September,20,Wednesday,Winter,Light Snow/Rain,102,91,11
2011-09-28,2011,September,21,Wednesday,Winter,Light Snow/Rain,74,67,7
2011-09-28,2011,September,22,Wednesday,Winter,Clear,87,68,19
2011-09-28,2011,September,23,Wednesday,Winter,Clear,71,59,12
2011-09-29,2011,September,0,Thursday,Winter,Clear,40,33,7
2011-09-29,2011,September,1,Thursday,Winter,Cloudy,23,20,3
2011-09-29,2011,September,2,Thursday,Winter,Cloudy,2,2,0
2011-09-29,2011,September,3,Thursday,Winter,Cloudy,8,8,0
2011-09-29,2011,September,4,Thursday,Winter,Cloudy,7,5,2
2011-09-29,2011,September,5,Thursday,Winter,Cloudy,22,22,0
2011-09-29,2011,September,6,Thursday,Winter,Cloudy,111,106,5
2011-09-29,2011,September,7,Thursday,Winter,Clear,283,269,14
2011-09-29,2011,September,8,Thursday,Winter,Clear,431,402,29
2011-09-29,2011,September,9,Thursday,Winter,Clear,225,198,27
2011-09-29,2011,September,10,Thursday,Winter,Clear,127,103,24
2011-09-29,2011,September,11,Thursday,Winter,Clear,158,122,36
2011-09-29,2011,September,12,Thursday,Winter,Clear,195,157,38
2011-09-29,2011,September,13,Thursday,Winter,Clear,211,175,36
2011-09-29,2011,September,14,Thursday,Winter,Clear,167,134,33
2011-09-29,2011,September,15,Thursday,Winter,Clear,227,185,42
2011-09-29,2011,September,16,Thursday,Winter,Clear,291,227,64
2011-09-29,2011,September,17,Thursday,Winter,Clear,589,527,62
2011-09-29,2011,September,18,Thursday,Winter,Clear,584,500,84
2011-09-29,2011,September,19,Thursday,Winter,Clear,384,348,36
2011-09-29,2011,September,20,Thursday,Winter,Clear,273,234,39
2011-09-29,2011,September,21,Thursday,Winter,Clear,225,195,30
2011-09-29,2011,September,22,Thursday,Winter,Clear,175,150,25
2011-09-29,2011,September,23,Thursday,Winter,Clear,81,64,17
2011-09-30,2011,September,0,Friday,Winter,Clear,60,53,7
2011-09-30,2011,September,1,Friday,Winter,Clear,23,18,5
2011-09-30,2011,September,2,Friday,Winter,Clear,15,9,6
2011-09-30,2011,September,3,Friday,Winter,Clear,3,3,0
2011-09-30,2011,September,4,Friday,Winter,Clear,8,6,2
2011-09-30,2011,September,5,Friday,Winter,Clear,26,23,3
2011-09-30,2011,September,6,Friday,Winter,Clear,98,98,0
2011-09-30,2011,September,7,Friday,Winter,Clear,297,283,14
2011-09-30,2011,September,8,Friday,Winter,Clear,456,425,31
2011-09-30,2011,September,9,Friday,Winter,Clear,237,214,23
2011-09-30,2011,September,10,Friday,Winter,Clear,168,122,46
2011-09-30,2011,September,11,Friday,Winter,Clear,217,168,49
2011-09-30,2011,September,12,Friday,Winter,Cloudy,254,195,59
2011-09-30,2011,September,13,Friday,Winter,Cloudy,266,194,72
2011-09-30,2011,September,14,Friday,Winter,Cloudy,266,173,93
2011-09-30,2011,September,15,Friday,Winter,Clear,245,193,52
2011-09-30,2011,September,16,Friday,Winter,Clear,360,298,62
2011-09-30,2011,September,17,Friday,Winter,Clear,591,497,94
2011-09-30,2011,September,18,Friday,Winter,Clear,511,449,62
2011-09-30,2011,September,19,Friday,Winter,Clear,374,332,42
2011-09-30,2011,September,20,Friday,Winter,Clear,230,202,28
2011-09-30,2011,September,21,Friday,Winter,Clear,206,179,27
2011-09-30,2011,September,22,Friday,Winter,Clear,159,129,30
2011-09-30,2011,September,23,Friday,Winter,Clear,132,109,23
2011-10-01,2011,October,0,Saturday,Winter,Clear,130,106,24
2011-10-01,2011,October,1,Saturday,Winter,Clear,58,47,11
2011-10-01,2011,October,2,Saturday,Winter,Clear,67,46,21
2011-10-01,2011,October,3,Saturday,Winter,Clear,25,17,8
2011-10-01,2011,October,4,Saturday,Winter,Clear,8,6,2
2011-10-01,2011,October,5,Saturday,Winter,Cloudy,5,4,1
2011-10-01,2011,October,6,Saturday,Winter,Clear,19,15,4
2011-10-01,2011,October,7,Saturday,Winter,Light Snow/Rain,36,30,6
2011-10-01,2011,October,8,Saturday,Winter,Cloudy,67,58,9
2011-10-01,2011,October,9,Saturday,Winter,Light Snow/Rain,129,112,17
2011-10-01,2011,October,10,Saturday,Winter,Light Snow/Rain,121,100,21
2011-10-01,2011,October,11,Saturday,Winter,Light Snow/Rain,132,102,30
2011-10-01,2011,October,12,Saturday,Winter,Cloudy,158,130,28
2011-10-01,2011,October,13,Saturday,Winter,Cloudy,125,98,27
2011-10-01,2011,October,14,Saturday,Winter,Cloudy,180,147,33
2011-10-01,2011,October,15,Saturday,Winter,Cloudy,195,154,41
2011-10-01,2011,October,16,Saturday,Winter,Cloudy,223,165,58
2011-10-01,2011,October,17,Saturday,Winter,Light Snow/Rain,228,170,58
2011-10-01,2011,October,18,Saturday,Winter,Light Snow/Rain,140,117,23
2011-10-01,2011,October,19,Saturday,Winter,Cloudy,126,99,27
2011-10-01,2011,October,20,Saturday,Winter,Light Snow/Rain,66,58,8
2011-10-01,2011,October,21,Saturday,Winter,Light Snow/Rain,56,53,3
2011-10-01,2011,October,22,Saturday,Winter,Cloudy,70,58,12
2011-10-01,2011,October,23,Saturday,Winter,Light Snow/Rain,65,57,8
2011-10-02,2011,October,0,Sunday,Winter,Light Snow/Rain,47,43,4
2011-10-02,2011,October,1,Sunday,Winter,Light Snow/Rain,24,23,1
2011-10-02,2011,October,2,Sunday,Winter,Light Snow/Rain,30,27,3
2011-10-02,2011,October,3,Sunday,Winter,Light Snow/Rain,9,5,4
2011-10-02,2011,October,4,Sunday,Winter,Cloudy,7,3,4
2011-10-02,2011,October,5,Sunday,Winter,Clear,7,7,0
2011-10-02,2011,October,6,Sunday,Winter,Clear,15,13,2
2011-10-02,2011,October,7,Sunday,Winter,Clear,29,24,5
2011-10-02,2011,October,8,Sunday,Winter,Cloudy,64,50,14
2011-10-02,2011,October,9,Sunday,Winter,Clear,115,96,19
2011-10-02,2011,October,10,Sunday,Winter,Cloudy,248,188,60
2011-10-02,2011,October,11,Sunday,Winter,Cloudy,292,218,74
2011-10-02,2011,October,12,Sunday,Winter,Cloudy,321,243,78
2011-10-02,2011,October,13,Sunday,Winter,Light Snow/Rain,308,224,84
2011-10-02,2011,October,14,Sunday,Winter,Light Snow/Rain,256,195,61
2011-10-02,2011,October,15,Sunday,Winter,Light Snow/Rain,173,144,29
2011-10-02,2011,October,16,Sunday,Winter,Light Snow/Rain,206,162,44
2011-10-02,2011,October,17,Sunday,Winter,Light Snow/Rain,167,135,32
2011-10-02,2011,October,18,Sunday,Winter,Cloudy,174,158,16
2011-10-02,2011,October,19,Sunday,Winter,Cloudy,162,128,34
2011-10-02,2011,October,20,Sunday,Winter,Cloudy,87,71,16
2011-10-02,2011,October,21,Sunday,Winter,Clear,88,71,17
2011-10-02,2011,October,22,Sunday,Winter,Light Snow/Rain,64,55,9
2011-10-02,2011,October,23,Sunday,Winter,Clear,25,19,6
2011-10-03,2011,October,0,Monday,Winter,Clear,16,13,3
2011-10-03,2011,October,1,Monday,Winter,Clear,6,5,1
2011-10-03,2011,October,2,Monday,Winter,Clear,4,4,0
2011-10-03,2011,October,3,Monday,Winter,Clear,7,6,1
2011-10-03,2011,October,4,Monday,Winter,Clear,8,6,2
2011-10-03,2011,October,5,Monday,Winter,Cloudy,21,17,4
2011-10-03,2011,October,6,Monday,Winter,Cloudy,94,91,3
2011-10-03,2011,October,7,Monday,Winter,Cloudy,249,241,8
2011-10-03,2011,October,8,Monday,Winter,Cloudy,372,359,13
2011-10-03,2011,October,9,Monday,Winter,Cloudy,153,141,12
2011-10-03,2011,October,10,Monday,Winter,Cloudy,101,82,19
2011-10-03,2011,October,11,Monday,Winter,Cloudy,126,100,26
2011-10-03,2011,October,12,Monday,Winter,Cloudy,147,118,29
2011-10-03,2011,October,13,Monday,Winter,Light Snow/Rain,118,102,16
2011-10-03,2011,October,14,Monday,Winter,Light Snow/Rain,120,94,26
2011-10-03,2011,October,15,Monday,Winter,Light Snow/Rain,101,79,22
2011-10-03,2011,October,16,Monday,Winter,Cloudy,218,202,16
2011-10-03,2011,October,17,Monday,Winter,Cloudy,495,455,40
2011-10-03,2011,October,18,Monday,Winter,Cloudy,412,384,28
2011-10-03,2011,October,19,Monday,Winter,Clear,315,300,15
2011-10-03,2011,October,20,Monday,Winter,Light Snow/Rain,204,191,13
2011-10-03,2011,October,21,Monday,Winter,Cloudy,138,128,10
2011-10-03,2011,October,22,Monday,Winter,Cloudy,91,79,12
2011-10-03,2011,October,23,Monday,Winter,Cloudy,54,43,11
2011-10-04,2011,October,0,Tuesday,Winter,Cloudy,27,22,5
2011-10-04,2011,October,1,Tuesday,Winter,Cloudy,9,8,1
2011-10-04,2011,October,2,Tuesday,Winter,Cloudy,3,2,1
2011-10-04,2011,October,3,Tuesday,Winter,Clear,6,3,3
2011-10-04,2011,October,4,Tuesday,Winter,Clear,7,4,3
2011-10-04,2011,October,5,Tuesday,Winter,Clear,27,25,2
2011-10-04,2011,October,6,Tuesday,Winter,Clear,112,109,3
2011-10-04,2011,October,7,Tuesday,Winter,Clear,309,298,11
2011-10-04,2011,October,8,Tuesday,Winter,Clear,400,372,28
2011-10-04,2011,October,9,Tuesday,Winter,Clear,187,168,19
2011-10-04,2011,October,10,Tuesday,Winter,Clear,126,107,19
2011-10-04,2011,October,11,Tuesday,Winter,Clear,124,102,22
2011-10-04,2011,October,12,Tuesday,Winter,Clear,199,160,39
2011-10-04,2011,October,13,Tuesday,Winter,Clear,173,153,20
2011-10-04,2011,October,14,Tuesday,Winter,Clear,183,156,27
2011-10-04,2011,October,15,Tuesday,Winter,Clear,194,166,28
2011-10-04,2011,October,16,Tuesday,Winter,Clear,309,273,36
2011-10-04,2011,October,17,Tuesday,Winter,Clear,585,530,55
2011-10-04,2011,October,18,Tuesday,Winter,Clear,524,456,68
2011-10-04,2011,October,19,Tuesday,Winter,Clear,345,310,35
2011-10-04,2011,October,20,Tuesday,Winter,Clear,261,236,25
2011-10-04,2011,October,21,Tuesday,Winter,Clear,166,144,22
2011-10-04,2011,October,22,Tuesday,Winter,Clear,114,106,8
2011-10-04,2011,October,23,Tuesday,Winter,Clear,66,60,6
2011-10-05,2011,October,0,Wednesday,Winter,Clear,43,36,7
2011-10-05,2011,October,1,Wednesday,Winter,Clear,11,7,4
2011-10-05,2011,October,2,Wednesday,Winter,Clear,3,2,1
2011-10-05,2011,October,3,Wednesday,Winter,Clear,6,5,1
2011-10-05,2011,October,4,Wednesday,Winter,Clear,5,4,1
2011-10-05,2011,October,5,Wednesday,Winter,Clear,32,29,3
2011-10-05,2011,October,6,Wednesday,Winter,Clear,117,112,5
2011-10-05,2011,October,7,Wednesday,Winter,Clear,301,292,9
2011-10-05,2011,October,8,Wednesday,Winter,Clear,467,441,26
2011-10-05,2011,October,9,Wednesday,Winter,Clear,219,187,32
2011-10-05,2011,October,10,Wednesday,Winter,Clear,133,103,30
2011-10-05,2011,October,11,Wednesday,Winter,Clear,170,138,32
2011-10-05,2011,October,12,Wednesday,Winter,Clear,214,180,34
2011-10-05,2011,October,13,Wednesday,Winter,Clear,219,189,30
2011-10-05,2011,October,14,Wednesday,Winter,Clear,190,156,34
2011-10-05,2011,October,15,Wednesday,Winter,Clear,182,147,35
2011-10-05,2011,October,16,Wednesday,Winter,Clear,282,245,37
2011-10-05,2011,October,17,Wednesday,Winter,Clear,591,525,66
2011-10-05,2011,October,18,Wednesday,Winter,Clear,593,536,57
2011-10-05,2011,October,19,Wednesday,Winter,Clear,374,334,40
2011-10-05,2011,October,20,Wednesday,Winter,Clear,246,228,18
2011-10-05,2011,October,21,Wednesday,Winter,Clear,201,173,28
2011-10-05,2011,October,22,Wednesday,Winter,Clear,154,134,20
2011-10-05,2011,October,23,Wednesday,Winter,Clear,73,64,9
2011-10-06,2011,October,0,Thursday,Winter,Clear,40,34,6
2011-10-06,2011,October,1,Thursday,Winter,Clear,22,17,5
2011-10-06,2011,October,2,Thursday,Winter,Clear,10,8,2
2011-10-06,2011,October,3,Thursday,Winter,Clear,5,4,1
2011-10-06,2011,October,4,Thursday,Winter,Clear,5,5,0
2011-10-06,2011,October,5,Thursday,Winter,Clear,24,24,0
2011-10-06,2011,October,6,Thursday,Winter,Clear,114,110,4
2011-10-06,2011,October,7,Thursday,Winter,Clear,302,287,15
2011-10-06,2011,October,8,Thursday,Winter,Clear,457,437,20
2011-10-06,2011,October,9,Thursday,Winter,Clear,208,188,20
2011-10-06,2011,October,10,Thursday,Winter,Clear,129,105,24
2011-10-06,2011,October,11,Thursday,Winter,Clear,144,115,29
2011-10-06,2011,October,12,Thursday,Winter,Clear,226,180,46
2011-10-06,2011,October,13,Thursday,Winter,Clear,191,158,33
2011-10-06,2011,October,14,Thursday,Winter,Clear,195,139,56
2011-10-06,2011,October,15,Thursday,Winter,Clear,219,157,62
2011-10-06,2011,October,16,Thursday,Winter,Clear,323,272,51
2011-10-06,2011,October,17,Thursday,Winter,Clear,568,505,63
2011-10-06,2011,October,18,Thursday,Winter,Clear,538,479,59
2011-10-06,2011,October,19,Thursday,Winter,Clear,343,305,38
2011-10-06,2011,October,20,Thursday,Winter,Clear,260,231,29
2011-10-06,2011,October,21,Thursday,Winter,Clear,195,161,34
2011-10-06,2011,October,22,Thursday,Winter,Clear,148,124,24
2011-10-06,2011,October,23,Thursday,Winter,Clear,99,81,18
2011-10-07,2011,October,0,Friday,Winter,Clear,67,48,19
2011-10-07,2011,October,1,Friday,Winter,Clear,28,25,3
2011-10-07,2011,October,2,Friday,Winter,Clear,5,5,0
2011-10-07,2011,October,3,Friday,Winter,Clear,10,9,1
2011-10-07,2011,October,4,Friday,Winter,Clear,5,5,0
2011-10-07,2011,October,5,Friday,Winter,Clear,27,24,3
2011-10-07,2011,October,6,Friday,Winter,Clear,87,84,3
2011-10-07,2011,October,7,Friday,Winter,Clear,242,237,5
2011-10-07,2011,October,8,Friday,Winter,Clear,417,386,31
2011-10-07,2011,October,9,Friday,Winter,Clear,241,207,34
2011-10-07,2011,October,10,Friday,Winter,Clear,174,126,48
2011-10-07,2011,October,11,Friday,Winter,Clear,230,150,80
2011-10-07,2011,October,12,Friday,Winter,Clear,235,174,61
2011-10-07,2011,October,13,Friday,Winter,Clear,305,210,95
2011-10-07,2011,October,14,Friday,Winter,Clear,256,179,77
2011-10-07,2011,October,15,Friday,Winter,Clear,270,202,68
2011-10-07,2011,October,16,Friday,Winter,Clear,419,346,73
2011-10-07,2011,October,17,Friday,Winter,Clear,563,462,101
2011-10-07,2011,October,18,Friday,Winter,Clear,465,371,94
2011-10-07,2011,October,19,Friday,Winter,Clear,294,243,51
2011-10-07,2011,October,20,Friday,Winter,Clear,197,167,30
2011-10-07,2011,October,21,Friday,Winter,Clear,166,144,22
2011-10-07,2011,October,22,Friday,Winter,Clear,146,119,27
2011-10-07,2011,October,23,Friday,Winter,Clear,136,113,23
2011-10-08,2011,October,0,Saturday,Winter,Clear,89,72,17
2011-10-08,2011,October,1,Saturday,Winter,Clear,65,51,14
2011-10-08,2011,October,2,Saturday,Winter,Clear,45,41,4
2011-10-08,2011,October,3,Saturday,Winter,Clear,20,16,4
2011-10-08,2011,October,4,Saturday,Winter,Clear,10,7,3
2011-10-08,2011,October,5,Saturday,Winter,Clear,8,7,1
2011-10-08,2011,October,6,Saturday,Winter,Clear,22,16,6
2011-10-08,2011,October,7,Saturday,Winter,Clear,73,46,27
2011-10-08,2011,October,8,Saturday,Winter,Clear,103,89,14
2011-10-08,2011,October,9,Saturday,Winter,Clear,217,163,54
2011-10-08,2011,October,10,Saturday,Winter,Clear,337,217,120
2011-10-08,2011,October,11,Saturday,Winter,Clear,397,221,176
2011-10-08,2011,October,12,Saturday,Winter,Clear,446,255,191
2011-10-08,2011,October,13,Saturday,Winter,Clear,485,229,256
2011-10-08,2011,October,14,Saturday,Winter,Clear,465,214,251
2011-10-08,2011,October,15,Saturday,Winter,Clear,496,234,262
2011-10-08,2011,October,16,Saturday,Winter,Clear,451,230,221
2011-10-08,2011,October,17,Saturday,Winter,Clear,393,219,174
2011-10-08,2011,October,18,Saturday,Winter,Clear,359,224,135
2011-10-08,2011,October,19,Saturday,Winter,Clear,248,172,76
2011-10-08,2011,October,20,Saturday,Winter,Clear,202,124,78
2011-10-08,2011,October,21,Saturday,Winter,Clear,187,133,54
2011-10-08,2011,October,22,Saturday,Winter,Clear,149,104,45
2011-10-08,2011,October,23,Saturday,Winter,Clear,142,90,52
2011-10-09,2011,October,0,Sunday,Winter,Clear,129,83,46
2011-10-09,2011,October,1,Sunday,Winter,Clear,78,63,15
2011-10-09,2011,October,2,Sunday,Winter,Clear,55,35,20
2011-10-09,2011,October,3,Sunday,Winter,Clear,30,20,10
2011-10-09,2011,October,4,Sunday,Winter,Clear,14,7,7
2011-10-09,2011,October,5,Sunday,Winter,Clear,15,14,1
2011-10-09,2011,October,6,Sunday,Winter,Clear,21,14,7
2011-10-09,2011,October,7,Sunday,Winter,Clear,44,26,18
2011-10-09,2011,October,8,Sunday,Winter,Clear,107,82,25
2011-10-09,2011,October,9,Sunday,Winter,Clear,185,119,66
2011-10-09,2011,October,10,Sunday,Winter,Clear,365,210,155
2011-10-09,2011,October,11,Sunday,Winter,Clear,423,234,189
2011-10-09,2011,October,12,Sunday,Winter,Clear,455,243,212
2011-10-09,2011,October,13,Sunday,Winter,Clear,418,193,225
2011-10-09,2011,October,14,Sunday,Winter,Clear,500,228,272
2011-10-09,2011,October,15,Sunday,Winter,Clear,407,209,198
2011-10-09,2011,October,16,Sunday,Winter,Clear,470,247,223
2011-10-09,2011,October,17,Sunday,Winter,Clear,438,230,208
2011-10-09,2011,October,18,Sunday,Winter,Clear,414,228,186
2011-10-09,2011,October,19,Sunday,Winter,Clear,302,186,116
2011-10-09,2011,October,20,Sunday,Winter,Clear,193,134,59
2011-10-09,2011,October,21,Sunday,Winter,Clear,173,120,53
2011-10-09,2011,October,22,Sunday,Winter,Cloudy,152,104,48
2011-10-09,2011,October,23,Sunday,Winter,Clear,123,85,38
2011-10-10,2011,October,0,Monday,Winter,Clear,53,42,11
2011-10-10,2011,October,1,Monday,Winter,Clear,34,30,4
2011-10-10,2011,October,2,Monday,Winter,Clear,19,15,4
2011-10-10,2011,October,3,Monday,Winter,Clear,11,9,2
2011-10-10,2011,October,4,Monday,Winter,Clear,6,4,2
2011-10-10,2011,October,5,Monday,Winter,Clear,21,19,2
2011-10-10,2011,October,6,Monday,Winter,Clear,44,39,5
2011-10-10,2011,October,7,Monday,Winter,Clear,114,102,12
2011-10-10,2011,October,8,Monday,Winter,Clear,254,227,27
2011-10-10,2011,October,9,Monday,Winter,Clear,219,161,58
2011-10-10,2011,October,10,Monday,Winter,Clear,265,158,107
2011-10-10,2011,October,11,Monday,Winter,Clear,322,183,139
2011-10-10,2011,October,12,Monday,Winter,Cloudy,365,201,164
2011-10-10,2011,October,13,Monday,Winter,Clear,365,219,146
2011-10-10,2011,October,14,Monday,Winter,Clear,370,223,147
2011-10-10,2011,October,15,Monday,Winter,Cloudy,384,254,130
2011-10-10,2011,October,16,Monday,Winter,Cloudy,402,248,154
2011-10-10,2011,October,17,Monday,Winter,Cloudy,459,334,125
2011-10-10,2011,October,18,Monday,Winter,Cloudy,473,365,108
2011-10-10,2011,October,19,Monday,Winter,Cloudy,336,267,69
2011-10-10,2011,October,20,Monday,Winter,Clear,225,188,37
2011-10-10,2011,October,21,Monday,Winter,Clear,175,148,27
2011-10-10,2011,October,22,Monday,Winter,Clear,126,104,22
2011-10-10,2011,October,23,Monday,Winter,Cloudy,75,63,12
2011-10-11,2011,October,0,Tuesday,Winter,Cloudy,30,16,14
2011-10-11,2011,October,1,Tuesday,Winter,Cloudy,11,9,2
2011-10-11,2011,October,2,Tuesday,Winter,Cloudy,5,4,1
2011-10-11,2011,October,3,Tuesday,Winter,Cloudy,3,1,2
2011-10-11,2011,October,4,Tuesday,Winter,Cloudy,5,5,0
2011-10-11,2011,October,5,Tuesday,Winter,Cloudy,20,20,0
2011-10-11,2011,October,6,Tuesday,Winter,Clear,123,114,9
2011-10-11,2011,October,7,Tuesday,Winter,Cloudy,352,333,19
2011-10-11,2011,October,8,Tuesday,Winter,Cloudy,406,375,31
2011-10-11,2011,October,9,Tuesday,Winter,Cloudy,235,195,40
2011-10-11,2011,October,10,Tuesday,Winter,Cloudy,149,111,38
2011-10-11,2011,October,11,Tuesday,Winter,Cloudy,123,92,31
2011-10-11,2011,October,12,Tuesday,Winter,Cloudy,181,130,51
2011-10-11,2011,October,13,Tuesday,Winter,Cloudy,180,138,42
2011-10-11,2011,October,14,Tuesday,Winter,Light Snow/Rain,171,117,54
2011-10-11,2011,October,15,Tuesday,Winter,Cloudy,175,139,36
2011-10-11,2011,October,16,Tuesday,Winter,Cloudy,320,257,63
2011-10-11,2011,October,17,Tuesday,Winter,Cloudy,604,534,70
2011-10-11,2011,October,18,Tuesday,Winter,Cloudy,539,493,46
2011-10-11,2011,October,19,Tuesday,Winter,Cloudy,318,285,33
2011-10-11,2011,October,20,Tuesday,Winter,Cloudy,234,203,31
2011-10-11,2011,October,21,Tuesday,Winter,Cloudy,175,158,17
2011-10-11,2011,October,22,Tuesday,Winter,Cloudy,147,120,27
2011-10-11,2011,October,23,Tuesday,Winter,Cloudy,57,47,10
2011-10-12,2011,October,0,Wednesday,Winter,Cloudy,25,23,2
2011-10-12,2011,October,1,Wednesday,Winter,Light Snow/Rain,10,8,2
2011-10-12,2011,October,2,Wednesday,Winter,Cloudy,2,2,0
2011-10-12,2011,October,3,Wednesday,Winter,Light Snow/Rain,2,2,0
2011-10-12,2011,October,4,Wednesday,Winter,Light Snow/Rain,7,6,1
2011-10-12,2011,October,5,Wednesday,Winter,Cloudy,22,22,0
2011-10-12,2011,October,6,Wednesday,Winter,Cloudy,112,107,5
2011-10-12,2011,October,7,Wednesday,Winter,Cloudy,259,244,15
2011-10-12,2011,October,8,Wednesday,Winter,Cloudy,404,377,27
2011-10-12,2011,October,9,Wednesday,Winter,Cloudy,197,183,14
2011-10-12,2011,October,10,Wednesday,Winter,Cloudy,113,98,15
2011-10-12,2011,October,11,Wednesday,Winter,Light Snow/Rain,120,102,18
2011-10-12,2011,October,12,Wednesday,Winter,Light Snow/Rain,62,53,9
2011-10-12,2011,October,13,Wednesday,Winter,Light Snow/Rain,101,76,25
2011-10-12,2011,October,14,Wednesday,Winter,Light Snow/Rain,78,70,8
2011-10-12,2011,October,15,Wednesday,Winter,Light Snow/Rain,45,42,3
2011-10-12,2011,October,16,Wednesday,Winter,Cloudy,55,50,5
2011-10-12,2011,October,17,Wednesday,Winter,Light Snow/Rain,251,235,16
2011-10-12,2011,October,18,Wednesday,Winter,Light Snow/Rain,172,161,11
2011-10-12,2011,October,19,Wednesday,Winter,Light Snow/Rain,109,102,7
2011-10-12,2011,October,20,Wednesday,Winter,Light Snow/Rain,90,81,9
2011-10-12,2011,October,21,Wednesday,Winter,Light Snow/Rain,83,74,9
2011-10-12,2011,October,22,Wednesday,Winter,Light Snow/Rain,43,40,3
2011-10-12,2011,October,23,Wednesday,Winter,Light Snow/Rain,54,41,13
2011-10-13,2011,October,0,Thursday,Winter,Cloudy,15,14,1
2011-10-13,2011,October,1,Thursday,Winter,Cloudy,12,9,3
2011-10-13,2011,October,2,Thursday,Winter,Cloudy,4,4,0
2011-10-13,2011,October,3,Thursday,Winter,Cloudy,6,4,2
2011-10-13,2011,October,4,Thursday,Winter,Cloudy,7,5,2
2011-10-13,2011,October,5,Thursday,Winter,Cloudy,17,16,1
2011-10-13,2011,October,6,Thursday,Winter,Light Snow/Rain,52,51,1
2011-10-13,2011,October,7,Thursday,Winter,Light Snow/Rain,81,76,5
2011-10-13,2011,October,8,Thursday,Winter,Light Snow/Rain,209,199,10
2011-10-13,2011,October,9,Thursday,Winter,Light Snow/Rain,109,106,3
2011-10-13,2011,October,10,Thursday,Winter,Light Snow/Rain,69,53,16
2011-10-13,2011,October,11,Thursday,Winter,Cloudy,84,76,8
2011-10-13,2011,October,12,Thursday,Winter,Cloudy,105,95,10
2011-10-13,2011,October,13,Thursday,Winter,Cloudy,162,142,20
2011-10-13,2011,October,14,Thursday,Winter,Clear,133,111,22
2011-10-13,2011,October,15,Thursday,Winter,Clear,155,128,27
2011-10-13,2011,October,16,Thursday,Winter,Clear,276,240,36
2011-10-13,2011,October,17,Thursday,Winter,Light Snow/Rain,479,432,47
2011-10-13,2011,October,18,Thursday,Winter,Light Snow/Rain,268,248,20
2011-10-13,2011,October,19,Thursday,Winter,Cloudy,205,187,18
2011-10-13,2011,October,20,Thursday,Winter,Clear,181,166,15
2011-10-13,2011,October,21,Thursday,Winter,Clear,123,115,8
2011-10-13,2011,October,22,Thursday,Winter,Clear,114,101,13
2011-10-13,2011,October,23,Thursday,Winter,Cloudy,47,45,2
2011-10-14,2011,October,0,Friday,Winter,Clear,39,29,10
2011-10-14,2011,October,1,Friday,Winter,Clear,24,16,8
2011-10-14,2011,October,2,Friday,Winter,Clear,6,6,0
2011-10-14,2011,October,3,Friday,Winter,Clear,7,6,1
2011-10-14,2011,October,4,Friday,Winter,Clear,8,8,0
2011-10-14,2011,October,5,Friday,Winter,Cloudy,17,17,0
2011-10-14,2011,October,6,Friday,Winter,Light Snow/Rain,94,90,4
2011-10-14,2011,October,7,Friday,Winter,Light Snow/Rain,147,137,10
2011-10-14,2011,October,8,Friday,Winter,Cloudy,209,186,23
2011-10-14,2011,October,9,Friday,Winter,Cloudy,180,164,16
2011-10-14,2011,October,10,Friday,Winter,Light Snow/Rain,125,108,17
2011-10-14,2011,October,11,Friday,Winter,Light Snow/Rain,87,76,11
2011-10-14,2011,October,12,Friday,Winter,Light Snow/Rain,75,62,13
2011-10-14,2011,October,13,Friday,Winter,Clear,132,114,18
2011-10-14,2011,October,14,Friday,Winter,Clear,156,119,37
2011-10-14,2011,October,15,Friday,Winter,Clear,230,169,61
2011-10-14,2011,October,16,Friday,Winter,Clear,344,264,80
2011-10-14,2011,October,17,Friday,Winter,Clear,481,426,55
2011-10-14,2011,October,18,Friday,Winter,Clear,423,361,62
2011-10-14,2011,October,19,Friday,Winter,Clear,248,221,27
2011-10-14,2011,October,20,Friday,Winter,Clear,196,177,19
2011-10-14,2011,October,21,Friday,Winter,Clear,178,156,22
2011-10-14,2011,October,22,Friday,Winter,Clear,143,123,20
2011-10-14,2011,October,23,Friday,Winter,Clear,95,80,15
2011-10-15,2011,October,0,Saturday,Winter,Clear,106,88,18
2011-10-15,2011,October,1,Saturday,Winter,Clear,73,64,9
2011-10-15,2011,October,2,Saturday,Winter,Clear,56,39,17
2011-10-15,2011,October,3,Saturday,Winter,Clear,23,18,5
2011-10-15,2011,October,4,Saturday,Winter,Clear,6,6,0
2011-10-15,2011,October,5,Saturday,Winter,Clear,7,6,1
2011-10-15,2011,October,6,Saturday,Winter,Clear,20,15,5
2011-10-15,2011,October,7,Saturday,Winter,Clear,57,40,17
2011-10-15,2011,October,8,Saturday,Winter,Clear,125,101,24
2011-10-15,2011,October,9,Saturday,Winter,Clear,207,157,50
2011-10-15,2011,October,10,Saturday,Winter,Clear,322,207,115
2011-10-15,2011,October,11,Saturday,Winter,Clear,374,221,153
2011-10-15,2011,October,12,Saturday,Winter,Clear,456,261,195
2011-10-15,2011,October,13,Saturday,Winter,Clear,394,223,171
2011-10-15,2011,October,14,Saturday,Winter,Clear,472,230,242
2011-10-15,2011,October,15,Saturday,Winter,Clear,377,211,166
2011-10-15,2011,October,16,Saturday,Winter,Clear,443,264,179
2011-10-15,2011,October,17,Saturday,Winter,Clear,441,264,177
2011-10-15,2011,October,18,Saturday,Winter,Clear,372,251,121
2011-10-15,2011,October,19,Saturday,Winter,Clear,238,177,61
2011-10-15,2011,October,20,Saturday,Winter,Clear,179,137,42
2011-10-15,2011,October,21,Saturday,Winter,Clear,168,115,53
2011-10-15,2011,October,22,Saturday,Winter,Clear,166,121,45
2011-10-15,2011,October,23,Saturday,Winter,Clear,135,102,33
2011-10-16,2011,October,0,Sunday,Winter,Clear,107,85,22
2011-10-16,2011,October,1,Sunday,Winter,Clear,77,64,13
2011-10-16,2011,October,2,Sunday,Winter,Clear,65,52,13
2011-10-16,2011,October,3,Sunday,Winter,Clear,42,31,11
2011-10-16,2011,October,4,Sunday,Winter,Clear,12,7,5
2011-10-16,2011,October,5,Sunday,Winter,Clear,7,6,1
2011-10-16,2011,October,6,Sunday,Winter,Clear,10,7,3
2011-10-16,2011,October,7,Sunday,Winter,Clear,48,39,9
2011-10-16,2011,October,8,Sunday,Winter,Clear,99,71,28
2011-10-16,2011,October,9,Sunday,Winter,Clear,190,151,39
2011-10-16,2011,October,10,Sunday,Winter,Clear,347,226,121
2011-10-16,2011,October,11,Sunday,Winter,Clear,377,218,159
2011-10-16,2011,October,12,Sunday,Winter,Clear,444,277,167
2011-10-16,2011,October,13,Sunday,Winter,Clear,438,269,169
2011-10-16,2011,October,14,Sunday,Winter,Clear,462,258,204
2011-10-16,2011,October,15,Sunday,Winter,Clear,412,230,182
2011-10-16,2011,October,16,Sunday,Winter,Clear,466,289,177
2011-10-16,2011,October,17,Sunday,Winter,Clear,405,253,152
2011-10-16,2011,October,18,Sunday,Winter,Clear,328,226,102
2011-10-16,2011,October,19,Sunday,Winter,Clear,233,181,52
2011-10-16,2011,October,20,Sunday,Winter,Clear,178,129,49
2011-10-16,2011,October,21,Sunday,Winter,Clear,102,88,14
2011-10-16,2011,October,22,Sunday,Winter,Clear,130,88,42
2011-10-16,2011,October,23,Sunday,Winter,Clear,62,48,14
2011-10-17,2011,October,0,Monday,Winter,Clear,37,25,12
2011-10-17,2011,October,1,Monday,Winter,Clear,17,15,2
2011-10-17,2011,October,2,Monday,Winter,Clear,7,3,4
2011-10-17,2011,October,3,Monday,Winter,Clear,2,2,0
2011-10-17,2011,October,4,Monday,Winter,Clear,5,3,2
2011-10-17,2011,October,5,Monday,Winter,Clear,29,28,1
2011-10-17,2011,October,6,Monday,Winter,Clear,114,107,7
2011-10-17,2011,October,7,Monday,Winter,Cloudy,309,299,10
2011-10-17,2011,October,8,Monday,Winter,Cloudy,414,381,33
2011-10-17,2011,October,9,Monday,Winter,Cloudy,206,180,26
2011-10-17,2011,October,10,Monday,Winter,Clear,135,92,43
2011-10-17,2011,October,11,Monday,Winter,Clear,166,131,35
2011-10-17,2011,October,12,Monday,Winter,Clear,205,166,39
2011-10-17,2011,October,13,Monday,Winter,Clear,205,156,49
2011-10-17,2011,October,14,Monday,Winter,Clear,166,122,44
2011-10-17,2011,October,15,Monday,Winter,Clear,208,142,66
2011-10-17,2011,October,16,Monday,Winter,Clear,302,238,64
2011-10-17,2011,October,17,Monday,Winter,Clear,620,540,80
2011-10-17,2011,October,18,Monday,Winter,Clear,518,469,49
2011-10-17,2011,October,19,Monday,Winter,Clear,333,288,45
2011-10-17,2011,October,20,Monday,Winter,Clear,229,189,40
2011-10-17,2011,October,21,Monday,Winter,Clear,177,141,36
2011-10-17,2011,October,22,Monday,Winter,Clear,104,88,16
2011-10-17,2011,October,23,Monday,Winter,Cloudy,62,52,10
2011-10-18,2011,October,0,Tuesday,Winter,Clear,31,23,8
2011-10-18,2011,October,1,Tuesday,Winter,Cloudy,11,7,4
2011-10-18,2011,October,2,Tuesday,Winter,Clear,5,4,1
2011-10-18,2011,October,3,Tuesday,Winter,Clear,1,1,0
2011-10-18,2011,October,4,Tuesday,Winter,Cloudy,4,4,0
2011-10-18,2011,October,5,Tuesday,Winter,Cloudy,21,19,2
2011-10-18,2011,October,6,Tuesday,Winter,Clear,109,105,4
2011-10-18,2011,October,7,Tuesday,Winter,Clear,341,326,15
2011-10-18,2011,October,8,Tuesday,Winter,Clear,499,474,25
2011-10-18,2011,October,9,Tuesday,Winter,Cloudy,227,198,29
2011-10-18,2011,October,10,Tuesday,Winter,Cloudy,102,75,27
2011-10-18,2011,October,11,Tuesday,Winter,Cloudy,147,112,35
2011-10-18,2011,October,12,Tuesday,Winter,Cloudy,201,159,42
2011-10-18,2011,October,13,Tuesday,Winter,Cloudy,219,171,48
2011-10-18,2011,October,14,Tuesday,Winter,Cloudy,169,137,32
2011-10-18,2011,October,15,Tuesday,Winter,Clear,205,139,66
2011-10-18,2011,October,16,Tuesday,Winter,Clear,304,246,58
2011-10-18,2011,October,17,Tuesday,Winter,Clear,625,553,72
2011-10-18,2011,October,18,Tuesday,Winter,Clear,570,512,58
2011-10-18,2011,October,19,Tuesday,Winter,Clear,317,286,31
2011-10-18,2011,October,20,Tuesday,Winter,Clear,227,204,23
2011-10-18,2011,October,21,Tuesday,Winter,Cloudy,206,178,28
2011-10-18,2011,October,22,Tuesday,Winter,Cloudy,137,115,22
2011-10-18,2011,October,23,Tuesday,Winter,Cloudy,70,63,7
2011-10-19,2011,October,0,Wednesday,Winter,Cloudy,34,23,11
2011-10-19,2011,October,1,Wednesday,Winter,Cloudy,16,9,7
2011-10-19,2011,October,2,Wednesday,Winter,Cloudy,7,6,1
2011-10-19,2011,October,4,Wednesday,Winter,Light Snow/Rain,3,3,0
2011-10-19,2011,October,5,Wednesday,Winter,Light Snow/Rain,3,3,0
2011-10-19,2011,October,6,Wednesday,Winter,Light Snow/Rain,31,28,3
2011-10-19,2011,October,7,Wednesday,Winter,Light Snow/Rain,68,67,1
2011-10-19,2011,October,8,Wednesday,Winter,Light Snow/Rain,210,200,10
2011-10-19,2011,October,9,Wednesday,Winter,Light Snow/Rain,202,185,17
2011-10-19,2011,October,10,Wednesday,Winter,Light Snow/Rain,123,109,14
2011-10-19,2011,October,11,Wednesday,Winter,Light Snow/Rain,149,116,33
2011-10-19,2011,October,12,Wednesday,Winter,Light Snow/Rain,130,117,13
2011-10-19,2011,October,13,Wednesday,Winter,Cloudy,106,86,20
2011-10-19,2011,October,14,Wednesday,Winter,Light Snow/Rain,97,80,17
2011-10-19,2011,October,15,Wednesday,Winter,Light Snow/Rain,120,99,21
2011-10-19,2011,October,16,Wednesday,Winter,Light Snow/Rain,201,180,21
2011-10-19,2011,October,17,Wednesday,Winter,Light Snow/Rain,181,170,11
2011-10-19,2011,October,18,Wednesday,Winter,Light Snow/Rain,140,132,8
2011-10-19,2011,October,19,Wednesday,Winter,Cloudy,197,189,8
2011-10-19,2011,October,20,Wednesday,Winter,Light Snow/Rain,145,140,5
2011-10-19,2011,October,21,Wednesday,Winter,Cloudy,85,79,6
2011-10-19,2011,October,22,Wednesday,Winter,Cloudy,107,94,13
2011-10-19,2011,October,23,Wednesday,Winter,Cloudy,69,55,14
2011-10-20,2011,October,0,Thursday,Winter,Clear,26,22,4
2011-10-20,2011,October,1,Thursday,Winter,Clear,15,11,4
2011-10-20,2011,October,2,Thursday,Winter,Clear,4,4,0
2011-10-20,2011,October,3,Thursday,Winter,Clear,1,1,0
2011-10-20,2011,October,4,Thursday,Winter,Clear,8,6,2
2011-10-20,2011,October,5,Thursday,Winter,Clear,26,24,2
2011-10-20,2011,October,6,Thursday,Winter,Clear,92,87,5
2011-10-20,2011,October,7,Thursday,Winter,Clear,318,303,15
2011-10-20,2011,October,8,Thursday,Winter,Clear,426,409,17
2011-10-20,2011,October,9,Thursday,Winter,Clear,223,197,26
2011-10-20,2011,October,10,Thursday,Winter,Clear,130,105,25
2011-10-20,2011,October,11,Thursday,Winter,Clear,129,99,30
2011-10-20,2011,October,12,Thursday,Winter,Clear,199,171,28
2011-10-20,2011,October,13,Thursday,Winter,Clear,164,136,28
2011-10-20,2011,October,14,Thursday,Winter,Cloudy,155,117,38
2011-10-20,2011,October,15,Thursday,Winter,Cloudy,160,138,22
2011-10-20,2011,October,16,Thursday,Winter,Cloudy,234,203,31
2011-10-20,2011,October,17,Thursday,Winter,Cloudy,494,438,56
2011-10-20,2011,October,18,Thursday,Winter,Cloudy,469,430,39
2011-10-20,2011,October,19,Thursday,Winter,Clear,298,278,20
2011-10-20,2011,October,20,Thursday,Winter,Cloudy,241,207,34
2011-10-20,2011,October,21,Thursday,Winter,Clear,165,149,16
2011-10-20,2011,October,22,Thursday,Winter,Clear,128,106,22
2011-10-20,2011,October,23,Thursday,Winter,Clear,90,83,7
2011-10-21,2011,October,0,Friday,Winter,Clear,50,42,8
2011-10-21,2011,October,1,Friday,Winter,Clear,26,19,7
2011-10-21,2011,October,2,Friday,Winter,Clear,18,12,6
2011-10-21,2011,October,3,Friday,Winter,Clear,7,7,0
2011-10-21,2011,October,4,Friday,Winter,Clear,6,6,0
2011-10-21,2011,October,5,Friday,Winter,Clear,31,31,0
2011-10-21,2011,October,6,Friday,Winter,Clear,85,78,7
2011-10-21,2011,October,7,Friday,Winter,Clear,233,228,5
2011-10-21,2011,October,8,Friday,Winter,Clear,402,386,16
2011-10-21,2011,October,9,Friday,Winter,Cloudy,222,189,33
2011-10-21,2011,October,10,Friday,Winter,Clear,138,106,32
2011-10-21,2011,October,11,Friday,Winter,Clear,174,135,39
2011-10-21,2011,October,12,Friday,Winter,Clear,240,193,47
2011-10-21,2011,October,13,Friday,Winter,Clear,206,163,43
2011-10-21,2011,October,14,Friday,Winter,Clear,198,131,67
2011-10-21,2011,October,15,Friday,Winter,Clear,235,178,57
2011-10-21,2011,October,16,Friday,Winter,Clear,302,242,60
2011-10-21,2011,October,17,Friday,Winter,Cloudy,524,445,79
2011-10-21,2011,October,18,Friday,Winter,Cloudy,397,354,43
2011-10-21,2011,October,19,Friday,Winter,Cloudy,253,228,25
2011-10-21,2011,October,20,Friday,Winter,Cloudy,184,155,29
2011-10-21,2011,October,21,Friday,Winter,Clear,143,112,31
2011-10-21,2011,October,22,Friday,Winter,Clear,113,89,24
2011-10-21,2011,October,23,Friday,Winter,Clear,117,99,18
2011-10-22,2011,October,0,Saturday,Winter,Clear,96,80,16
2011-10-22,2011,October,1,Saturday,Winter,Clear,70,50,20
2011-10-22,2011,October,2,Saturday,Winter,Clear,31,25,6
2011-10-22,2011,October,3,Saturday,Winter,Clear,20,19,1
2011-10-22,2011,October,4,Saturday,Winter,Clear,8,4,4
2011-10-22,2011,October,5,Saturday,Winter,Clear,8,7,1
2011-10-22,2011,October,6,Saturday,Winter,Clear,18,17,1
2011-10-22,2011,October,7,Saturday,Winter,Clear,57,49,8
2011-10-22,2011,October,8,Saturday,Winter,Clear,114,88,26
2011-10-22,2011,October,9,Saturday,Winter,Clear,169,122,47
2011-10-22,2011,October,10,Saturday,Winter,Cloudy,236,149,87
2011-10-22,2011,October,11,Saturday,Winter,Cloudy,282,172,110
2011-10-22,2011,October,12,Saturday,Winter,Clear,343,211,132
2011-10-22,2011,October,13,Saturday,Winter,Clear,322,186,136
2011-10-22,2011,October,14,Saturday,Winter,Cloudy,310,177,133
2011-10-22,2011,October,15,Saturday,Winter,Clear,382,223,159
2011-10-22,2011,October,16,Saturday,Winter,Clear,359,190,169
2011-10-22,2011,October,17,Saturday,Winter,Clear,360,217,143
2011-10-22,2011,October,18,Saturday,Winter,Clear,335,224,111
2011-10-22,2011,October,19,Saturday,Winter,Clear,220,173,47
2011-10-22,2011,October,20,Saturday,Winter,Clear,159,111,48
2011-10-22,2011,October,21,Saturday,Winter,Clear,157,120,37
2011-10-22,2011,October,22,Saturday,Winter,Clear,144,114,30
2011-10-22,2011,October,23,Saturday,Winter,Clear,108,81,27
2011-10-23,2011,October,0,Sunday,Winter,Clear,88,64,24
2011-10-23,2011,October,1,Sunday,Winter,Clear,71,60,11
2011-10-23,2011,October,2,Sunday,Winter,Clear,50,40,10
2011-10-23,2011,October,3,Sunday,Winter,Clear,46,31,15
2011-10-23,2011,October,4,Sunday,Winter,Clear,6,1,5
2011-10-23,2011,October,5,Sunday,Winter,Clear,3,2,1
2011-10-23,2011,October,6,Sunday,Winter,Clear,12,12,0
2011-10-23,2011,October,7,Sunday,Winter,Clear,21,18,3
2011-10-23,2011,October,8,Sunday,Winter,Clear,88,56,32
2011-10-23,2011,October,9,Sunday,Winter,Clear,143,95,48
2011-10-23,2011,October,10,Sunday,Winter,Clear,289,185,104
2011-10-23,2011,October,11,Sunday,Winter,Clear,333,202,131
2011-10-23,2011,October,12,Sunday,Winter,Clear,413,249,164
2011-10-23,2011,October,13,Sunday,Winter,Clear,415,255,160
2011-10-23,2011,October,14,Sunday,Winter,Clear,408,216,192
2011-10-23,2011,October,15,Sunday,Winter,Clear,387,216,171
2011-10-23,2011,October,16,Sunday,Winter,Clear,405,217,188
2011-10-23,2011,October,17,Sunday,Winter,Clear,340,220,120
2011-10-23,2011,October,18,Sunday,Winter,Clear,284,196,88
2011-10-23,2011,October,19,Sunday,Winter,Clear,193,140,53
2011-10-23,2011,October,20,Sunday,Winter,Clear,144,112,32
2011-10-23,2011,October,21,Sunday,Winter,Clear,99,75,24
2011-10-23,2011,October,22,Sunday,Winter,Clear,94,69,25
2011-10-23,2011,October,23,Sunday,Winter,Clear,49,31,18
2011-10-24,2011,October,0,Monday,Winter,Clear,32,26,6
2011-10-24,2011,October,1,Monday,Winter,Clear,15,8,7
2011-10-24,2011,October,2,Monday,Winter,Clear,7,6,1
2011-10-24,2011,October,3,Monday,Winter,Clear,4,3,1
2011-10-24,2011,October,4,Monday,Winter,Clear,6,5,1
2011-10-24,2011,October,5,Monday,Winter,Clear,21,19,2
2011-10-24,2011,October,6,Monday,Winter,Clear,86,83,3
2011-10-24,2011,October,7,Monday,Winter,Cloudy,285,274,11
2011-10-24,2011,October,8,Monday,Winter,Cloudy,398,378,20
2011-10-24,2011,October,9,Monday,Winter,Cloudy,195,166,29
2011-10-24,2011,October,10,Monday,Winter,Cloudy,129,82,47
2011-10-24,2011,October,11,Monday,Winter,Cloudy,168,109,59
2011-10-24,2011,October,12,Monday,Winter,Cloudy,220,156,64
2011-10-24,2011,October,13,Monday,Winter,Cloudy,198,138,60
2011-10-24,2011,October,14,Monday,Winter,Cloudy,206,143,63
2011-10-24,2011,October,15,Monday,Winter,Clear,177,125,52
2011-10-24,2011,October,16,Monday,Winter,Clear,310,242,68
2011-10-24,2011,October,17,Monday,Winter,Clear,614,527,87
2011-10-24,2011,October,18,Monday,Winter,Clear,486,428,58
2011-10-24,2011,October,19,Monday,Winter,Light Snow/Rain,237,212,25
2011-10-24,2011,October,20,Monday,Winter,Clear,129,118,11
2011-10-24,2011,October,21,Monday,Winter,Clear,126,114,12
2011-10-24,2011,October,22,Monday,Winter,Clear,79,76,3
2011-10-24,2011,October,23,Monday,Winter,Clear,59,50,9
2011-10-25,2011,October,0,Tuesday,Winter,Clear,30,26,4
2011-10-25,2011,October,1,Tuesday,Winter,Clear,11,6,5
2011-10-25,2011,October,2,Tuesday,Winter,Clear,5,3,2
2011-10-25,2011,October,3,Tuesday,Winter,Clear,4,3,1
2011-10-25,2011,October,4,Tuesday,Winter,Clear,5,5,0
2011-10-25,2011,October,5,Tuesday,Winter,Clear,24,24,0
2011-10-25,2011,October,6,Tuesday,Winter,Clear,98,95,3
2011-10-25,2011,October,7,Tuesday,Winter,Clear,314,299,15
2011-10-25,2011,October,8,Tuesday,Winter,Clear,408,383,25
2011-10-25,2011,October,9,Tuesday,Winter,Clear,223,194,29
2011-10-25,2011,October,10,Tuesday,Winter,Clear,128,102,26
2011-10-25,2011,October,11,Tuesday,Winter,Clear,166,120,46
2011-10-25,2011,October,12,Tuesday,Winter,Clear,200,165,35
2011-10-25,2011,October,13,Tuesday,Winter,Clear,198,161,37
2011-10-25,2011,October,14,Tuesday,Winter,Clear,200,134,66
2011-10-25,2011,October,15,Tuesday,Winter,Clear,234,171,63
2011-10-25,2011,October,16,Tuesday,Winter,Clear,285,233,52
2011-10-25,2011,October,17,Tuesday,Winter,Clear,585,517,68
2011-10-25,2011,October,18,Tuesday,Winter,Clear,518,453,65
2011-10-25,2011,October,19,Tuesday,Winter,Clear,338,294,44
2011-10-25,2011,October,20,Tuesday,Winter,Clear,248,208,40
2011-10-25,2011,October,21,Tuesday,Winter,Clear,201,169,32
2011-10-25,2011,October,22,Tuesday,Winter,Clear,170,148,22
2011-10-25,2011,October,23,Tuesday,Winter,Clear,94,79,15
2011-10-26,2011,October,0,Wednesday,Winter,Clear,32,28,4
2011-10-26,2011,October,1,Wednesday,Winter,Clear,12,9,3
2011-10-26,2011,October,2,Wednesday,Winter,Clear,3,1,2
2011-10-26,2011,October,3,Wednesday,Winter,Clear,3,3,0
2011-10-26,2011,October,4,Wednesday,Winter,Clear,5,5,0
2011-10-26,2011,October,5,Wednesday,Winter,Clear,21,21,0
2011-10-26,2011,October,6,Wednesday,Winter,Clear,92,92,0
2011-10-26,2011,October,7,Wednesday,Winter,Clear,299,284,15
2011-10-26,2011,October,8,Wednesday,Winter,Cloudy,464,438,26
2011-10-26,2011,October,9,Wednesday,Winter,Cloudy,240,226,14
2011-10-26,2011,October,10,Wednesday,Winter,Cloudy,131,105,26
2011-10-26,2011,October,11,Wednesday,Winter,Clear,155,132,23
2011-10-26,2011,October,12,Wednesday,Winter,Light Snow/Rain,194,155,39
2011-10-26,2011,October,13,Wednesday,Winter,Light Snow/Rain,82,62,20
2011-10-26,2011,October,14,Wednesday,Winter,Cloudy,66,52,14
2011-10-26,2011,October,15,Wednesday,Winter,Cloudy,70,59,11
2011-10-26,2011,October,16,Wednesday,Winter,Cloudy,213,196,17
2011-10-26,2011,October,17,Wednesday,Winter,Cloudy,454,414,40
2011-10-26,2011,October,18,Wednesday,Winter,Clear,453,398,55
2011-10-26,2011,October,19,Wednesday,Winter,Clear,331,306,25
2011-10-26,2011,October,20,Wednesday,Winter,Clear,207,180,27
2011-10-26,2011,October,21,Wednesday,Winter,Cloudy,157,140,17
2011-10-26,2011,October,22,Wednesday,Winter,Cloudy,135,112,23
2011-10-26,2011,October,23,Wednesday,Winter,Cloudy,75,72,3
2011-10-27,2011,October,0,Thursday,Winter,Clear,26,23,3
2011-10-27,2011,October,1,Thursday,Winter,Clear,11,9,2
2011-10-27,2011,October,2,Thursday,Winter,Light Snow/Rain,8,5,3
2011-10-27,2011,October,3,Thursday,Winter,Light Snow/Rain,4,3,1
2011-10-27,2011,October,4,Thursday,Winter,Light Snow/Rain,4,3,1
2011-10-27,2011,October,5,Thursday,Winter,Light Snow/Rain,15,14,1
2011-10-27,2011,October,6,Thursday,Winter,Light Snow/Rain,46,42,4
2011-10-27,2011,October,7,Thursday,Winter,Cloudy,137,128,9
2011-10-27,2011,October,8,Thursday,Winter,Light Snow/Rain,316,304,12
2011-10-27,2011,October,9,Thursday,Winter,Cloudy,171,155,16
2011-10-27,2011,October,10,Thursday,Winter,Light Snow/Rain,62,52,10
2011-10-27,2011,October,11,Thursday,Winter,Light Snow/Rain,52,44,8
2011-10-27,2011,October,12,Thursday,Winter,Light Snow/Rain,53,45,8
2011-10-27,2011,October,13,Thursday,Winter,Cloudy,74,64,10
2011-10-27,2011,October,14,Thursday,Winter,Cloudy,92,76,16
2011-10-27,2011,October,15,Thursday,Winter,Cloudy,107,95,12
2011-10-27,2011,October,16,Thursday,Winter,Cloudy,207,193,14
2011-10-27,2011,October,17,Thursday,Winter,Cloudy,322,291,31
2011-10-27,2011,October,18,Thursday,Winter,Cloudy,240,226,14
2011-10-27,2011,October,19,Thursday,Winter,Cloudy,219,200,19
2011-10-27,2011,October,20,Thursday,Winter,Clear,182,171,11
2011-10-27,2011,October,21,Thursday,Winter,Clear,132,119,13
2011-10-27,2011,October,22,Thursday,Winter,Clear,111,97,14
2011-10-27,2011,October,23,Thursday,Winter,Clear,68,60,8
2011-10-28,2011,October,0,Friday,Winter,Clear,44,40,4
2011-10-28,2011,October,1,Friday,Winter,Clear,16,9,7
2011-10-28,2011,October,2,Friday,Winter,Clear,4,3,1
2011-10-28,2011,October,3,Friday,Winter,Clear,8,4,4
2011-10-28,2011,October,4,Friday,Winter,Clear,10,5,5
2011-10-28,2011,October,5,Friday,Winter,Cloudy,25,25,0
2011-10-28,2011,October,6,Friday,Winter,Clear,75,74,1
2011-10-28,2011,October,7,Friday,Winter,Clear,205,199,6
2011-10-28,2011,October,8,Friday,Winter,Clear,374,361,13
2011-10-28,2011,October,9,Friday,Winter,Clear,229,210,19
2011-10-28,2011,October,10,Friday,Winter,Clear,130,102,28
2011-10-28,2011,October,11,Friday,Winter,Clear,168,128,40
2011-10-28,2011,October,12,Friday,Winter,Cloudy,213,167,46
2011-10-28,2011,October,13,Friday,Winter,Cloudy,228,185,43
2011-10-28,2011,October,14,Friday,Winter,Cloudy,185,152,33
2011-10-28,2011,October,15,Friday,Winter,Cloudy,215,171,44
2011-10-28,2011,October,16,Friday,Winter,Cloudy,308,262,46
2011-10-28,2011,October,17,Friday,Winter,Cloudy,446,411,35
2011-10-28,2011,October,18,Friday,Winter,Cloudy,368,332,36
2011-10-28,2011,October,19,Friday,Winter,Cloudy,204,188,16
2011-10-28,2011,October,20,Friday,Winter,Light Snow/Rain,143,131,12
2011-10-28,2011,October,21,Friday,Winter,Light Snow/Rain,74,69,5
2011-10-28,2011,October,22,Friday,Winter,Light Snow/Rain,36,32,4
2011-10-28,2011,October,23,Friday,Winter,Light Snow/Rain,39,31,8
2011-10-29,2011,October,0,Saturday,Winter,Light Snow/Rain,19,19,0
2011-10-29,2011,October,1,Saturday,Winter,Light Snow/Rain,18,18,0
2011-10-29,2011,October,2,Saturday,Winter,Light Snow/Rain,17,16,1
2011-10-29,2011,October,3,Saturday,Winter,Light Snow/Rain,8,8,0
2011-10-29,2011,October,4,Saturday,Winter,Light Snow/Rain,1,1,0
2011-10-29,2011,October,5,Saturday,Winter,Light Snow/Rain,1,1,0
2011-10-29,2011,October,6,Saturday,Winter,Light Snow/Rain,5,1,4
2011-10-29,2011,October,7,Saturday,Winter,Light Snow/Rain,7,6,1
2011-10-29,2011,October,8,Saturday,Winter,Light Snow/Rain,20,16,4
2011-10-29,2011,October,9,Saturday,Winter,Light Snow/Rain,20,19,1
2011-10-29,2011,October,10,Saturday,Winter,Light Snow/Rain,12,12,0
2011-10-29,2011,October,11,Saturday,Winter,Light Snow/Rain,27,26,1
2011-10-29,2011,October,12,Saturday,Winter,Light Snow/Rain,50,44,6
2011-10-29,2011,October,13,Saturday,Winter,Light Snow/Rain,30,30,0
2011-10-29,2011,October,14,Saturday,Winter,Light Snow/Rain,29,29,0
2011-10-29,2011,October,15,Saturday,Winter,Light Snow/Rain,41,38,3
2011-10-29,2011,October,16,Saturday,Winter,Light Snow/Rain,22,19,3
2011-10-29,2011,October,17,Saturday,Winter,Light Snow/Rain,31,28,3
2011-10-29,2011,October,18,Saturday,Winter,Light Snow/Rain,43,37,6
2011-10-29,2011,October,19,Saturday,Winter,Clear,39,36,3
2011-10-29,2011,October,20,Saturday,Winter,Clear,47,40,7
2011-10-29,2011,October,21,Saturday,Winter,Clear,50,49,1
2011-10-29,2011,October,22,Saturday,Winter,Clear,54,44,10
2011-10-29,2011,October,23,Saturday,Winter,Clear,36,33,3
2011-10-30,2011,October,0,Sunday,Winter,Clear,54,47,7
2011-10-30,2011,October,1,Sunday,Winter,Clear,43,34,9
2011-10-30,2011,October,2,Sunday,Winter,Clear,50,43,7
2011-10-30,2011,October,3,Sunday,Winter,Clear,33,26,7
2011-10-30,2011,October,4,Sunday,Winter,Clear,11,10,1
2011-10-30,2011,October,5,Sunday,Winter,Clear,4,4,0
2011-10-30,2011,October,6,Sunday,Winter,Clear,10,8,2
2011-10-30,2011,October,7,Sunday,Winter,Clear,22,15,7
2011-10-30,2011,October,8,Sunday,Winter,Clear,80,60,20
2011-10-30,2011,October,9,Sunday,Winter,Clear,147,92,55
2011-10-30,2011,October,10,Sunday,Winter,Clear,178,125,53
2011-10-30,2011,October,11,Sunday,Winter,Clear,240,182,58
2011-10-30,2011,October,12,Sunday,Winter,Clear,314,229,85
2011-10-30,2011,October,13,Sunday,Winter,Clear,345,232,113
2011-10-30,2011,October,14,Sunday,Winter,Clear,300,209,91
2011-10-30,2011,October,15,Sunday,Winter,Clear,290,202,88
2011-10-30,2011,October,16,Sunday,Winter,Clear,320,213,107
2011-10-30,2011,October,17,Sunday,Winter,Clear,245,191,54
2011-10-30,2011,October,18,Sunday,Winter,Clear,213,162,51
2011-10-30,2011,October,19,Sunday,Winter,Clear,153,125,28
2011-10-30,2011,October,20,Sunday,Winter,Clear,92,74,18
2011-10-30,2011,October,21,Sunday,Winter,Clear,79,75,4
2011-10-30,2011,October,22,Sunday,Winter,Clear,71,58,13
2011-10-30,2011,October,23,Sunday,Winter,Clear,37,30,7
2011-10-31,2011,October,0,Monday,Winter,Clear,23,20,3
2011-10-31,2011,October,1,Monday,Winter,Clear,13,8,5
2011-10-31,2011,October,2,Monday,Winter,Clear,3,3,0
2011-10-31,2011,October,3,Monday,Winter,Clear,3,3,0
2011-10-31,2011,October,4,Monday,Winter,Clear,6,5,1
2011-10-31,2011,October,5,Monday,Winter,Clear,18,18,0
2011-10-31,2011,October,6,Monday,Winter,Clear,86,82,4
2011-10-31,2011,October,7,Monday,Winter,Clear,227,216,11
2011-10-31,2011,October,8,Monday,Winter,Cloudy,372,355,17
2011-10-31,2011,October,9,Monday,Winter,Cloudy,211,197,14
2011-10-31,2011,October,10,Monday,Winter,Cloudy,105,87,18
2011-10-31,2011,October,11,Monday,Winter,Clear,128,97,31
2011-10-31,2011,October,12,Monday,Winter,Clear,170,140,30
2011-10-31,2011,October,13,Monday,Winter,Cloudy,152,128,24
2011-10-31,2011,October,14,Monday,Winter,Cloudy,141,119,22
2011-10-31,2011,October,15,Monday,Winter,Clear,168,141,27
2011-10-31,2011,October,16,Monday,Winter,Clear,272,242,30
2011-10-31,2011,October,17,Monday,Winter,Clear,486,442,44
2011-10-31,2011,October,18,Monday,Winter,Clear,422,392,30
2011-10-31,2011,October,19,Monday,Winter,Clear,238,226,12
2011-10-31,2011,October,20,Monday,Winter,Clear,172,154,18
2011-10-31,2011,October,21,Monday,Winter,Cloudy,116,109,7
2011-10-31,2011,October,22,Monday,Winter,Cloudy,85,77,8
2011-10-31,2011,October,23,Monday,Winter,Cloudy,52,46,6
2011-11-01,2011,November,0,Tuesday,Winter,Cloudy,21,18,3
2011-11-01,2011,November,1,Tuesday,Winter,Clear,11,8,3
2011-11-01,2011,November,2,Tuesday,Winter,Cloudy,4,3,1
2011-11-01,2011,November,3,Tuesday,Winter,Cloudy,6,5,1
2011-11-01,2011,November,4,Tuesday,Winter,Clear,8,7,1
2011-11-01,2011,November,5,Tuesday,Winter,Clear,18,18,0
2011-11-01,2011,November,6,Tuesday,Winter,Clear,93,90,3
2011-11-01,2011,November,7,Tuesday,Winter,Clear,254,246,8
2011-11-01,2011,November,8,Tuesday,Winter,Clear,419,402,17
2011-11-01,2011,November,9,Tuesday,Winter,Clear,222,206,16
2011-11-01,2011,November,10,Tuesday,Winter,Clear,135,114,21
2011-11-01,2011,November,11,Tuesday,Winter,Clear,117,101,16
2011-11-01,2011,November,12,Tuesday,Winter,Clear,176,153,23
2011-11-01,2011,November,13,Tuesday,Winter,Clear,167,147,20
2011-11-01,2011,November,14,Tuesday,Winter,Clear,150,118,32
2011-11-01,2011,November,15,Tuesday,Winter,Clear,186,148,38
2011-11-01,2011,November,16,Tuesday,Winter,Clear,298,252,46
2011-11-01,2011,November,17,Tuesday,Winter,Clear,506,470,36
2011-11-01,2011,November,18,Tuesday,Winter,Clear,460,421,39
2011-11-01,2011,November,19,Tuesday,Winter,Clear,313,274,39
2011-11-01,2011,November,20,Tuesday,Winter,Clear,209,191,18
2011-11-01,2011,November,21,Tuesday,Winter,Clear,127,114,13
2011-11-01,2011,November,22,Tuesday,Winter,Clear,96,91,5
2011-11-01,2011,November,23,Tuesday,Winter,Clear,72,61,11
2011-11-02,2011,November,0,Wednesday,Winter,Clear,19,19,0
2011-11-02,2011,November,1,Wednesday,Winter,Clear,10,8,2
2011-11-02,2011,November,2,Wednesday,Winter,Clear,2,2,0
2011-11-02,2011,November,3,Wednesday,Winter,Clear,2,2,0
2011-11-02,2011,November,4,Wednesday,Winter,Clear,4,4,0
2011-11-02,2011,November,5,Wednesday,Winter,Clear,27,27,0
2011-11-02,2011,November,6,Wednesday,Winter,Clear,92,91,1
2011-11-02,2011,November,7,Wednesday,Winter,Clear,251,240,11
2011-11-02,2011,November,8,Wednesday,Winter,Clear,472,452,20
2011-11-02,2011,November,9,Wednesday,Winter,Clear,228,213,15
2011-11-02,2011,November,10,Wednesday,Winter,Clear,133,108,25
2011-11-02,2011,November,11,Wednesday,Winter,Clear,144,117,27
2011-11-02,2011,November,12,Wednesday,Winter,Clear,189,157,32
2011-11-02,2011,November,13,Wednesday,Winter,Clear,161,139,22
2011-11-02,2011,November,14,Wednesday,Winter,Clear,172,132,40
2011-11-02,2011,November,15,Wednesday,Winter,Clear,187,161,26
2011-11-02,2011,November,16,Wednesday,Winter,Clear,266,231,35
2011-11-02,2011,November,17,Wednesday,Winter,Clear,553,523,30
2011-11-02,2011,November,18,Wednesday,Winter,Clear,479,448,31
2011-11-02,2011,November,19,Wednesday,Winter,Clear,282,257,25
2011-11-02,2011,November,20,Wednesday,Winter,Clear,182,177,5
2011-11-02,2011,November,21,Wednesday,Winter,Clear,168,155,13
2011-11-02,2011,November,22,Wednesday,Winter,Clear,106,99,7
2011-11-02,2011,November,23,Wednesday,Winter,Clear,57,54,3
2011-11-03,2011,November,0,Thursday,Winter,Clear,31,28,3
2011-11-03,2011,November,1,Thursday,Winter,Clear,15,12,3
2011-11-03,2011,November,2,Thursday,Winter,Clear,7,5,2
2011-11-03,2011,November,3,Thursday,Winter,Clear,5,4,1
2011-11-03,2011,November,4,Thursday,Winter,Clear,4,3,1
2011-11-03,2011,November,5,Thursday,Winter,Clear,28,27,1
2011-11-03,2011,November,6,Thursday,Winter,Clear,99,96,3
2011-11-03,2011,November,7,Thursday,Winter,Cloudy,292,280,12
2011-11-03,2011,November,8,Thursday,Winter,Cloudy,402,394,8
2011-11-03,2011,November,9,Thursday,Winter,Cloudy,164,155,9
2011-11-03,2011,November,10,Thursday,Winter,Cloudy,110,98,12
2011-11-03,2011,November,11,Thursday,Winter,Clear,120,108,12
2011-11-03,2011,November,12,Thursday,Winter,Clear,179,162,17
2011-11-03,2011,November,13,Thursday,Winter,Cloudy,169,150,19
2011-11-03,2011,November,14,Thursday,Winter,Clear,152,120,32
2011-11-03,2011,November,15,Thursday,Winter,Clear,162,138,24
2011-11-03,2011,November,16,Thursday,Winter,Clear,267,234,33
2011-11-03,2011,November,17,Thursday,Winter,Clear,498,465,33
2011-11-03,2011,November,18,Thursday,Winter,Clear,433,409,24
2011-11-03,2011,November,19,Thursday,Winter,Clear,252,234,18
2011-11-03,2011,November,20,Thursday,Winter,Clear,209,198,11
2011-11-03,2011,November,21,Thursday,Winter,Clear,144,140,4
2011-11-03,2011,November,22,Thursday,Winter,Clear,137,116,21
2011-11-03,2011,November,23,Thursday,Winter,Clear,95,80,15
2011-11-04,2011,November,0,Friday,Winter,Cloudy,43,32,11
2011-11-04,2011,November,1,Friday,Winter,Cloudy,17,16,1
2011-11-04,2011,November,2,Friday,Winter,Cloudy,10,8,2
2011-11-04,2011,November,3,Friday,Winter,Cloudy,8,7,1
2011-11-04,2011,November,4,Friday,Winter,Cloudy,7,6,1
2011-11-04,2011,November,5,Friday,Winter,Cloudy,23,23,0
2011-11-04,2011,November,6,Friday,Winter,Cloudy,66,64,2
2011-11-04,2011,November,7,Friday,Winter,Cloudy,245,235,10
2011-11-04,2011,November,8,Friday,Winter,Cloudy,395,387,8
2011-11-04,2011,November,9,Friday,Winter,Cloudy,254,239,15
2011-11-04,2011,November,10,Friday,Winter,Cloudy,134,115,19
2011-11-04,2011,November,11,Friday,Winter,Cloudy,162,128,34
2011-11-04,2011,November,12,Friday,Winter,Cloudy,197,153,44
2011-11-04,2011,November,13,Friday,Winter,Clear,194,161,33
2011-11-04,2011,November,14,Friday,Winter,Clear,201,147,54
2011-11-04,2011,November,15,Friday,Winter,Clear,237,192,45
2011-11-04,2011,November,16,Friday,Winter,Clear,290,237,53
2011-11-04,2011,November,17,Friday,Winter,Clear,480,438,42
2011-11-04,2011,November,18,Friday,Winter,Clear,374,339,35
2011-11-04,2011,November,19,Friday,Winter,Clear,196,182,14
2011-11-04,2011,November,20,Friday,Winter,Clear,186,171,15
2011-11-04,2011,November,21,Friday,Winter,Clear,123,115,8
2011-11-04,2011,November,22,Friday,Winter,Clear,115,109,6
2011-11-04,2011,November,23,Friday,Winter,Clear,89,72,17
2011-11-05,2011,November,0,Saturday,Winter,Clear,52,48,4
2011-11-05,2011,November,1,Saturday,Winter,Clear,62,57,5
2011-11-05,2011,November,2,Saturday,Winter,Clear,31,24,7
2011-11-05,2011,November,3,Saturday,Winter,Clear,8,8,0
2011-11-05,2011,November,4,Saturday,Winter,Clear,8,5,3
2011-11-05,2011,November,5,Saturday,Winter,Clear,2,2,0
2011-11-05,2011,November,6,Saturday,Winter,Clear,23,20,3
2011-11-05,2011,November,7,Saturday,Winter,Clear,34,31,3
2011-11-05,2011,November,8,Saturday,Winter,Clear,84,80,4
2011-11-05,2011,November,9,Saturday,Winter,Clear,141,111,30
2011-11-05,2011,November,10,Saturday,Winter,Clear,227,171,56
2011-11-05,2011,November,11,Saturday,Winter,Clear,238,169,69
2011-11-05,2011,November,12,Saturday,Winter,Clear,372,235,137
2011-11-05,2011,November,13,Saturday,Winter,Clear,355,207,148
2011-11-05,2011,November,14,Saturday,Winter,Clear,386,227,159
2011-11-05,2011,November,15,Saturday,Winter,Clear,343,202,141
2011-11-05,2011,November,16,Saturday,Winter,Clear,335,207,128
2011-11-05,2011,November,17,Saturday,Winter,Clear,334,234,100
2011-11-05,2011,November,18,Saturday,Winter,Clear,237,185,52
2011-11-05,2011,November,19,Saturday,Winter,Clear,204,159,45
2011-11-05,2011,November,20,Saturday,Winter,Clear,165,136,29
2011-11-05,2011,November,21,Saturday,Winter,Clear,118,99,19
2011-11-05,2011,November,22,Saturday,Winter,Clear,82,72,10
2011-11-05,2011,November,23,Saturday,Winter,Clear,85,81,4
2011-11-06,2011,November,0,Sunday,Winter,Clear,75,65,10
2011-11-06,2011,November,1,Sunday,Winter,Clear,115,104,11
2011-11-06,2011,November,2,Sunday,Winter,Clear,29,23,6
2011-11-06,2011,November,3,Sunday,Winter,Clear,9,4,5
2011-11-06,2011,November,4,Sunday,Winter,Clear,6,6,0
2011-11-06,2011,November,5,Sunday,Winter,Clear,5,5,0
2011-11-06,2011,November,6,Sunday,Winter,Clear,16,11,5
2011-11-06,2011,November,7,Sunday,Winter,Clear,28,24,4
2011-11-06,2011,November,8,Sunday,Winter,Cloudy,90,71,19
2011-11-06,2011,November,9,Sunday,Winter,Cloudy,170,134,36
2011-11-06,2011,November,10,Sunday,Winter,Clear,262,186,76
2011-11-06,2011,November,11,Sunday,Winter,Clear,320,216,104
2011-11-06,2011,November,12,Sunday,Winter,Clear,346,226,120
2011-11-06,2011,November,13,Sunday,Winter,Clear,314,209,105
2011-11-06,2011,November,14,Sunday,Winter,Clear,320,219,101
2011-11-06,2011,November,15,Sunday,Winter,Clear,306,210,96
2011-11-06,2011,November,16,Sunday,Winter,Clear,347,263,84
2011-11-06,2011,November,17,Sunday,Winter,Clear,256,185,71
2011-11-06,2011,November,18,Sunday,Winter,Clear,185,146,39
2011-11-06,2011,November,19,Sunday,Winter,Clear,151,130,21
2011-11-06,2011,November,20,Sunday,Winter,Clear,116,100,16
2011-11-06,2011,November,21,Sunday,Winter,Clear,88,77,11
2011-11-06,2011,November,22,Sunday,Winter,Clear,45,40,5
2011-11-06,2011,November,23,Sunday,Winter,Clear,50,43,7
2011-11-07,2011,November,0,Monday,Winter,Clear,15,14,1
2011-11-07,2011,November,1,Monday,Winter,Clear,8,6,2
2011-11-07,2011,November,2,Monday,Winter,Clear,2,2,0
2011-11-07,2011,November,3,Monday,Winter,Clear,3,3,0
2011-11-07,2011,November,4,Monday,Winter,Clear,6,4,2
2011-11-07,2011,November,5,Monday,Winter,Clear,26,25,1
2011-11-07,2011,November,6,Monday,Winter,Cloudy,99,97,2
2011-11-07,2011,November,7,Monday,Winter,Cloudy,311,305,6
2011-11-07,2011,November,8,Monday,Winter,Cloudy,410,397,13
2011-11-07,2011,November,9,Monday,Winter,Cloudy,174,156,18
2011-11-07,2011,November,10,Monday,Winter,Clear,123,95,28
2011-11-07,2011,November,11,Monday,Winter,Clear,128,100,28
2011-11-07,2011,November,12,Monday,Winter,Clear,179,158,21
2011-11-07,2011,November,13,Monday,Winter,Clear,189,157,32
2011-11-07,2011,November,14,Monday,Winter,Clear,145,115,30
2011-11-07,2011,November,15,Monday,Winter,Clear,170,132,38
2011-11-07,2011,November,16,Monday,Winter,Clear,295,255,40
2011-11-07,2011,November,17,Monday,Winter,Clear,528,489,39
2011-11-07,2011,November,18,Monday,Winter,Clear,425,407,18
2011-11-07,2011,November,19,Monday,Winter,Clear,300,280,20
2011-11-07,2011,November,20,Monday,Winter,Clear,204,187,17
2011-11-07,2011,November,21,Monday,Winter,Clear,139,129,10
2011-11-07,2011,November,22,Monday,Winter,Clear,108,102,6
2011-11-07,2011,November,23,Monday,Winter,Clear,48,47,1
2011-11-08,2011,November,0,Tuesday,Winter,Clear,18,18,0
2011-11-08,2011,November,1,Tuesday,Winter,Clear,11,8,3
2011-11-08,2011,November,2,Tuesday,Winter,Clear,1,1,0
2011-11-08,2011,November,3,Tuesday,Winter,Clear,3,3,0
2011-11-08,2011,November,4,Tuesday,Winter,Clear,4,4,0
2011-11-08,2011,November,5,Tuesday,Winter,Clear,18,17,1
2011-11-08,2011,November,6,Tuesday,Winter,Clear,99,96,3
2011-11-08,2011,November,7,Tuesday,Winter,Clear,323,316,7
2011-11-08,2011,November,8,Tuesday,Winter,Clear,466,455,11
2011-11-08,2011,November,9,Tuesday,Winter,Clear,191,177,14
2011-11-08,2011,November,10,Tuesday,Winter,Clear,129,104,25
2011-11-08,2011,November,11,Tuesday,Winter,Clear,147,126,21
2011-11-08,2011,November,12,Tuesday,Winter,Clear,203,175,28
2011-11-08,2011,November,13,Tuesday,Winter,Clear,196,165,31
2011-11-08,2011,November,14,Tuesday,Winter,Clear,161,129,32
2011-11-08,2011,November,15,Tuesday,Winter,Clear,188,155,33
2011-11-08,2011,November,16,Tuesday,Winter,Clear,289,250,39
2011-11-08,2011,November,17,Tuesday,Winter,Clear,499,459,40
2011-11-08,2011,November,18,Tuesday,Winter,Clear,462,432,30
2011-11-08,2011,November,19,Tuesday,Winter,Clear,278,264,14
2011-11-08,2011,November,20,Tuesday,Winter,Clear,181,169,12
2011-11-08,2011,November,21,Tuesday,Winter,Clear,182,166,16
2011-11-08,2011,November,22,Tuesday,Winter,Clear,108,95,13
2011-11-08,2011,November,23,Tuesday,Winter,Clear,48,45,3
2011-11-09,2011,November,0,Wednesday,Winter,Clear,13,13,0
2011-11-09,2011,November,1,Wednesday,Winter,Clear,10,10,0
2011-11-09,2011,November,2,Wednesday,Winter,Clear,5,5,0
2011-11-09,2011,November,3,Wednesday,Winter,Clear,4,4,0
2011-11-09,2011,November,4,Wednesday,Winter,Clear,4,4,0
2011-11-09,2011,November,5,Wednesday,Winter,Clear,28,28,0
2011-11-09,2011,November,6,Wednesday,Winter,Clear,98,98,0
2011-11-09,2011,November,7,Wednesday,Winter,Clear,300,300,0
2011-11-09,2011,November,8,Wednesday,Winter,Clear,456,437,19
2011-11-09,2011,November,9,Wednesday,Winter,Clear,219,197,22
2011-11-09,2011,November,10,Wednesday,Winter,Clear,105,89,16
2011-11-09,2011,November,11,Wednesday,Winter,Clear,152,131,21
2011-11-09,2011,November,12,Wednesday,Winter,Clear,180,156,24
2011-11-09,2011,November,13,Wednesday,Winter,Clear,167,136,31
2011-11-09,2011,November,14,Wednesday,Winter,Clear,179,153,26
2011-11-09,2011,November,15,Wednesday,Winter,Clear,151,130,21
2011-11-09,2011,November,16,Wednesday,Winter,Clear,281,257,24
2011-11-09,2011,November,17,Wednesday,Winter,Clear,485,458,27
2011-11-09,2011,November,18,Wednesday,Winter,Clear,408,387,21
2011-11-09,2011,November,19,Wednesday,Winter,Clear,304,292,12
2011-11-09,2011,November,20,Wednesday,Winter,Clear,219,201,18
2011-11-09,2011,November,21,Wednesday,Winter,Clear,161,152,9
2011-11-09,2011,November,22,Wednesday,Winter,Clear,114,105,9
2011-11-09,2011,November,23,Wednesday,Winter,Clear,66,61,5
2011-11-10,2011,November,0,Thursday,Winter,Clear,24,24,0
2011-11-10,2011,November,1,Thursday,Winter,Cloudy,11,10,1
2011-11-10,2011,November,2,Thursday,Winter,Cloudy,5,5,0
2011-11-10,2011,November,3,Thursday,Winter,Clear,11,11,0
2011-11-10,2011,November,4,Thursday,Winter,Clear,3,2,1
2011-11-10,2011,November,5,Thursday,Winter,Cloudy,23,22,1
2011-11-10,2011,November,6,Thursday,Winter,Cloudy,114,110,4
2011-11-10,2011,November,7,Thursday,Winter,Cloudy,272,266,6
2011-11-10,2011,November,8,Thursday,Winter,Cloudy,436,418,18
2011-11-10,2011,November,9,Thursday,Winter,Cloudy,211,188,23
2011-11-10,2011,November,10,Thursday,Winter,Cloudy,117,100,17
2011-11-10,2011,November,11,Thursday,Winter,Cloudy,108,99,9
2011-11-10,2011,November,12,Thursday,Winter,Cloudy,167,149,18
2011-11-10,2011,November,13,Thursday,Winter,Light Snow/Rain,96,87,9
2011-11-10,2011,November,14,Thursday,Winter,Light Snow/Rain,64,58,6
2011-11-10,2011,November,15,Thursday,Winter,Light Snow/Rain,62,57,5
2011-11-10,2011,November,16,Thursday,Winter,Light Snow/Rain,73,67,6
2011-11-10,2011,November,17,Thursday,Winter,Light Snow/Rain,177,168,9
2011-11-10,2011,November,18,Thursday,Winter,Cloudy,273,263,10
2011-11-10,2011,November,19,Thursday,Winter,Cloudy,211,192,19
2011-11-10,2011,November,20,Thursday,Winter,Cloudy,168,160,8
2011-11-10,2011,November,21,Thursday,Winter,Clear,136,130,6
2011-11-10,2011,November,22,Thursday,Winter,Clear,89,84,5
2011-11-10,2011,November,23,Thursday,Winter,Cloudy,82,73,9
2011-11-11,2011,November,0,Friday,Winter,Clear,66,56,10
2011-11-11,2011,November,1,Friday,Winter,Clear,19,16,3
2011-11-11,2011,November,2,Friday,Winter,Clear,11,10,1
2011-11-11,2011,November,3,Friday,Winter,Clear,6,6,0
2011-11-11,2011,November,4,Friday,Winter,Clear,8,8,0
2011-11-11,2011,November,5,Friday,Winter,Clear,13,13,0
2011-11-11,2011,November,6,Friday,Winter,Clear,46,46,0
2011-11-11,2011,November,7,Friday,Winter,Clear,121,116,5
2011-11-11,2011,November,8,Friday,Winter,Clear,258,249,9
2011-11-11,2011,November,9,Friday,Winter,Clear,201,186,15
2011-11-11,2011,November,10,Friday,Winter,Clear,200,162,38
2011-11-11,2011,November,11,Friday,Winter,Clear,170,150,20
2011-11-11,2011,November,12,Friday,Winter,Clear,239,198,41
2011-11-11,2011,November,13,Friday,Winter,Clear,236,179,57
2011-11-11,2011,November,14,Friday,Winter,Clear,247,183,64
2011-11-11,2011,November,15,Friday,Winter,Clear,216,187,29
2011-11-11,2011,November,16,Friday,Winter,Clear,238,189,49
2011-11-11,2011,November,17,Friday,Winter,Clear,310,286,24
2011-11-11,2011,November,18,Friday,Winter,Clear,208,185,23
2011-11-11,2011,November,19,Friday,Winter,Clear,199,182,17
2011-11-11,2011,November,20,Friday,Winter,Clear,109,97,12
2011-11-11,2011,November,21,Friday,Winter,Clear,83,79,4
2011-11-11,2011,November,22,Friday,Winter,Clear,91,78,13
2011-11-11,2011,November,23,Friday,Winter,Clear,73,67,6
2011-11-12,2011,November,0,Saturday,Winter,Clear,64,52,12
2011-11-12,2011,November,1,Saturday,Winter,Clear,54,45,9
2011-11-12,2011,November,2,Saturday,Winter,Clear,46,39,7
2011-11-12,2011,November,3,Saturday,Winter,Clear,17,13,4
2011-11-12,2011,November,4,Saturday,Winter,Clear,7,7,0
2011-11-12,2011,November,5,Saturday,Winter,Clear,4,3,1
2011-11-12,2011,November,6,Saturday,Winter,Clear,7,7,0
2011-11-12,2011,November,7,Saturday,Winter,Clear,27,24,3
2011-11-12,2011,November,8,Saturday,Winter,Clear,101,87,14
2011-11-12,2011,November,9,Saturday,Winter,Clear,160,142,18
2011-11-12,2011,November,10,Saturday,Winter,Clear,232,170,62
2011-11-12,2011,November,11,Saturday,Winter,Clear,315,213,102
2011-11-12,2011,November,12,Saturday,Winter,Clear,366,224,142
2011-11-12,2011,November,13,Saturday,Winter,Clear,353,225,128
2011-11-12,2011,November,14,Saturday,Winter,Clear,435,244,191
2011-11-12,2011,November,15,Saturday,Winter,Clear,386,221,165
2011-11-12,2011,November,16,Saturday,Winter,Clear,361,224,137
2011-11-12,2011,November,17,Saturday,Winter,Clear,285,193,92
2011-11-12,2011,November,18,Saturday,Winter,Clear,203,150,53
2011-11-12,2011,November,19,Saturday,Winter,Clear,171,139,32
2011-11-12,2011,November,20,Saturday,Winter,Clear,132,101,31
2011-11-12,2011,November,21,Saturday,Winter,Clear,122,103,19
2011-11-12,2011,November,22,Saturday,Winter,Clear,118,88,30
2011-11-12,2011,November,23,Saturday,Winter,Clear,101,78,23
2011-11-13,2011,November,0,Sunday,Winter,Cloudy,73,61,12
2011-11-13,2011,November,1,Sunday,Winter,Cloudy,71,58,13
2011-11-13,2011,November,2,Sunday,Winter,Clear,57,48,9
2011-11-13,2011,November,3,Sunday,Winter,Cloudy,28,20,8
2011-11-13,2011,November,4,Sunday,Winter,Cloudy,6,5,1
2011-11-13,2011,November,5,Sunday,Winter,Clear,5,3,2
2011-11-13,2011,November,6,Sunday,Winter,Clear,23,18,5
2011-11-13,2011,November,7,Sunday,Winter,Clear,43,30,13
2011-11-13,2011,November,8,Sunday,Winter,Clear,79,55,24
2011-11-13,2011,November,9,Sunday,Winter,Clear,135,97,38
2011-11-13,2011,November,10,Sunday,Winter,Clear,241,178,63
2011-11-13,2011,November,11,Sunday,Winter,Clear,295,187,108
2011-11-13,2011,November,12,Sunday,Winter,Cloudy,354,242,112
2011-11-13,2011,November,13,Sunday,Winter,Cloudy,339,234,105
2011-11-13,2011,November,14,Sunday,Winter,Cloudy,371,263,108
2011-11-13,2011,November,15,Sunday,Winter,Cloudy,310,221,89
2011-11-13,2011,November,16,Sunday,Winter,Cloudy,319,226,93
2011-11-13,2011,November,17,Sunday,Winter,Clear,231,187,44
2011-11-13,2011,November,18,Sunday,Winter,Clear,190,155,35
2011-11-13,2011,November,19,Sunday,Winter,Clear,157,121,36
2011-11-13,2011,November,20,Sunday,Winter,Clear,139,115,24
2011-11-13,2011,November,21,Sunday,Winter,Clear,95,76,19
2011-11-13,2011,November,22,Sunday,Winter,Clear,89,64,25
2011-11-13,2011,November,23,Sunday,Winter,Clear,67,49,18
2011-11-14,2011,November,0,Monday,Winter,Clear,30,22,8
2011-11-14,2011,November,1,Monday,Winter,Clear,11,6,5
2011-11-14,2011,November,2,Monday,Winter,Clear,17,10,7
2011-11-14,2011,November,3,Monday,Winter,Clear,7,3,4
2011-11-14,2011,November,4,Monday,Winter,Clear,5,5,0
2011-11-14,2011,November,5,Monday,Winter,Cloudy,19,19,0
2011-11-14,2011,November,6,Monday,Winter,Cloudy,114,104,10
2011-11-14,2011,November,7,Monday,Winter,Clear,322,311,11
2011-11-14,2011,November,8,Monday,Winter,Cloudy,452,425,27
2011-11-14,2011,November,9,Monday,Winter,Cloudy,233,204,29
2011-11-14,2011,November,10,Monday,Winter,Cloudy,111,85,26
2011-11-14,2011,November,11,Monday,Winter,Cloudy,128,106,22
2011-11-14,2011,November,12,Monday,Winter,Clear,202,166,36
2011-11-14,2011,November,13,Monday,Winter,Clear,203,153,50
2011-11-14,2011,November,14,Monday,Winter,Clear,185,138,47
2011-11-14,2011,November,15,Monday,Winter,Clear,195,142,53
2011-11-14,2011,November,16,Monday,Winter,Clear,315,264,51
2011-11-14,2011,November,17,Monday,Winter,Clear,519,464,55
2011-11-14,2011,November,18,Monday,Winter,Clear,489,460,29
2011-11-14,2011,November,19,Monday,Winter,Clear,302,274,28
2011-11-14,2011,November,20,Monday,Winter,Clear,240,210,30
2011-11-14,2011,November,21,Monday,Winter,Clear,213,176,37
2011-11-14,2011,November,22,Monday,Winter,Clear,113,96,17
2011-11-14,2011,November,23,Monday,Winter,Clear,61,48,13
2011-11-15,2011,November,0,Tuesday,Winter,Clear,22,15,7
2011-11-15,2011,November,1,Tuesday,Winter,Clear,10,5,5
2011-11-15,2011,November,2,Tuesday,Winter,Clear,15,8,7
2011-11-15,2011,November,3,Tuesday,Winter,Cloudy,4,4,0
2011-11-15,2011,November,4,Tuesday,Winter,Clear,7,6,1
2011-11-15,2011,November,5,Tuesday,Winter,Clear,28,26,2
2011-11-15,2011,November,6,Tuesday,Winter,Cloudy,108,104,4
2011-11-15,2011,November,7,Tuesday,Winter,Cloudy,319,298,21
2011-11-15,2011,November,8,Tuesday,Winter,Cloudy,480,453,27
2011-11-15,2011,November,9,Tuesday,Winter,Cloudy,200,174,26
2011-11-15,2011,November,10,Tuesday,Winter,Cloudy,138,115,23
2011-11-15,2011,November,11,Tuesday,Winter,Cloudy,134,116,18
2011-11-15,2011,November,12,Tuesday,Winter,Cloudy,176,148,28
2011-11-15,2011,November,13,Tuesday,Winter,Light Snow/Rain,153,132,21
2011-11-15,2011,November,14,Tuesday,Winter,Cloudy,147,120,27
2011-11-15,2011,November,15,Tuesday,Winter,Cloudy,191,155,36
2011-11-15,2011,November,16,Tuesday,Winter,Cloudy,271,240,31
2011-11-15,2011,November,17,Tuesday,Winter,Cloudy,451,422,29
2011-11-15,2011,November,18,Tuesday,Winter,Cloudy,441,414,27
2011-11-15,2011,November,19,Tuesday,Winter,Cloudy,286,259,27
2011-11-15,2011,November,20,Tuesday,Winter,Cloudy,238,212,26
2011-11-15,2011,November,21,Tuesday,Winter,Cloudy,168,145,23
2011-11-15,2011,November,22,Tuesday,Winter,Cloudy,128,109,19
2011-11-15,2011,November,23,Tuesday,Winter,Cloudy,80,66,14
2011-11-16,2011,November,0,Wednesday,Winter,Cloudy,31,26,5
2011-11-16,2011,November,1,Wednesday,Winter,Light Snow/Rain,5,5,0
2011-11-16,2011,November,2,Wednesday,Winter,Cloudy,10,6,4
2011-11-16,2011,November,3,Wednesday,Winter,Cloudy,5,3,2
2011-11-16,2011,November,4,Wednesday,Winter,Cloudy,4,3,1
2011-11-16,2011,November,5,Wednesday,Winter,Light Snow/Rain,13,13,0
2011-11-16,2011,November,6,Wednesday,Winter,Cloudy,56,52,4
2011-11-16,2011,November,7,Wednesday,Winter,Light Snow/Rain,137,130,7
2011-11-16,2011,November,8,Wednesday,Winter,Light Snow/Rain,232,223,9
2011-11-16,2011,November,9,Wednesday,Winter,Light Snow/Rain,82,77,5
2011-11-16,2011,November,10,Wednesday,Winter,Light Snow/Rain,36,32,4
2011-11-16,2011,November,11,Wednesday,Winter,Light Snow/Rain,60,53,7
2011-11-16,2011,November,12,Wednesday,Winter,Light Snow/Rain,54,49,5
2011-11-16,2011,November,13,Wednesday,Winter,Light Snow/Rain,58,52,6
2011-11-16,2011,November,14,Wednesday,Winter,Cloudy,61,49,12
2011-11-16,2011,November,15,Wednesday,Winter,Light Snow/Rain,66,50,16
2011-11-16,2011,November,16,Wednesday,Winter,Light Snow/Rain,123,110,13
2011-11-16,2011,November,17,Wednesday,Winter,Cloudy,233,216,17
2011-11-16,2011,November,18,Wednesday,Winter,Light Snow/Rain,189,176,13
2011-11-16,2011,November,19,Wednesday,Winter,Light Snow/Rain,111,108,3
2011-11-16,2011,November,20,Wednesday,Winter,Light Snow/Rain,99,94,5
2011-11-16,2011,November,21,Wednesday,Winter,Light Snow/Rain,75,72,3
2011-11-16,2011,November,22,Wednesday,Winter,Light Snow/Rain,46,45,1
2011-11-16,2011,November,23,Wednesday,Winter,Light Snow/Rain,31,28,3
2011-11-17,2011,November,0,Thursday,Winter,Cloudy,24,22,2
2011-11-17,2011,November,1,Thursday,Winter,Cloudy,5,5,0
2011-11-17,2011,November,2,Thursday,Winter,Cloudy,5,5,0
2011-11-17,2011,November,3,Thursday,Winter,Cloudy,3,3,0
2011-11-17,2011,November,4,Thursday,Winter,Cloudy,4,3,1
2011-11-17,2011,November,5,Thursday,Winter,Light Snow/Rain,22,21,1
2011-11-17,2011,November,6,Thursday,Winter,Light Snow/Rain,75,72,3
2011-11-17,2011,November,7,Thursday,Winter,Light Snow/Rain,168,164,4
2011-11-17,2011,November,8,Thursday,Winter,Light Snow/Rain,355,343,12
2011-11-17,2011,November,9,Thursday,Winter,Cloudy,198,184,14
2011-11-17,2011,November,10,Thursday,Winter,Cloudy,81,74,7
2011-11-17,2011,November,11,Thursday,Winter,Light Snow/Rain,97,93,4
2011-11-17,2011,November,12,Thursday,Winter,Cloudy,121,115,6
2011-11-17,2011,November,13,Thursday,Winter,Cloudy,124,109,15
2011-11-17,2011,November,14,Thursday,Winter,Cloudy,110,105,5
2011-11-17,2011,November,15,Thursday,Winter,Cloudy,116,106,10
2011-11-17,2011,November,16,Thursday,Winter,Clear,195,187,8
2011-11-17,2011,November,17,Thursday,Winter,Clear,399,379,20
2011-11-17,2011,November,18,Thursday,Winter,Clear,307,298,9
2011-11-17,2011,November,19,Thursday,Winter,Clear,217,210,7
2011-11-17,2011,November,20,Thursday,Winter,Clear,169,162,7
2011-11-17,2011,November,21,Thursday,Winter,Clear,116,113,3
2011-11-17,2011,November,22,Thursday,Winter,Clear,84,83,1
2011-11-17,2011,November,23,Thursday,Winter,Clear,58,58,0
2011-11-18,2011,November,0,Friday,Winter,Clear,30,28,2
2011-11-18,2011,November,1,Friday,Winter,Clear,10,10,0
2011-11-18,2011,November,2,Friday,Winter,Clear,10,8,2
2011-11-18,2011,November,3,Friday,Winter,Clear,2,2,0
2011-11-18,2011,November,4,Friday,Winter,Clear,5,5,0
2011-11-18,2011,November,5,Friday,Winter,Clear,22,22,0
2011-11-18,2011,November,6,Friday,Winter,Clear,71,70,1
2011-11-18,2011,November,7,Friday,Winter,Clear,216,211,5
2011-11-18,2011,November,8,Friday,Winter,Clear,375,369,6
2011-11-18,2011,November,9,Friday,Winter,Clear,213,207,6
2011-11-18,2011,November,10,Friday,Winter,Clear,115,105,10
2011-11-18,2011,November,11,Friday,Winter,Clear,140,122,18
2011-11-18,2011,November,12,Friday,Winter,Clear,165,143,22
2011-11-18,2011,November,13,Friday,Winter,Clear,177,146,31
2011-11-18,2011,November,14,Friday,Winter,Clear,154,123,31
2011-11-18,2011,November,15,Friday,Winter,Clear,178,151,27
2011-11-18,2011,November,16,Friday,Winter,Clear,209,190,19
2011-11-18,2011,November,17,Friday,Winter,Clear,378,361,17
2011-11-18,2011,November,18,Friday,Winter,Clear,328,312,16
2011-11-18,2011,November,19,Friday,Winter,Clear,190,183,7
2011-11-18,2011,November,20,Friday,Winter,Clear,137,129,8
2011-11-18,2011,November,21,Friday,Winter,Clear,111,108,3
2011-11-18,2011,November,22,Friday,Winter,Clear,97,88,9
2011-11-18,2011,November,23,Friday,Winter,Clear,59,54,5
2011-11-19,2011,November,0,Saturday,Winter,Clear,53,49,4
2011-11-19,2011,November,1,Saturday,Winter,Clear,35,34,1
2011-11-19,2011,November,2,Saturday,Winter,Clear,46,34,12
2011-11-19,2011,November,3,Saturday,Winter,Clear,15,11,4
2011-11-19,2011,November,4,Saturday,Winter,Clear,8,4,4
2011-11-19,2011,November,5,Saturday,Winter,Clear,2,2,0
2011-11-19,2011,November,6,Saturday,Winter,Clear,12,10,2
2011-11-19,2011,November,7,Saturday,Winter,Clear,41,38,3
2011-11-19,2011,November,8,Saturday,Winter,Clear,92,80,12
2011-11-19,2011,November,9,Saturday,Winter,Clear,142,130,12
2011-11-19,2011,November,10,Saturday,Winter,Clear,200,165,35
2011-11-19,2011,November,11,Saturday,Winter,Clear,233,183,50
2011-11-19,2011,November,12,Saturday,Winter,Clear,311,218,93
2011-11-19,2011,November,13,Saturday,Winter,Clear,363,245,118
2011-11-19,2011,November,14,Saturday,Winter,Clear,349,228,121
2011-11-19,2011,November,15,Saturday,Winter,Clear,382,262,120
2011-11-19,2011,November,16,Saturday,Winter,Clear,287,188,99
2011-11-19,2011,November,17,Saturday,Winter,Clear,232,171,61
2011-11-19,2011,November,18,Saturday,Winter,Clear,208,172,36
2011-11-19,2011,November,19,Saturday,Winter,Cloudy,182,149,33
2011-11-19,2011,November,20,Saturday,Winter,Cloudy,163,115,48
2011-11-19,2011,November,21,Saturday,Winter,Cloudy,108,79,29
2011-11-19,2011,November,22,Saturday,Winter,Cloudy,106,80,26
2011-11-19,2011,November,23,Saturday,Winter,Clear,93,73,20
2011-11-20,2011,November,0,Sunday,Winter,Clear,93,79,14
2011-11-20,2011,November,1,Sunday,Winter,Clear,84,73,11
2011-11-20,2011,November,2,Sunday,Winter,Clear,56,44,12
2011-11-20,2011,November,3,Sunday,Winter,Cloudy,37,31,6
2011-11-20,2011,November,4,Sunday,Winter,Cloudy,12,10,2
2011-11-20,2011,November,5,Sunday,Winter,Cloudy,4,4,0
2011-11-20,2011,November,6,Sunday,Winter,Cloudy,9,6,3
2011-11-20,2011,November,7,Sunday,Winter,Clear,23,19,4
2011-11-20,2011,November,8,Sunday,Winter,Cloudy,65,52,13
2011-11-20,2011,November,9,Sunday,Winter,Clear,138,109,29
2011-11-20,2011,November,10,Sunday,Winter,Cloudy,229,183,46
2011-11-20,2011,November,11,Sunday,Winter,Cloudy,286,212,74
2011-11-20,2011,November,12,Sunday,Winter,Cloudy,304,234,70
2011-11-20,2011,November,13,Sunday,Winter,Cloudy,369,285,84
2011-11-20,2011,November,14,Sunday,Winter,Clear,363,250,113
2011-11-20,2011,November,15,Sunday,Winter,Cloudy,351,242,109
2011-11-20,2011,November,16,Sunday,Winter,Cloudy,306,225,81
2011-11-20,2011,November,17,Sunday,Winter,Cloudy,203,168,35
2011-11-20,2011,November,18,Sunday,Winter,Cloudy,145,123,22
2011-11-20,2011,November,19,Sunday,Winter,Cloudy,157,140,17
2011-11-20,2011,November,20,Sunday,Winter,Cloudy,113,90,23
2011-11-20,2011,November,21,Sunday,Winter,Cloudy,105,94,11
2011-11-20,2011,November,22,Sunday,Winter,Light Snow/Rain,40,35,5
2011-11-20,2011,November,23,Sunday,Winter,Light Snow/Rain,28,25,3
2011-11-21,2011,November,0,Monday,Winter,Cloudy,17,13,4
2011-11-21,2011,November,1,Monday,Winter,Light Snow/Rain,12,8,4
2011-11-21,2011,November,2,Monday,Winter,Light Snow/Rain,3,2,1
2011-11-21,2011,November,3,Monday,Winter,Light Snow/Rain,4,4,0
2011-11-21,2011,November,4,Monday,Winter,Light Snow/Rain,5,5,0
2011-11-21,2011,November,5,Monday,Winter,Cloudy,20,20,0
2011-11-21,2011,November,6,Monday,Winter,Cloudy,76,76,0
2011-11-21,2011,November,7,Monday,Winter,Cloudy,246,229,17
2011-11-21,2011,November,8,Monday,Winter,Cloudy,391,378,13
2011-11-21,2011,November,9,Monday,Winter,Cloudy,237,222,15
2011-11-21,2011,November,10,Monday,Winter,Cloudy,135,110,25
2011-11-21,2011,November,11,Monday,Winter,Cloudy,128,112,16
2011-11-21,2011,November,12,Monday,Winter,Cloudy,162,138,24
2011-11-21,2011,November,13,Monday,Winter,Cloudy,134,121,13
2011-11-21,2011,November,14,Monday,Winter,Cloudy,135,121,14
2011-11-21,2011,November,15,Monday,Winter,Light Snow/Rain,108,93,15
2011-11-21,2011,November,16,Monday,Winter,Light Snow/Rain,108,95,13
2011-11-21,2011,November,17,Monday,Winter,Light Snow/Rain,210,200,10
2011-11-21,2011,November,18,Monday,Winter,Light Snow/Rain,192,184,8
2011-11-21,2011,November,19,Monday,Winter,Light Snow/Rain,137,135,2
2011-11-21,2011,November,20,Monday,Winter,Light Snow/Rain,80,75,5
2011-11-21,2011,November,21,Monday,Winter,Light Snow/Rain,114,103,11
2011-11-21,2011,November,22,Monday,Winter,Light Snow/Rain,78,72,6
2011-11-21,2011,November,23,Monday,Winter,Light Snow/Rain,33,29,4
2011-11-22,2011,November,0,Tuesday,Winter,Light Snow/Rain,14,14,0
2011-11-22,2011,November,1,Tuesday,Winter,Light Snow/Rain,6,5,1
2011-11-22,2011,November,2,Tuesday,Winter,Light Snow/Rain,6,4,2
2011-11-22,2011,November,3,Tuesday,Winter,Light Snow/Rain,3,2,1
2011-11-22,2011,November,4,Tuesday,Winter,Light Snow/Rain,7,7,0
2011-11-22,2011,November,5,Tuesday,Winter,Light Snow/Rain,18,17,1
2011-11-22,2011,November,6,Tuesday,Winter,Cloudy,64,63,1
2011-11-22,2011,November,7,Tuesday,Winter,Light Snow/Rain,121,119,2
2011-11-22,2011,November,8,Tuesday,Winter,Light Snow/Rain,190,185,5
2011-11-22,2011,November,9,Tuesday,Winter,Light Snow/Rain,149,147,2
2011-11-22,2011,November,10,Tuesday,Winter,Light Snow/Rain,52,46,6
2011-11-22,2011,November,11,Tuesday,Winter,Light Snow/Rain,32,28,4
2011-11-22,2011,November,12,Tuesday,Winter,Light Snow/Rain,21,18,3
2011-11-22,2011,November,13,Tuesday,Winter,Light Snow/Rain,26,22,4
2011-11-22,2011,November,14,Tuesday,Winter,Light Snow/Rain,35,31,4
2011-11-22,2011,November,15,Tuesday,Winter,Light Snow/Rain,34,32,2
2011-11-22,2011,November,16,Tuesday,Winter,Light Snow/Rain,62,59,3
2011-11-22,2011,November,17,Tuesday,Winter,Light Snow/Rain,165,161,4
2011-11-22,2011,November,18,Tuesday,Winter,Light Snow/Rain,148,148,0
2011-11-22,2011,November,19,Tuesday,Winter,Light Snow/Rain,111,106,5
2011-11-22,2011,November,20,Tuesday,Winter,Cloudy,127,121,6
2011-11-22,2011,November,21,Tuesday,Winter,Cloudy,90,86,4
2011-11-22,2011,November,22,Tuesday,Winter,Cloudy,87,81,6
2011-11-22,2011,November,23,Tuesday,Winter,Cloudy,39,36,3
2011-11-23,2011,November,0,Wednesday,Winter,Cloudy,16,14,2
2011-11-23,2011,November,1,Wednesday,Winter,Cloudy,8,8,0
2011-11-23,2011,November,2,Wednesday,Winter,Light Snow/Rain,6,5,1
2011-11-23,2011,November,3,Wednesday,Winter,Light Snow/Rain,3,2,1
2011-11-23,2011,November,4,Wednesday,Winter,Light Snow/Rain,5,5,0
2011-11-23,2011,November,5,Wednesday,Winter,Cloudy,17,16,1
2011-11-23,2011,November,6,Wednesday,Winter,Cloudy,69,68,1
2011-11-23,2011,November,7,Wednesday,Winter,Cloudy,156,154,2
2011-11-23,2011,November,8,Wednesday,Winter,Cloudy,323,316,7
2011-11-23,2011,November,9,Wednesday,Winter,Cloudy,167,164,3
2011-11-23,2011,November,10,Wednesday,Winter,Cloudy,76,70,6
2011-11-23,2011,November,11,Wednesday,Winter,Cloudy,116,107,9
2011-11-23,2011,November,12,Wednesday,Winter,Clear,160,151,9
2011-11-23,2011,November,13,Wednesday,Winter,Cloudy,174,162,12
2011-11-23,2011,November,14,Wednesday,Winter,Clear,213,200,13
2011-11-23,2011,November,15,Wednesday,Winter,Cloudy,207,194,13
2011-11-23,2011,November,16,Wednesday,Winter,Cloudy,173,169,4
2011-11-23,2011,November,17,Wednesday,Winter,Light Snow/Rain,163,156,7
2011-11-23,2011,November,18,Wednesday,Winter,Cloudy,145,138,7
2011-11-23,2011,November,19,Wednesday,Winter,Clear,122,116,6
2011-11-23,2011,November,20,Wednesday,Winter,Clear,68,67,1
2011-11-23,2011,November,21,Wednesday,Winter,Clear,66,66,0
2011-11-23,2011,November,22,Wednesday,Winter,Clear,62,59,3
2011-11-23,2011,November,23,Wednesday,Winter,Clear,51,47,4
2011-11-24,2011,November,0,Thursday,Winter,Clear,23,22,1
2011-11-24,2011,November,1,Thursday,Winter,Clear,24,23,1
2011-11-24,2011,November,2,Thursday,Winter,Clear,22,19,3
2011-11-24,2011,November,3,Thursday,Winter,Clear,5,4,1
2011-11-24,2011,November,4,Thursday,Winter,Clear,2,1,1
2011-11-24,2011,November,5,Thursday,Winter,Clear,11,10,1
2011-11-24,2011,November,6,Thursday,Winter,Clear,6,5,1
2011-11-24,2011,November,7,Thursday,Winter,Clear,40,31,9
2011-11-24,2011,November,8,Thursday,Winter,Clear,46,42,4
2011-11-24,2011,November,9,Thursday,Winter,Clear,81,68,13
2011-11-24,2011,November,10,Thursday,Winter,Clear,98,64,34
2011-11-24,2011,November,11,Thursday,Winter,Clear,142,90,52
2011-11-24,2011,November,12,Thursday,Winter,Clear,150,88,62
2011-11-24,2011,November,13,Thursday,Winter,Clear,175,91,84
2011-11-24,2011,November,14,Thursday,Winter,Clear,168,94,74
2011-11-24,2011,November,15,Thursday,Winter,Clear,149,71,78
2011-11-24,2011,November,16,Thursday,Winter,Clear,114,66,48
2011-11-24,2011,November,17,Thursday,Winter,Clear,74,40,34
2011-11-24,2011,November,18,Thursday,Winter,Clear,37,24,13
2011-11-24,2011,November,19,Thursday,Winter,Clear,28,13,15
2011-11-24,2011,November,20,Thursday,Winter,Clear,31,17,14
2011-11-24,2011,November,21,Thursday,Winter,Clear,26,19,7
2011-11-24,2011,November,22,Thursday,Winter,Clear,22,14,8
2011-11-24,2011,November,23,Thursday,Winter,Clear,21,19,2
2011-11-25,2011,November,0,Friday,Winter,Clear,29,22,7
2011-11-25,2011,November,1,Friday,Winter,Clear,14,12,2
2011-11-25,2011,November,2,Friday,Winter,Clear,10,6,4
2011-11-25,2011,November,3,Friday,Winter,Clear,2,2,0
2011-11-25,2011,November,4,Friday,Winter,Clear,7,3,4
2011-11-25,2011,November,5,Friday,Winter,Clear,5,3,2
2011-11-25,2011,November,6,Friday,Winter,Clear,13,9,4
2011-11-25,2011,November,7,Friday,Winter,Clear,35,31,4
2011-11-25,2011,November,8,Friday,Winter,Clear,74,68,6
2011-11-25,2011,November,9,Friday,Winter,Clear,95,70,25
2011-11-25,2011,November,10,Friday,Winter,Clear,142,82,60
2011-11-25,2011,November,11,Friday,Winter,Clear,226,127,99
2011-11-25,2011,November,12,Friday,Winter,Clear,272,146,126
2011-11-25,2011,November,13,Friday,Winter,Clear,283,140,143
2011-11-25,2011,November,14,Friday,Winter,Clear,272,150,122
2011-11-25,2011,November,15,Friday,Winter,Clear,310,145,165
2011-11-25,2011,November,16,Friday,Winter,Clear,261,139,122
2011-11-25,2011,November,17,Friday,Winter,Clear,184,127,57
2011-11-25,2011,November,18,Friday,Winter,Clear,153,108,45
2011-11-25,2011,November,19,Friday,Winter,Clear,134,96,38
2011-11-25,2011,November,20,Friday,Winter,Clear,95,76,19
2011-11-25,2011,November,21,Friday,Winter,Clear,85,61,24
2011-11-25,2011,November,22,Friday,Winter,Clear,58,46,12
2011-11-25,2011,November,23,Friday,Winter,Clear,33,28,5
2011-11-26,2011,November,0,Saturday,Winter,Clear,47,38,9
2011-11-26,2011,November,1,Saturday,Winter,Clear,29,24,5
2011-11-26,2011,November,2,Saturday,Winter,Clear,23,20,3
2011-11-26,2011,November,3,Saturday,Winter,Clear,17,9,8
2011-11-26,2011,November,4,Saturday,Winter,Clear,4,4,0
2011-11-26,2011,November,5,Saturday,Winter,Clear,3,3,0
2011-11-26,2011,November,6,Saturday,Winter,Cloudy,10,8,2
2011-11-26,2011,November,7,Saturday,Winter,Clear,17,13,4
2011-11-26,2011,November,8,Saturday,Winter,Clear,60,50,10
2011-11-26,2011,November,9,Saturday,Winter,Clear,83,67,16
2011-11-26,2011,November,10,Saturday,Winter,Clear,141,84,57
2011-11-26,2011,November,11,Saturday,Winter,Clear,230,123,107
2011-11-26,2011,November,12,Saturday,Winter,Clear,309,172,137
2011-11-26,2011,November,13,Saturday,Winter,Clear,325,148,177
2011-11-26,2011,November,14,Saturday,Winter,Cloudy,299,158,141
2011-11-26,2011,November,15,Saturday,Winter,Cloudy,314,160,154
2011-11-26,2011,November,16,Saturday,Winter,Cloudy,275,138,137
2011-11-26,2011,November,17,Saturday,Winter,Cloudy,184,122,62
2011-11-26,2011,November,18,Saturday,Winter,Cloudy,185,118,67
2011-11-26,2011,November,19,Saturday,Winter,Cloudy,146,100,46
2011-11-26,2011,November,20,Saturday,Winter,Cloudy,141,86,55
2011-11-26,2011,November,21,Saturday,Winter,Cloudy,92,72,20
2011-11-26,2011,November,22,Saturday,Winter,Cloudy,65,51,14
2011-11-26,2011,November,23,Saturday,Winter,Clear,69,51,18
2011-11-27,2011,November,0,Sunday,Winter,Clear,46,39,7
2011-11-27,2011,November,1,Sunday,Winter,Clear,44,35,9
2011-11-27,2011,November,2,Sunday,Winter,Clear,31,22,9
2011-11-27,2011,November,3,Sunday,Winter,Clear,17,8,9
2011-11-27,2011,November,4,Sunday,Winter,Clear,4,4,0
2011-11-27,2011,November,5,Sunday,Winter,Clear,5,5,0
2011-11-27,2011,November,6,Sunday,Winter,Clear,9,9,0
2011-11-27,2011,November,7,Sunday,Winter,Clear,23,11,12
2011-11-27,2011,November,8,Sunday,Winter,Clear,42,36,6
2011-11-27,2011,November,9,Sunday,Winter,Clear,111,90,21
2011-11-27,2011,November,10,Sunday,Winter,Clear,189,131,58
2011-11-27,2011,November,11,Sunday,Winter,Clear,240,157,83
2011-11-27,2011,November,12,Sunday,Winter,Clear,256,193,63
2011-11-27,2011,November,13,Sunday,Winter,Clear,313,216,97
2011-11-27,2011,November,14,Sunday,Winter,Clear,313,200,113
2011-11-27,2011,November,15,Sunday,Winter,Clear,317,221,96
2011-11-27,2011,November,16,Sunday,Winter,Clear,323,229,94
2011-11-27,2011,November,17,Sunday,Winter,Clear,204,167,37
2011-11-27,2011,November,18,Sunday,Winter,Clear,155,130,25
2011-11-27,2011,November,19,Sunday,Winter,Clear,139,109,30
2011-11-27,2011,November,20,Sunday,Winter,Clear,104,94,10
2011-11-27,2011,November,21,Sunday,Winter,Clear,88,75,13
2011-11-27,2011,November,22,Sunday,Winter,Clear,66,53,13
2011-11-27,2011,November,23,Sunday,Winter,Clear,32,27,5
2011-11-28,2011,November,0,Monday,Winter,Clear,16,10,6
2011-11-28,2011,November,1,Monday,Winter,Clear,13,12,1
2011-11-28,2011,November,3,Monday,Winter,Clear,5,4,1
2011-11-28,2011,November,4,Monday,Winter,Clear,4,4,0
2011-11-28,2011,November,5,Monday,Winter,Clear,34,34,0
2011-11-28,2011,November,6,Monday,Winter,Clear,104,98,6
2011-11-28,2011,November,7,Monday,Winter,Clear,277,270,7
2011-11-28,2011,November,8,Monday,Winter,Cloudy,407,394,13
2011-11-28,2011,November,9,Monday,Winter,Cloudy,208,191,17
2011-11-28,2011,November,10,Monday,Winter,Cloudy,107,86,21
2011-11-28,2011,November,11,Monday,Winter,Cloudy,118,107,11
2011-11-28,2011,November,12,Monday,Winter,Clear,178,165,13
2011-11-28,2011,November,13,Monday,Winter,Cloudy,162,137,25
2011-11-28,2011,November,14,Monday,Winter,Clear,143,129,14
2011-11-28,2011,November,15,Monday,Winter,Clear,150,132,18
2011-11-28,2011,November,16,Monday,Winter,Clear,264,240,24
2011-11-28,2011,November,17,Monday,Winter,Clear,468,444,24
2011-11-28,2011,November,18,Monday,Winter,Clear,416,396,20
2011-11-28,2011,November,19,Monday,Winter,Clear,264,260,4
2011-11-28,2011,November,20,Monday,Winter,Cloudy,218,206,12
2011-11-28,2011,November,21,Monday,Winter,Cloudy,156,152,4
2011-11-28,2011,November,22,Monday,Winter,Cloudy,109,102,7
2011-11-28,2011,November,23,Monday,Winter,Cloudy,46,41,5
2011-11-29,2011,November,0,Tuesday,Winter,Clear,22,18,4
2011-11-29,2011,November,1,Tuesday,Winter,Clear,17,16,1
2011-11-29,2011,November,2,Tuesday,Winter,Cloudy,5,5,0
2011-11-29,2011,November,3,Tuesday,Winter,Cloudy,2,2,0
2011-11-29,2011,November,4,Tuesday,Winter,Cloudy,6,5,1
2011-11-29,2011,November,5,Tuesday,Winter,Clear,22,21,1
2011-11-29,2011,November,6,Tuesday,Winter,Clear,89,88,1
2011-11-29,2011,November,7,Tuesday,Winter,Clear,342,330,12
2011-11-29,2011,November,8,Tuesday,Winter,Clear,449,440,9
2011-11-29,2011,November,9,Tuesday,Winter,Light Snow/Rain,202,197,5
2011-11-29,2011,November,10,Tuesday,Winter,Light Snow/Rain,36,34,2
2011-11-29,2011,November,11,Tuesday,Winter,Light Snow/Rain,11,10,1
2011-11-29,2011,November,12,Tuesday,Winter,Light Snow/Rain,18,17,1
2011-11-29,2011,November,13,Tuesday,Winter,Light Snow/Rain,22,22,0
2011-11-29,2011,November,14,Tuesday,Winter,Light Snow/Rain,36,35,1
2011-11-29,2011,November,15,Tuesday,Winter,Light Snow/Rain,65,60,5
2011-11-29,2011,November,16,Tuesday,Winter,Light Snow/Rain,151,146,5
2011-11-29,2011,November,17,Tuesday,Winter,Cloudy,354,346,8
2011-11-29,2011,November,18,Tuesday,Winter,Cloudy,358,347,11
2011-11-29,2011,November,19,Tuesday,Winter,Cloudy,250,244,6
2011-11-29,2011,November,20,Tuesday,Winter,Cloudy,184,176,8
2011-11-29,2011,November,21,Tuesday,Winter,Cloudy,125,116,9
2011-11-29,2011,November,22,Tuesday,Winter,Clear,95,90,5
2011-11-29,2011,November,23,Tuesday,Winter,Clear,53,53,0
2011-11-30,2011,November,0,Wednesday,Winter,Clear,24,23,1
2011-11-30,2011,November,1,Wednesday,Winter,Clear,8,8,0
2011-11-30,2011,November,2,Wednesday,Winter,Clear,5,5,0
2011-11-30,2011,November,3,Wednesday,Winter,Clear,1,1,0
2011-11-30,2011,November,4,Wednesday,Winter,Clear,5,5,0
2011-11-30,2011,November,5,Wednesday,Winter,Clear,22,21,1
2011-11-30,2011,November,6,Wednesday,Winter,Clear,103,100,3
2011-11-30,2011,November,7,Wednesday,Winter,Clear,285,276,9
2011-11-30,2011,November,8,Wednesday,Winter,Clear,478,465,13
2011-11-30,2011,November,9,Wednesday,Winter,Clear,193,186,7
2011-11-30,2011,November,10,Wednesday,Winter,Clear,110,95,15
2011-11-30,2011,November,11,Wednesday,Winter,Clear,122,112,10
2011-11-30,2011,November,12,Wednesday,Winter,Cloudy,160,148,12
2011-11-30,2011,November,13,Wednesday,Winter,Cloudy,147,131,16
2011-11-30,2011,November,14,Wednesday,Winter,Cloudy,112,99,13
2011-11-30,2011,November,15,Wednesday,Winter,Clear,115,104,11
2011-11-30,2011,November,16,Wednesday,Winter,Clear,226,199,27
2011-11-30,2011,November,17,Wednesday,Winter,Cloudy,380,365,15
2011-11-30,2011,November,18,Wednesday,Winter,Clear,376,369,7
2011-11-30,2011,November,19,Wednesday,Winter,Cloudy,279,273,6
2011-11-30,2011,November,20,Wednesday,Winter,Cloudy,190,184,6
2011-11-30,2011,November,21,Wednesday,Winter,Clear,135,128,7
2011-11-30,2011,November,22,Wednesday,Winter,Clear,87,82,5
2011-11-30,2011,November,23,Wednesday,Winter,Clear,50,46,4
2011-12-01,2011,December,0,Thursday,Winter,Clear,20,19,1
2011-12-01,2011,December,1,Thursday,Winter,Clear,10,9,1
2011-12-01,2011,December,2,Thursday,Winter,Clear,9,8,1
2011-12-01,2011,December,3,Thursday,Winter,Clear,7,6,1
2011-12-01,2011,December,4,Thursday,Winter,Clear,1,1,0
2011-12-01,2011,December,5,Thursday,Winter,Clear,24,23,1
2011-12-01,2011,December,6,Thursday,Winter,Clear,97,92,5
2011-12-01,2011,December,7,Thursday,Winter,Clear,276,265,11
2011-12-01,2011,December,8,Thursday,Winter,Clear,477,462,15
2011-12-01,2011,December,9,Thursday,Winter,Clear,224,215,9
2011-12-01,2011,December,10,Thursday,Winter,Clear,93,86,7
2011-12-01,2011,December,11,Thursday,Winter,Clear,102,95,7
2011-12-01,2011,December,12,Thursday,Winter,Clear,148,139,9
2011-12-01,2011,December,13,Thursday,Winter,Clear,154,137,17
2011-12-01,2011,December,14,Thursday,Winter,Clear,150,130,20
2011-12-01,2011,December,15,Thursday,Winter,Clear,154,144,10
2011-12-01,2011,December,16,Thursday,Winter,Clear,201,192,9
2011-12-01,2011,December,17,Thursday,Winter,Clear,418,409,9
2011-12-01,2011,December,18,Thursday,Winter,Clear,405,393,12
2011-12-01,2011,December,19,Thursday,Winter,Clear,228,219,9
2011-12-01,2011,December,20,Thursday,Winter,Clear,190,178,12
2011-12-01,2011,December,21,Thursday,Winter,Clear,162,154,8
2011-12-01,2011,December,22,Thursday,Winter,Clear,104,99,5
2011-12-01,2011,December,23,Thursday,Winter,Clear,73,70,3
2011-12-02,2011,December,0,Friday,Winter,Clear,38,32,6
2011-12-02,2011,December,1,Friday,Winter,Clear,15,14,1
2011-12-02,2011,December,2,Friday,Winter,Clear,10,10,0
2011-12-02,2011,December,3,Friday,Winter,Clear,1,1,0
2011-12-02,2011,December,4,Friday,Winter,Clear,3,3,0
2011-12-02,2011,December,5,Friday,Winter,Clear,23,23,0
2011-12-02,2011,December,6,Friday,Winter,Clear,87,84,3
2011-12-02,2011,December,7,Friday,Winter,Clear,205,199,6
2011-12-02,2011,December,8,Friday,Winter,Clear,445,432,13
2011-12-02,2011,December,9,Friday,Winter,Clear,246,234,12
2011-12-02,2011,December,10,Friday,Winter,Clear,105,89,16
2011-12-02,2011,December,11,Friday,Winter,Clear,160,142,18
2011-12-02,2011,December,12,Friday,Winter,Clear,204,186,18
2011-12-02,2011,December,13,Friday,Winter,Clear,207,188,19
2011-12-02,2011,December,14,Friday,Winter,Clear,170,145,25
2011-12-02,2011,December,15,Friday,Winter,Clear,199,175,24
2011-12-02,2011,December,16,Friday,Winter,Clear,276,254,22
2011-12-02,2011,December,17,Friday,Winter,Clear,411,391,20
2011-12-02,2011,December,18,Friday,Winter,Clear,372,362,10
2011-12-02,2011,December,19,Friday,Winter,Clear,265,252,13
2011-12-02,2011,December,20,Friday,Winter,Clear,190,178,12
2011-12-02,2011,December,21,Friday,Winter,Clear,111,102,9
2011-12-02,2011,December,22,Friday,Winter,Clear,102,95,7
2011-12-02,2011,December,23,Friday,Winter,Clear,95,81,14
2011-12-03,2011,December,0,Saturday,Winter,Clear,75,65,10
2011-12-03,2011,December,1,Saturday,Winter,Clear,71,62,9
2011-12-03,2011,December,2,Saturday,Winter,Clear,50,41,9
2011-12-03,2011,December,3,Saturday,Winter,Clear,9,5,4
2011-12-03,2011,December,4,Saturday,Winter,Clear,8,7,1
2011-12-03,2011,December,5,Saturday,Winter,Clear,6,6,0
2011-12-03,2011,December,6,Saturday,Winter,Clear,11,10,1
2011-12-03,2011,December,7,Saturday,Winter,Clear,26,24,2
2011-12-03,2011,December,8,Saturday,Winter,Clear,63,62,1
2011-12-03,2011,December,9,Saturday,Winter,Clear,124,99,25
2011-12-03,2011,December,10,Saturday,Winter,Clear,195,173,22
2011-12-03,2011,December,11,Saturday,Winter,Clear,275,227,48
2011-12-03,2011,December,12,Saturday,Winter,Clear,358,280,78
2011-12-03,2011,December,13,Saturday,Winter,Clear,292,222,70
2011-12-03,2011,December,14,Saturday,Winter,Clear,343,251,92
2011-12-03,2011,December,15,Saturday,Winter,Clear,337,237,100
2011-12-03,2011,December,16,Saturday,Winter,Clear,305,230,75
2011-12-03,2011,December,17,Saturday,Winter,Clear,232,186,46
2011-12-03,2011,December,18,Saturday,Winter,Clear,224,193,31
2011-12-03,2011,December,19,Saturday,Winter,Clear,175,144,31
2011-12-03,2011,December,20,Saturday,Winter,Clear,127,110,17
2011-12-03,2011,December,21,Saturday,Winter,Cloudy,109,104,5
2011-12-03,2011,December,22,Saturday,Winter,Cloudy,114,97,17
2011-12-03,2011,December,23,Saturday,Winter,Clear,85,73,12
2011-12-04,2011,December,0,Sunday,Winter,Clear,83,64,19
2011-12-04,2011,December,1,Sunday,Winter,Clear,74,54,20
2011-12-04,2011,December,2,Sunday,Winter,Clear,62,51,11
2011-12-04,2011,December,3,Sunday,Winter,Clear,41,34,7
2011-12-04,2011,December,4,Sunday,Winter,Clear,11,9,2
2011-12-04,2011,December,5,Sunday,Winter,Clear,4,2,2
2011-12-04,2011,December,6,Sunday,Winter,Clear,4,3,1
2011-12-04,2011,December,7,Sunday,Winter,Clear,26,23,3
2011-12-04,2011,December,8,Sunday,Winter,Clear,55,48,7
2011-12-04,2011,December,9,Sunday,Winter,Clear,126,114,12
2011-12-04,2011,December,10,Sunday,Winter,Clear,216,180,36
2011-12-04,2011,December,11,Sunday,Winter,Clear,254,206,48
2011-12-04,2011,December,12,Sunday,Winter,Clear,329,247,82
2011-12-04,2011,December,13,Sunday,Winter,Clear,357,269,88
2011-12-04,2011,December,14,Sunday,Winter,Clear,323,246,77
2011-12-04,2011,December,15,Sunday,Winter,Clear,296,227,69
2011-12-04,2011,December,16,Sunday,Winter,Clear,330,266,64
2011-12-04,2011,December,17,Sunday,Winter,Clear,245,207,38
2011-12-04,2011,December,18,Sunday,Winter,Clear,171,161,10
2011-12-04,2011,December,19,Sunday,Winter,Clear,173,158,15
2011-12-04,2011,December,20,Sunday,Winter,Clear,124,116,8
2011-12-04,2011,December,21,Sunday,Winter,Clear,72,65,7
2011-12-04,2011,December,22,Sunday,Winter,Clear,64,59,5
2011-12-04,2011,December,23,Sunday,Winter,Clear,45,42,3
2011-12-05,2011,December,0,Monday,Winter,Clear,24,21,3
2011-12-05,2011,December,1,Monday,Winter,Clear,12,10,2
2011-12-05,2011,December,2,Monday,Winter,Clear,8,8,0
2011-12-05,2011,December,3,Monday,Winter,Clear,2,2,0
2011-12-05,2011,December,4,Monday,Winter,Clear,7,7,0
2011-12-05,2011,December,5,Monday,Winter,Clear,25,24,1
2011-12-05,2011,December,6,Monday,Winter,Clear,90,89,1
2011-12-05,2011,December,7,Monday,Winter,Clear,283,274,9
2011-12-05,2011,December,8,Monday,Winter,Clear,404,392,12
2011-12-05,2011,December,9,Monday,Winter,Cloudy,190,178,12
2011-12-05,2011,December,10,Monday,Winter,Cloudy,87,78,9
2011-12-05,2011,December,11,Monday,Winter,Cloudy,123,106,17
2011-12-05,2011,December,12,Monday,Winter,Cloudy,154,125,29
2011-12-05,2011,December,13,Monday,Winter,Cloudy,171,153,18
2011-12-05,2011,December,14,Monday,Winter,Cloudy,133,126,7
2011-12-05,2011,December,15,Monday,Winter,Cloudy,148,132,16
2011-12-05,2011,December,16,Monday,Winter,Clear,248,238,10
2011-12-05,2011,December,17,Monday,Winter,Clear,446,430,16
2011-12-05,2011,December,18,Monday,Winter,Clear,399,386,13
2011-12-05,2011,December,19,Monday,Winter,Cloudy,308,295,13
2011-12-05,2011,December,20,Monday,Winter,Cloudy,205,190,15
2011-12-05,2011,December,21,Monday,Winter,Cloudy,176,166,10
2011-12-05,2011,December,22,Monday,Winter,Cloudy,106,94,12
2011-12-05,2011,December,23,Monday,Winter,Cloudy,62,54,8
2011-12-06,2011,December,0,Tuesday,Winter,Cloudy,28,25,3
2011-12-06,2011,December,1,Tuesday,Winter,Cloudy,16,14,2
2011-12-06,2011,December,2,Tuesday,Winter,Cloudy,3,3,0
2011-12-06,2011,December,3,Tuesday,Winter,Cloudy,3,3,0
2011-12-06,2011,December,4,Tuesday,Winter,Light Snow/Rain,7,7,0
2011-12-06,2011,December,5,Tuesday,Winter,Light Snow/Rain,20,20,0
2011-12-06,2011,December,6,Tuesday,Winter,Cloudy,86,81,5
2011-12-06,2011,December,7,Tuesday,Winter,Cloudy,234,227,7
2011-12-06,2011,December,8,Tuesday,Winter,Cloudy,414,401,13
2011-12-06,2011,December,9,Tuesday,Winter,Cloudy,204,200,4
2011-12-06,2011,December,10,Tuesday,Winter,Light Snow/Rain,50,44,6
2011-12-06,2011,December,11,Tuesday,Winter,Light Snow/Rain,32,28,4
2011-12-06,2011,December,12,Tuesday,Winter,Light Snow/Rain,55,50,5
2011-12-06,2011,December,13,Tuesday,Winter,Light Snow/Rain,71,65,6
2011-12-06,2011,December,14,Tuesday,Winter,Light Snow/Rain,75,69,6
2011-12-06,2011,December,15,Tuesday,Winter,Light Snow/Rain,45,43,2
2011-12-06,2011,December,16,Tuesday,Winter,Light Snow/Rain,88,84,4
2011-12-06,2011,December,17,Tuesday,Winter,Cloudy,262,249,13
2011-12-06,2011,December,18,Tuesday,Winter,Cloudy,304,287,17
2011-12-06,2011,December,19,Tuesday,Winter,Light Snow/Rain,233,223,10
2011-12-06,2011,December,20,Tuesday,Winter,Light Snow/Rain,110,107,3
2011-12-06,2011,December,21,Tuesday,Winter,Cloudy,114,108,6
2011-12-06,2011,December,22,Tuesday,Winter,Light Snow/Rain,87,82,5
2011-12-06,2011,December,23,Tuesday,Winter,Light Snow/Rain,53,48,5
2011-12-07,2011,December,0,Wednesday,Winter,Clear,33,30,3
2011-12-07,2011,December,1,Wednesday,Winter,Cloudy,13,9,4
2011-12-07,2011,December,2,Wednesday,Winter,Light Snow/Rain,6,4,2
2011-12-07,2011,December,3,Wednesday,Winter,Light Snow/Rain,3,3,0
2011-12-07,2011,December,4,Wednesday,Winter,Light Snow/Rain,1,1,0
2011-12-07,2011,December,5,Wednesday,Winter,Light Snow/Rain,3,3,0
2011-12-07,2011,December,6,Wednesday,Winter,Light Snow/Rain,18,18,0
2011-12-07,2011,December,7,Wednesday,Winter,Light Snow/Rain,46,43,3
2011-12-07,2011,December,8,Wednesday,Winter,Light Snow/Rain,86,80,6
2011-12-07,2011,December,9,Wednesday,Winter,Light Snow/Rain,64,64,0
2011-12-07,2011,December,10,Wednesday,Winter,Light Snow/Rain,33,32,1
2011-12-07,2011,December,11,Wednesday,Winter,Light Snow/Rain,50,47,3
2011-12-07,2011,December,12,Wednesday,Winter,Light Snow/Rain,33,29,4
2011-12-07,2011,December,13,Wednesday,Winter,Light Snow/Rain,33,28,5
2011-12-07,2011,December,14,Wednesday,Winter,Light Snow/Rain,25,24,1
2011-12-07,2011,December,15,Wednesday,Winter,Light Snow/Rain,30,25,5
2011-12-07,2011,December,16,Wednesday,Winter,Light Snow/Rain,31,28,3
2011-12-07,2011,December,17,Wednesday,Winter,Light Snow/Rain,52,48,4
2011-12-07,2011,December,18,Wednesday,Winter,Light Snow/Rain,51,48,3
2011-12-07,2011,December,19,Wednesday,Winter,Light Snow/Rain,33,31,2
2011-12-07,2011,December,20,Wednesday,Winter,Light Snow/Rain,26,25,1
2011-12-07,2011,December,21,Wednesday,Winter,Light Snow/Rain,6,6,0
2011-12-07,2011,December,22,Wednesday,Winter,Light Snow/Rain,13,13,0
2011-12-07,2011,December,23,Wednesday,Winter,Clear,16,16,0
2011-12-08,2011,December,0,Thursday,Winter,Cloudy,21,21,0
2011-12-08,2011,December,1,Thursday,Winter,Clear,7,6,1
2011-12-08,2011,December,2,Thursday,Winter,Clear,4,4,0
2011-12-08,2011,December,3,Thursday,Winter,Clear,1,1,0
2011-12-08,2011,December,4,Thursday,Winter,Cloudy,2,2,0
2011-12-08,2011,December,5,Thursday,Winter,Clear,12,12,0
2011-12-08,2011,December,6,Thursday,Winter,Clear,71,71,0
2011-12-08,2011,December,7,Thursday,Winter,Clear,244,233,11
2011-12-08,2011,December,8,Thursday,Winter,Clear,429,418,11
2011-12-08,2011,December,9,Thursday,Winter,Clear,225,218,7
2011-12-08,2011,December,10,Thursday,Winter,Clear,110,109,1
2011-12-08,2011,December,11,Thursday,Winter,Clear,106,100,6
2011-12-08,2011,December,12,Thursday,Winter,Clear,156,148,8
2011-12-08,2011,December,13,Thursday,Winter,Clear,124,115,9
2011-12-08,2011,December,14,Thursday,Winter,Clear,137,121,16
2011-12-08,2011,December,15,Thursday,Winter,Clear,117,98,19
2011-12-08,2011,December,16,Thursday,Winter,Clear,208,201,7
2011-12-08,2011,December,17,Thursday,Winter,Clear,331,321,10
2011-12-08,2011,December,18,Thursday,Winter,Clear,318,306,12
2011-12-08,2011,December,19,Thursday,Winter,Clear,232,220,12
2011-12-08,2011,December,20,Thursday,Winter,Clear,175,170,5
2011-12-08,2011,December,21,Thursday,Winter,Clear,139,135,4
2011-12-08,2011,December,22,Thursday,Winter,Clear,92,84,8
2011-12-08,2011,December,23,Thursday,Winter,Clear,61,58,3
2011-12-09,2011,December,0,Friday,Winter,Clear,34,26,8
2011-12-09,2011,December,1,Friday,Winter,Clear,14,12,2
2011-12-09,2011,December,2,Friday,Winter,Clear,12,10,2
2011-12-09,2011,December,3,Friday,Winter,Clear,6,5,1
2011-12-09,2011,December,4,Friday,Winter,Clear,2,1,1
2011-12-09,2011,December,5,Friday,Winter,Clear,20,20,0
2011-12-09,2011,December,6,Friday,Winter,Clear,63,62,1
2011-12-09,2011,December,7,Friday,Winter,Clear,199,195,4
2011-12-09,2011,December,8,Friday,Winter,Clear,385,378,7
2011-12-09,2011,December,9,Friday,Winter,Clear,264,256,8
2011-12-09,2011,December,10,Friday,Winter,Cloudy,126,115,11
2011-12-09,2011,December,11,Friday,Winter,Clear,136,121,15
2011-12-09,2011,December,12,Friday,Winter,Clear,173,146,27
2011-12-09,2011,December,13,Friday,Winter,Clear,168,141,27
2011-12-09,2011,December,14,Friday,Winter,Clear,187,163,24
2011-12-09,2011,December,15,Friday,Winter,Clear,189,160,29
2011-12-09,2011,December,16,Friday,Winter,Clear,250,226,24
2011-12-09,2011,December,17,Friday,Winter,Clear,362,352,10
2011-12-09,2011,December,18,Friday,Winter,Clear,318,308,10
2011-12-09,2011,December,19,Friday,Winter,Clear,199,189,10
2011-12-09,2011,December,20,Friday,Winter,Clear,150,140,10
2011-12-09,2011,December,21,Friday,Winter,Clear,140,131,9
2011-12-09,2011,December,22,Friday,Winter,Clear,129,114,15
2011-12-09,2011,December,23,Friday,Winter,Clear,94,88,6
2011-12-10,2011,December,0,Saturday,Winter,Cloudy,77,66,11
2011-12-10,2011,December,1,Saturday,Winter,Cloudy,66,55,11
2011-12-10,2011,December,2,Saturday,Winter,Cloudy,60,48,12
2011-12-10,2011,December,3,Saturday,Winter,Cloudy,25,20,5
2011-12-10,2011,December,4,Saturday,Winter,Cloudy,3,3,0
2011-12-10,2011,December,5,Saturday,Winter,Clear,6,6,0
2011-12-10,2011,December,6,Saturday,Winter,Clear,11,10,1
2011-12-10,2011,December,7,Saturday,Winter,Clear,11,11,0
2011-12-10,2011,December,8,Saturday,Winter,Clear,73,68,5
2011-12-10,2011,December,9,Saturday,Winter,Clear,149,134,15
2011-12-10,2011,December,10,Saturday,Winter,Clear,192,161,31
2011-12-10,2011,December,11,Saturday,Winter,Clear,236,192,44
2011-12-10,2011,December,12,Saturday,Winter,Clear,283,235,48
2011-12-10,2011,December,13,Saturday,Winter,Clear,286,239,47
2011-12-10,2011,December,14,Saturday,Winter,Clear,293,242,51
2011-12-10,2011,December,15,Saturday,Winter,Clear,299,239,60
2011-12-10,2011,December,16,Saturday,Winter,Clear,241,183,58
2011-12-10,2011,December,17,Saturday,Winter,Clear,185,151,34
2011-12-10,2011,December,18,Saturday,Winter,Clear,172,144,28
2011-12-10,2011,December,19,Saturday,Winter,Clear,154,139,15
2011-12-10,2011,December,20,Saturday,Winter,Clear,124,114,10
2011-12-10,2011,December,21,Saturday,Winter,Clear,83,79,4
2011-12-10,2011,December,22,Saturday,Winter,Clear,95,88,7
2011-12-10,2011,December,23,Saturday,Winter,Clear,66,61,5
2011-12-11,2011,December,0,Sunday,Winter,Clear,74,69,5
2011-12-11,2011,December,1,Sunday,Winter,Clear,62,54,8
2011-12-11,2011,December,2,Sunday,Winter,Clear,52,47,5
2011-12-11,2011,December,3,Sunday,Winter,Clear,19,17,2
2011-12-11,2011,December,4,Sunday,Winter,Clear,5,5,0
2011-12-11,2011,December,5,Sunday,Winter,Clear,6,6,0
2011-12-11,2011,December,6,Sunday,Winter,Clear,10,10,0
2011-12-11,2011,December,7,Sunday,Winter,Clear,31,30,1
2011-12-11,2011,December,8,Sunday,Winter,Clear,72,68,4
2011-12-11,2011,December,9,Sunday,Winter,Clear,107,88,19
2011-12-11,2011,December,10,Sunday,Winter,Clear,194,164,30
2011-12-11,2011,December,11,Sunday,Winter,Clear,197,166,31
2011-12-11,2011,December,12,Sunday,Winter,Clear,288,246,42
2011-12-11,2011,December,13,Sunday,Winter,Clear,268,224,44
2011-12-11,2011,December,14,Sunday,Winter,Clear,242,198,44
2011-12-11,2011,December,15,Sunday,Winter,Clear,266,219,47
2011-12-11,2011,December,16,Sunday,Winter,Clear,206,174,32
2011-12-11,2011,December,17,Sunday,Winter,Clear,163,150,13
2011-12-11,2011,December,18,Sunday,Winter,Clear,163,151,12
2011-12-11,2011,December,19,Sunday,Winter,Clear,105,98,7
2011-12-11,2011,December,20,Sunday,Winter,Clear,72,62,10
2011-12-11,2011,December,21,Sunday,Winter,Clear,63,53,10
2011-12-11,2011,December,22,Sunday,Winter,Clear,43,36,7
2011-12-11,2011,December,23,Sunday,Winter,Clear,35,31,4
2011-12-12,2011,December,0,Monday,Winter,Clear,20,16,4
2011-12-12,2011,December,1,Monday,Winter,Clear,9,9,0
2011-12-12,2011,December,2,Monday,Winter,Clear,4,4,0
2011-12-12,2011,December,3,Monday,Winter,Clear,2,2,0
2011-12-12,2011,December,4,Monday,Winter,Clear,3,3,0
2011-12-12,2011,December,5,Monday,Winter,Clear,21,21,0
2011-12-12,2011,December,6,Monday,Winter,Clear,64,63,1
2011-12-12,2011,December,7,Monday,Winter,Clear,235,231,4
2011-12-12,2011,December,8,Monday,Winter,Cloudy,385,378,7
2011-12-12,2011,December,9,Monday,Winter,Cloudy,220,208,12
2011-12-12,2011,December,10,Monday,Winter,Cloudy,105,91,14
2011-12-12,2011,December,11,Monday,Winter,Cloudy,115,100,15
2011-12-12,2011,December,12,Monday,Winter,Clear,145,138,7
2011-12-12,2011,December,13,Monday,Winter,Cloudy,166,153,13
2011-12-12,2011,December,14,Monday,Winter,Cloudy,111,95,16
2011-12-12,2011,December,15,Monday,Winter,Cloudy,132,124,8
2011-12-12,2011,December,16,Monday,Winter,Cloudy,214,209,5
2011-12-12,2011,December,17,Monday,Winter,Cloudy,359,352,7
2011-12-12,2011,December,18,Monday,Winter,Clear,357,349,8
2011-12-12,2011,December,19,Monday,Winter,Clear,241,232,9
2011-12-12,2011,December,20,Monday,Winter,Clear,165,157,8
2011-12-12,2011,December,21,Monday,Winter,Clear,121,119,2
2011-12-12,2011,December,22,Monday,Winter,Clear,71,71,0
2011-12-12,2011,December,23,Monday,Winter,Clear,45,42,3
2011-12-13,2011,December,0,Tuesday,Winter,Clear,17,16,1
2011-12-13,2011,December,1,Tuesday,Winter,Clear,4,4,0
2011-12-13,2011,December,2,Tuesday,Winter,Clear,2,1,1
2011-12-13,2011,December,3,Tuesday,Winter,Clear,3,3,0
2011-12-13,2011,December,4,Tuesday,Winter,Clear,4,4,0
2011-12-13,2011,December,5,Tuesday,Winter,Clear,20,20,0
2011-12-13,2011,December,6,Tuesday,Winter,Clear,92,92,0
2011-12-13,2011,December,7,Tuesday,Winter,Clear,223,221,2
2011-12-13,2011,December,8,Tuesday,Winter,Clear,400,391,9
2011-12-13,2011,December,9,Tuesday,Winter,Clear,233,223,10
2011-12-13,2011,December,10,Tuesday,Winter,Clear,102,99,3
2011-12-13,2011,December,11,Tuesday,Winter,Clear,124,115,9
2011-12-13,2011,December,12,Tuesday,Winter,Clear,167,147,20
2011-12-13,2011,December,13,Tuesday,Winter,Clear,127,120,7
2011-12-13,2011,December,14,Tuesday,Winter,Clear,134,116,18
2011-12-13,2011,December,15,Tuesday,Winter,Clear,151,144,7
2011-12-13,2011,December,16,Tuesday,Winter,Clear,207,194,13
2011-12-13,2011,December,17,Tuesday,Winter,Clear,398,381,17
2011-12-13,2011,December,18,Tuesday,Winter,Clear,382,370,12
2011-12-13,2011,December,19,Tuesday,Winter,Clear,267,262,5
2011-12-13,2011,December,20,Tuesday,Winter,Clear,161,154,7
2011-12-13,2011,December,21,Tuesday,Winter,Clear,139,134,5
2011-12-13,2011,December,22,Tuesday,Winter,Clear,107,102,5
2011-12-13,2011,December,23,Tuesday,Winter,Clear,59,55,4
2011-12-14,2011,December,0,Wednesday,Winter,Clear,22,22,0
2011-12-14,2011,December,1,Wednesday,Winter,Clear,8,8,0
2011-12-14,2011,December,2,Wednesday,Winter,Clear,2,2,0
2011-12-14,2011,December,3,Wednesday,Winter,Clear,3,3,0
2011-12-14,2011,December,4,Wednesday,Winter,Clear,4,4,0
2011-12-14,2011,December,5,Wednesday,Winter,Cloudy,26,26,0
2011-12-14,2011,December,6,Wednesday,Winter,Cloudy,87,87,0
2011-12-14,2011,December,7,Wednesday,Winter,Clear,247,243,4
2011-12-14,2011,December,8,Wednesday,Winter,Cloudy,467,458,9
2011-12-14,2011,December,9,Wednesday,Winter,Cloudy,239,230,9
2011-12-14,2011,December,10,Wednesday,Winter,Cloudy,142,133,9
2011-12-14,2011,December,11,Wednesday,Winter,Cloudy,115,103,12
2011-12-14,2011,December,12,Wednesday,Winter,Cloudy,144,138,6
2011-12-14,2011,December,13,Wednesday,Winter,Cloudy,133,119,14
2011-12-14,2011,December,14,Wednesday,Winter,Cloudy,151,134,17
2011-12-14,2011,December,15,Wednesday,Winter,Cloudy,167,143,24
2011-12-14,2011,December,16,Wednesday,Winter,Cloudy,245,233,12
2011-12-14,2011,December,17,Wednesday,Winter,Cloudy,396,377,19
2011-12-14,2011,December,18,Wednesday,Winter,Cloudy,390,379,11
2011-12-14,2011,December,19,Wednesday,Winter,Cloudy,268,259,9
2011-12-14,2011,December,20,Wednesday,Winter,Cloudy,175,169,6
2011-12-14,2011,December,21,Wednesday,Winter,Cloudy,154,145,9
2011-12-14,2011,December,22,Wednesday,Winter,Clear,104,99,5
2011-12-14,2011,December,23,Wednesday,Winter,Clear,51,48,3
2011-12-15,2011,December,0,Thursday,Winter,Clear,50,45,5
2011-12-15,2011,December,1,Thursday,Winter,Cloudy,20,15,5
2011-12-15,2011,December,2,Thursday,Winter,Cloudy,7,5,2
2011-12-15,2011,December,3,Thursday,Winter,Cloudy,3,2,1
2011-12-15,2011,December,4,Thursday,Winter,Cloudy,6,6,0
2011-12-15,2011,December,5,Thursday,Winter,Cloudy,24,24,0
2011-12-15,2011,December,6,Thursday,Winter,Clear,92,90,2
2011-12-15,2011,December,7,Thursday,Winter,Clear,258,252,6
2011-12-15,2011,December,8,Thursday,Winter,Cloudy,457,449,8
2011-12-15,2011,December,9,Thursday,Winter,Cloudy,280,274,6
2011-12-15,2011,December,10,Thursday,Winter,Cloudy,109,105,4
2011-12-15,2011,December,11,Thursday,Winter,Cloudy,135,126,9
2011-12-15,2011,December,12,Thursday,Winter,Cloudy,157,140,17
2011-12-15,2011,December,13,Thursday,Winter,Cloudy,164,150,14
2011-12-15,2011,December,14,Thursday,Winter,Cloudy,132,124,8
2011-12-15,2011,December,15,Thursday,Winter,Light Snow/Rain,82,76,6
2011-12-15,2011,December,16,Thursday,Winter,Light Snow/Rain,131,124,7
2011-12-15,2011,December,17,Thursday,Winter,Cloudy,324,310,14
2011-12-15,2011,December,18,Thursday,Winter,Cloudy,377,363,14
2011-12-15,2011,December,19,Thursday,Winter,Cloudy,287,274,13
2011-12-15,2011,December,20,Thursday,Winter,Clear,221,209,12
2011-12-15,2011,December,21,Thursday,Winter,Clear,155,145,10
2011-12-15,2011,December,22,Thursday,Winter,Clear,124,116,8
2011-12-15,2011,December,23,Thursday,Winter,Clear,114,104,10
2011-12-16,2011,December,0,Friday,Winter,Clear,72,60,12
2011-12-16,2011,December,1,Friday,Winter,Clear,31,28,3
2011-12-16,2011,December,2,Friday,Winter,Clear,23,23,0
2011-12-16,2011,December,3,Friday,Winter,Clear,5,3,2
2011-12-16,2011,December,4,Friday,Winter,Cloudy,5,4,1
2011-12-16,2011,December,5,Friday,Winter,Clear,26,26,0
2011-12-16,2011,December,6,Friday,Winter,Cloudy,82,80,2
2011-12-16,2011,December,7,Friday,Winter,Cloudy,231,226,5
2011-12-16,2011,December,8,Friday,Winter,Clear,459,449,10
2011-12-16,2011,December,9,Friday,Winter,Clear,243,235,8
2011-12-16,2011,December,10,Friday,Winter,Clear,132,122,10
2011-12-16,2011,December,11,Friday,Winter,Cloudy,144,135,9
2011-12-16,2011,December,12,Friday,Winter,Cloudy,173,163,10
2011-12-16,2011,December,13,Friday,Winter,Cloudy,137,125,12
2011-12-16,2011,December,14,Friday,Winter,Cloudy,128,115,13
2011-12-16,2011,December,15,Friday,Winter,Cloudy,153,141,12
2011-12-16,2011,December,16,Friday,Winter,Cloudy,224,212,12
2011-12-16,2011,December,17,Friday,Winter,Cloudy,365,352,13
2011-12-16,2011,December,18,Friday,Winter,Cloudy,295,285,10
2011-12-16,2011,December,19,Friday,Winter,Cloudy,214,203,11
2011-12-16,2011,December,20,Friday,Winter,Cloudy,152,146,6
2011-12-16,2011,December,21,Friday,Winter,Cloudy,102,95,7
2011-12-16,2011,December,22,Friday,Winter,Cloudy,106,100,6
2011-12-16,2011,December,23,Friday,Winter,Cloudy,75,71,4
2011-12-17,2011,December,0,Saturday,Winter,Clear,62,59,3
2011-12-17,2011,December,1,Saturday,Winter,Cloudy,43,39,4
2011-12-17,2011,December,2,Saturday,Winter,Cloudy,58,47,11
2011-12-17,2011,December,3,Saturday,Winter,Clear,26,22,4
2011-12-17,2011,December,4,Saturday,Winter,Clear,9,9,0
2011-12-17,2011,December,5,Saturday,Winter,Cloudy,9,7,2
2011-12-17,2011,December,6,Saturday,Winter,Cloudy,17,17,0
2011-12-17,2011,December,7,Saturday,Winter,Cloudy,20,20,0
2011-12-17,2011,December,8,Saturday,Winter,Cloudy,59,55,4
2011-12-17,2011,December,9,Saturday,Winter,Cloudy,100,95,5
2011-12-17,2011,December,10,Saturday,Winter,Cloudy,181,171,10
2011-12-17,2011,December,11,Saturday,Winter,Cloudy,209,188,21
2011-12-17,2011,December,12,Saturday,Winter,Cloudy,244,216,28
2011-12-17,2011,December,13,Saturday,Winter,Cloudy,236,204,32
2011-12-17,2011,December,14,Saturday,Winter,Clear,237,207,30
2011-12-17,2011,December,15,Saturday,Winter,Clear,228,195,33
2011-12-17,2011,December,16,Saturday,Winter,Clear,222,192,30
2011-12-17,2011,December,17,Saturday,Winter,Clear,165,153,12
2011-12-17,2011,December,18,Saturday,Winter,Clear,157,150,7
2011-12-17,2011,December,19,Saturday,Winter,Light Snow/Rain,106,95,11
2011-12-17,2011,December,20,Saturday,Winter,Clear,106,99,7
2011-12-17,2011,December,21,Saturday,Winter,Clear,96,88,8
2011-12-17,2011,December,22,Saturday,Winter,Clear,80,73,7
2011-12-17,2011,December,23,Saturday,Winter,Clear,69,63,6
2011-12-18,2011,December,0,Sunday,Winter,Clear,71,64,7
2011-12-18,2011,December,1,Sunday,Winter,Clear,46,43,3
2011-12-18,2011,December,2,Sunday,Winter,Clear,41,39,2
2011-12-18,2011,December,3,Sunday,Winter,Clear,18,16,2
2011-12-18,2011,December,4,Sunday,Winter,Clear,1,1,0
2011-12-18,2011,December,5,Sunday,Winter,Clear,5,4,1
2011-12-18,2011,December,6,Sunday,Winter,Clear,3,3,0
2011-12-18,2011,December,7,Sunday,Winter,Clear,12,11,1
2011-12-18,2011,December,8,Sunday,Winter,Clear,32,31,1
2011-12-18,2011,December,9,Sunday,Winter,Clear,81,75,6
2011-12-18,2011,December,10,Sunday,Winter,Clear,129,122,7
2011-12-18,2011,December,11,Sunday,Winter,Cloudy,188,168,20
2011-12-18,2011,December,12,Sunday,Winter,Clear,228,202,26
2011-12-18,2011,December,13,Sunday,Winter,Clear,228,210,18
2011-12-18,2011,December,14,Sunday,Winter,Clear,219,200,19
2011-12-18,2011,December,15,Sunday,Winter,Clear,207,184,23
2011-12-18,2011,December,16,Sunday,Winter,Clear,234,207,27
2011-12-18,2011,December,17,Sunday,Winter,Clear,136,126,10
2011-12-18,2011,December,18,Sunday,Winter,Clear,138,123,15
2011-12-18,2011,December,19,Sunday,Winter,Clear,135,130,5
2011-12-18,2011,December,20,Sunday,Winter,Clear,104,94,10
2011-12-18,2011,December,21,Sunday,Winter,Clear,89,80,9
2011-12-18,2011,December,22,Sunday,Winter,Clear,49,47,2
2011-12-18,2011,December,23,Sunday,Winter,Clear,37,31,6
2011-12-19,2011,December,0,Monday,Winter,Clear,17,14,3
2011-12-19,2011,December,1,Monday,Winter,Clear,11,8,3
2011-12-19,2011,December,2,Monday,Winter,Clear,3,3,0
2011-12-19,2011,December,3,Monday,Winter,Clear,3,3,0
2011-12-19,2011,December,4,Monday,Winter,Clear,4,4,0
2011-12-19,2011,December,5,Monday,Winter,Clear,21,21,0
2011-12-19,2011,December,6,Monday,Winter,Clear,68,68,0
2011-12-19,2011,December,7,Monday,Winter,Clear,191,187,4
2011-12-19,2011,December,8,Monday,Winter,Clear,397,389,8
2011-12-19,2011,December,9,Monday,Winter,Clear,183,166,17
2011-12-19,2011,December,10,Monday,Winter,Clear,108,96,12
2011-12-19,2011,December,11,Monday,Winter,Clear,127,105,22
2011-12-19,2011,December,12,Monday,Winter,Clear,141,128,13
2011-12-19,2011,December,13,Monday,Winter,Clear,142,127,15
2011-12-19,2011,December,14,Monday,Winter,Clear,137,107,30
2011-12-19,2011,December,15,Monday,Winter,Clear,159,135,24
2011-12-19,2011,December,16,Monday,Winter,Clear,208,189,19
2011-12-19,2011,December,17,Monday,Winter,Clear,378,362,16
2011-12-19,2011,December,18,Monday,Winter,Clear,354,343,11
2011-12-19,2011,December,19,Monday,Winter,Cloudy,251,234,17
2011-12-19,2011,December,20,Monday,Winter,Clear,206,197,9
2011-12-19,2011,December,21,Monday,Winter,Cloudy,127,112,15
2011-12-19,2011,December,22,Monday,Winter,Cloudy,107,95,12
2011-12-19,2011,December,23,Monday,Winter,Clear,60,50,10
2011-12-20,2011,December,0,Tuesday,Winter,Clear,21,21,0
2011-12-20,2011,December,1,Tuesday,Winter,Clear,6,6,0
2011-12-20,2011,December,2,Tuesday,Winter,Cloudy,11,10,1
2011-12-20,2011,December,3,Tuesday,Winter,Cloudy,2,1,1
2011-12-20,2011,December,4,Tuesday,Winter,Cloudy,4,4,0
2011-12-20,2011,December,5,Tuesday,Winter,Cloudy,15,15,0
2011-12-20,2011,December,6,Tuesday,Winter,Cloudy,72,71,1
2011-12-20,2011,December,7,Tuesday,Winter,Cloudy,268,261,7
2011-12-20,2011,December,8,Tuesday,Winter,Cloudy,432,422,10
2011-12-20,2011,December,9,Tuesday,Winter,Cloudy,259,245,14
2011-12-20,2011,December,10,Tuesday,Winter,Cloudy,129,109,20
2011-12-20,2011,December,11,Tuesday,Winter,Cloudy,129,116,13
2011-12-20,2011,December,12,Tuesday,Winter,Cloudy,175,159,16
2011-12-20,2011,December,13,Tuesday,Winter,Cloudy,181,163,18
2011-12-20,2011,December,14,Tuesday,Winter,Cloudy,138,127,11
2011-12-20,2011,December,15,Tuesday,Winter,Cloudy,154,139,15
2011-12-20,2011,December,16,Tuesday,Winter,Clear,238,218,20
2011-12-20,2011,December,17,Tuesday,Winter,Clear,431,417,14
2011-12-20,2011,December,18,Tuesday,Winter,Clear,411,385,26
2011-12-20,2011,December,19,Tuesday,Winter,Clear,224,218,6
2011-12-20,2011,December,20,Tuesday,Winter,Clear,147,144,3
2011-12-20,2011,December,21,Tuesday,Winter,Clear,143,139,4
2011-12-20,2011,December,22,Tuesday,Winter,Cloudy,107,104,3
2011-12-20,2011,December,23,Tuesday,Winter,Cloudy,53,40,13
2011-12-21,2011,December,0,Wednesday,Spring,Cloudy,25,18,7
2011-12-21,2011,December,1,Wednesday,Spring,Cloudy,11,10,1
2011-12-21,2011,December,2,Wednesday,Spring,Cloudy,4,4,0
2011-12-21,2011,December,3,Wednesday,Spring,Cloudy,2,2,0
2011-12-21,2011,December,4,Wednesday,Spring,Cloudy,2,2,0
2011-12-21,2011,December,5,Wednesday,Spring,Cloudy,28,28,0
2011-12-21,2011,December,6,Wednesday,Spring,Cloudy,76,75,1
2011-12-21,2011,December,7,Wednesday,Spring,Cloudy,229,224,5
2011-12-21,2011,December,8,Wednesday,Spring,Light Snow/Rain,405,393,12
2011-12-21,2011,December,9,Wednesday,Spring,Cloudy,234,220,14
2011-12-21,2011,December,10,Wednesday,Spring,Cloudy,89,83,6
2011-12-21,2011,December,11,Wednesday,Spring,Cloudy,56,53,3
2011-12-21,2011,December,12,Wednesday,Spring,Light Snow/Rain,61,58,3
2011-12-21,2011,December,13,Wednesday,Spring,Light Snow/Rain,58,55,3
2011-12-21,2011,December,14,Wednesday,Spring,Cloudy,51,40,11
2011-12-21,2011,December,15,Wednesday,Spring,Cloudy,61,57,4
2011-12-21,2011,December,16,Wednesday,Spring,Light Snow/Rain,101,95,6
2011-12-21,2011,December,17,Wednesday,Spring,Light Snow/Rain,229,226,3
2011-12-21,2011,December,18,Wednesday,Spring,Cloudy,280,278,2
2011-12-21,2011,December,19,Wednesday,Spring,Cloudy,209,200,9
2011-12-21,2011,December,20,Wednesday,Spring,Cloudy,167,162,5
2011-12-21,2011,December,21,Wednesday,Spring,Clear,123,114,9
2011-12-21,2011,December,22,Wednesday,Spring,Clear,105,102,3
2011-12-21,2011,December,23,Wednesday,Spring,Clear,54,54,0
2011-12-22,2011,December,0,Thursday,Spring,Cloudy,27,24,3
2011-12-22,2011,December,1,Thursday,Spring,Clear,15,15,0
2011-12-22,2011,December,2,Thursday,Spring,Clear,11,10,1
2011-12-22,2011,December,3,Thursday,Spring,Clear,6,6,0
2011-12-22,2011,December,4,Thursday,Spring,Clear,3,3,0
2011-12-22,2011,December,5,Thursday,Spring,Clear,16,15,1
2011-12-22,2011,December,6,Thursday,Spring,Clear,64,63,1
2011-12-22,2011,December,7,Thursday,Spring,Clear,186,182,4
2011-12-22,2011,December,8,Thursday,Spring,Cloudy,343,333,10
2011-12-22,2011,December,9,Thursday,Spring,Cloudy,228,218,10
2011-12-22,2011,December,10,Thursday,Spring,Cloudy,141,128,13
2011-12-22,2011,December,11,Thursday,Spring,Cloudy,145,135,10
2011-12-22,2011,December,12,Thursday,Spring,Cloudy,202,180,22
2011-12-22,2011,December,13,Thursday,Spring,Cloudy,188,167,21
2011-12-22,2011,December,14,Thursday,Spring,Cloudy,159,136,23
2011-12-22,2011,December,15,Thursday,Spring,Cloudy,214,186,28
2011-12-22,2011,December,16,Thursday,Spring,Cloudy,256,226,30
2011-12-22,2011,December,17,Thursday,Spring,Cloudy,356,332,24
2011-12-22,2011,December,18,Thursday,Spring,Cloudy,288,277,11
2011-12-22,2011,December,19,Thursday,Spring,Cloudy,142,130,12
2011-12-22,2011,December,20,Thursday,Spring,Light Snow/Rain,33,33,0
2011-12-22,2011,December,21,Thursday,Spring,Light Snow/Rain,17,15,2
2011-12-22,2011,December,22,Thursday,Spring,Light Snow/Rain,17,17,0
2011-12-22,2011,December,23,Thursday,Spring,Light Snow/Rain,11,10,1
2011-12-23,2011,December,0,Friday,Spring,Light Snow/Rain,9,7,2
2011-12-23,2011,December,1,Friday,Spring,Light Snow/Rain,12,11,1
2011-12-23,2011,December,2,Friday,Spring,Light Snow/Rain,13,12,1
2011-12-23,2011,December,3,Friday,Spring,Light Snow/Rain,4,4,0
2011-12-23,2011,December,4,Friday,Spring,Light Snow/Rain,2,2,0
2011-12-23,2011,December,5,Friday,Spring,Clear,8,8,0
2011-12-23,2011,December,6,Friday,Spring,Clear,40,40,0
2011-12-23,2011,December,7,Friday,Spring,Clear,92,88,4
2011-12-23,2011,December,8,Friday,Spring,Clear,182,173,9
2011-12-23,2011,December,9,Friday,Spring,Clear,156,152,4
2011-12-23,2011,December,10,Friday,Spring,Clear,104,96,8
2011-12-23,2011,December,11,Friday,Spring,Clear,174,148,26
2011-12-23,2011,December,12,Friday,Spring,Clear,170,156,14
2011-12-23,2011,December,13,Friday,Spring,Clear,194,177,17
2011-12-23,2011,December,14,Friday,Spring,Clear,200,177,23
2011-12-23,2011,December,15,Friday,Spring,Clear,203,191,12
2011-12-23,2011,December,16,Friday,Spring,Clear,181,166,15
2011-12-23,2011,December,17,Friday,Spring,Clear,140,129,11
2011-12-23,2011,December,18,Friday,Spring,Clear,95,91,4
2011-12-23,2011,December,19,Friday,Spring,Clear,76,75,1
2011-12-23,2011,December,20,Friday,Spring,Clear,50,47,3
2011-12-23,2011,December,21,Friday,Spring,Clear,32,32,0
2011-12-23,2011,December,22,Friday,Spring,Clear,47,43,4
2011-12-23,2011,December,23,Friday,Spring,Clear,25,21,4
2011-12-24,2011,December,0,Saturday,Spring,Cloudy,23,20,3
2011-12-24,2011,December,1,Saturday,Spring,Cloudy,16,15,1
2011-12-24,2011,December,2,Saturday,Spring,Cloudy,26,22,4
2011-12-24,2011,December,3,Saturday,Spring,Cloudy,5,5,0
2011-12-24,2011,December,4,Saturday,Spring,Cloudy,3,3,0
2011-12-24,2011,December,5,Saturday,Spring,Cloudy,4,3,1
2011-12-24,2011,December,6,Saturday,Spring,Cloudy,10,10,0
2011-12-24,2011,December,7,Saturday,Spring,Clear,10,10,0
2011-12-24,2011,December,8,Saturday,Spring,Clear,27,27,0
2011-12-24,2011,December,9,Saturday,Spring,Clear,56,53,3
2011-12-24,2011,December,10,Saturday,Spring,Clear,56,52,4
2011-12-24,2011,December,11,Saturday,Spring,Clear,71,62,9
2011-12-24,2011,December,12,Saturday,Spring,Clear,94,79,15
2011-12-24,2011,December,13,Saturday,Spring,Clear,121,97,24
2011-12-24,2011,December,14,Saturday,Spring,Clear,85,70,15
2011-12-24,2011,December,15,Saturday,Spring,Clear,97,82,15
2011-12-24,2011,December,16,Saturday,Spring,Clear,99,74,25
2011-12-24,2011,December,17,Saturday,Spring,Clear,68,53,15
2011-12-24,2011,December,18,Saturday,Spring,Clear,35,33,2
2011-12-24,2011,December,19,Saturday,Spring,Clear,25,24,1
2011-12-24,2011,December,20,Saturday,Spring,Clear,24,19,5
2011-12-24,2011,December,21,Saturday,Spring,Clear,19,15,4
2011-12-24,2011,December,22,Saturday,Spring,Clear,20,12,8
2011-12-24,2011,December,23,Saturday,Spring,Clear,17,16,1
2011-12-25,2011,December,0,Sunday,Spring,Clear,6,4,2
2011-12-25,2011,December,1,Sunday,Spring,Clear,4,2,2
2011-12-25,2011,December,2,Sunday,Spring,Clear,2,2,0
2011-12-25,2011,December,3,Sunday,Spring,Clear,4,3,1
2011-12-25,2011,December,5,Sunday,Spring,Clear,1,1,0
2011-12-25,2011,December,6,Sunday,Spring,Clear,1,1,0
2011-12-25,2011,December,7,Sunday,Spring,Clear,4,4,0
2011-12-25,2011,December,8,Sunday,Spring,Clear,5,4,1
2011-12-25,2011,December,9,Sunday,Spring,Clear,23,20,3
2011-12-25,2011,December,10,Sunday,Spring,Clear,43,12,31
2011-12-25,2011,December,11,Sunday,Spring,Clear,85,42,43
2011-12-25,2011,December,12,Sunday,Spring,Clear,66,41,25
2011-12-25,2011,December,13,Sunday,Spring,Clear,79,39,40
2011-12-25,2011,December,14,Sunday,Spring,Clear,86,45,41
2011-12-25,2011,December,15,Sunday,Spring,Clear,91,48,43
2011-12-25,2011,December,16,Sunday,Spring,Clear,86,51,35
2011-12-25,2011,December,17,Sunday,Spring,Clear,44,33,11
2011-12-25,2011,December,18,Sunday,Spring,Clear,30,23,7
2011-12-25,2011,December,19,Sunday,Spring,Clear,16,14,2
2011-12-25,2011,December,20,Sunday,Spring,Clear,26,18,8
2011-12-25,2011,December,21,Sunday,Spring,Clear,19,15,4
2011-12-25,2011,December,22,Sunday,Spring,Clear,17,15,2
2011-12-25,2011,December,23,Sunday,Spring,Clear,16,14,2
2011-12-26,2011,December,0,Monday,Spring,Clear,11,6,5
2011-12-26,2011,December,1,Monday,Spring,Clear,10,7,3
2011-12-26,2011,December,2,Monday,Spring,Clear,7,5,2
2011-12-26,2011,December,4,Monday,Spring,Clear,2,2,0
2011-12-26,2011,December,5,Monday,Spring,Clear,4,4,0
2011-12-26,2011,December,6,Monday,Spring,Clear,4,4,0
2011-12-26,2011,December,7,Monday,Spring,Clear,19,17,2
2011-12-26,2011,December,8,Monday,Spring,Clear,18,13,5
2011-12-26,2011,December,9,Monday,Spring,Clear,62,38,24
2011-12-26,2011,December,10,Monday,Spring,Clear,70,39,31
2011-12-26,2011,December,11,Monday,Spring,Clear,91,51,40
2011-12-26,2011,December,12,Monday,Spring,Clear,100,66,34
2011-12-26,2011,December,13,Monday,Spring,Clear,140,83,57
2011-12-26,2011,December,14,Monday,Spring,Clear,153,80,73
2011-12-26,2011,December,15,Monday,Spring,Clear,131,105,26
2011-12-26,2011,December,16,Monday,Spring,Clear,97,69,28
2011-12-26,2011,December,17,Monday,Spring,Clear,97,67,30
2011-12-26,2011,December,18,Monday,Spring,Clear,75,54,21
2011-12-26,2011,December,19,Monday,Spring,Clear,65,49,16
2011-12-26,2011,December,20,Monday,Spring,Clear,56,42,14
2011-12-26,2011,December,21,Monday,Spring,Clear,49,39,10
2011-12-26,2011,December,22,Monday,Spring,Clear,27,22,5
2011-12-26,2011,December,23,Monday,Spring,Clear,29,25,4
2011-12-27,2011,December,0,Tuesday,Spring,Clear,12,9,3
2011-12-27,2011,December,1,Tuesday,Spring,Clear,6,6,0
2011-12-27,2011,December,2,Tuesday,Spring,Clear,4,2,2
2011-12-27,2011,December,3,Tuesday,Spring,Cloudy,3,3,0
2011-12-27,2011,December,4,Tuesday,Spring,Cloudy,3,3,0
2011-12-27,2011,December,5,Tuesday,Spring,Cloudy,8,8,0
2011-12-27,2011,December,6,Tuesday,Spring,Cloudy,35,35,0
2011-12-27,2011,December,7,Tuesday,Spring,Cloudy,80,79,1
2011-12-27,2011,December,8,Tuesday,Spring,Cloudy,164,155,9
2011-12-27,2011,December,9,Tuesday,Spring,Light Snow/Rain,104,85,19
2011-12-27,2011,December,10,Tuesday,Spring,Cloudy,60,47,13
2011-12-27,2011,December,11,Tuesday,Spring,Light Snow/Rain,30,24,6
2011-12-27,2011,December,12,Tuesday,Spring,Light Snow/Rain,24,16,8
2011-12-27,2011,December,13,Tuesday,Spring,Light Snow/Rain,20,19,1
2011-12-27,2011,December,14,Tuesday,Spring,Light Snow/Rain,14,14,0
2011-12-27,2011,December,15,Tuesday,Spring,Light Snow/Rain,19,17,2
2011-12-27,2011,December,16,Tuesday,Spring,Light Snow/Rain,46,44,2
2011-12-27,2011,December,17,Tuesday,Spring,Light Snow/Rain,115,109,6
2011-12-27,2011,December,18,Tuesday,Spring,Clear,135,126,9
2011-12-27,2011,December,19,Tuesday,Spring,Clear,90,87,3
2011-12-27,2011,December,20,Tuesday,Spring,Clear,69,66,3
2011-12-27,2011,December,21,Tuesday,Spring,Clear,63,52,11
2011-12-27,2011,December,22,Tuesday,Spring,Clear,32,29,3
2011-12-27,2011,December,23,Tuesday,Spring,Clear,26,24,2
2011-12-28,2011,December,0,Wednesday,Spring,Clear,10,10,0
2011-12-28,2011,December,1,Wednesday,Spring,Clear,12,12,0
2011-12-28,2011,December,2,Wednesday,Spring,Clear,7,7,0
2011-12-28,2011,December,3,Wednesday,Spring,Clear,4,4,0
2011-12-28,2011,December,5,Wednesday,Spring,Clear,9,9,0
2011-12-28,2011,December,6,Wednesday,Spring,Clear,43,42,1
2011-12-28,2011,December,7,Wednesday,Spring,Clear,110,106,4
2011-12-28,2011,December,8,Wednesday,Spring,Clear,217,206,11
2011-12-28,2011,December,9,Wednesday,Spring,Clear,189,171,18
2011-12-28,2011,December,10,Wednesday,Spring,Clear,96,84,12
2011-12-28,2011,December,11,Wednesday,Spring,Clear,111,93,18
2011-12-28,2011,December,12,Wednesday,Spring,Clear,140,108,32
2011-12-28,2011,December,13,Wednesday,Spring,Clear,159,135,24
2011-12-28,2011,December,14,Wednesday,Spring,Clear,120,96,24
2011-12-28,2011,December,15,Wednesday,Spring,Clear,117,101,16
2011-12-28,2011,December,16,Wednesday,Spring,Clear,167,144,23
2011-12-28,2011,December,17,Wednesday,Spring,Clear,250,225,25
2011-12-28,2011,December,18,Wednesday,Spring,Clear,169,159,10
2011-12-28,2011,December,19,Wednesday,Spring,Clear,151,135,16
2011-12-28,2011,December,20,Wednesday,Spring,Clear,79,70,9
2011-12-28,2011,December,21,Wednesday,Spring,Clear,70,63,7
2011-12-28,2011,December,22,Wednesday,Spring,Clear,33,31,2
2011-12-28,2011,December,23,Wednesday,Spring,Clear,39,36,3
2011-12-29,2011,December,0,Thursday,Spring,Cloudy,28,24,4
2011-12-29,2011,December,1,Thursday,Spring,Clear,15,15,0
2011-12-29,2011,December,2,Thursday,Spring,Clear,3,3,0
2011-12-29,2011,December,3,Thursday,Spring,Clear,2,2,0
2011-12-29,2011,December,4,Thursday,Spring,Clear,3,2,1
2011-12-29,2011,December,5,Thursday,Spring,Clear,10,10,0
2011-12-29,2011,December,6,Thursday,Spring,Clear,41,39,2
2011-12-29,2011,December,7,Thursday,Spring,Clear,106,104,2
2011-12-29,2011,December,8,Thursday,Spring,Cloudy,210,207,3
2011-12-29,2011,December,9,Thursday,Spring,Cloudy,170,155,15
2011-12-29,2011,December,10,Thursday,Spring,Cloudy,110,97,13
2011-12-29,2011,December,11,Thursday,Spring,Cloudy,122,99,23
2011-12-29,2011,December,12,Thursday,Spring,Cloudy,130,118,12
2011-12-29,2011,December,13,Thursday,Spring,Cloudy,131,95,36
2011-12-29,2011,December,14,Thursday,Spring,Cloudy,142,112,30
2011-12-29,2011,December,15,Thursday,Spring,Cloudy,177,150,27
2011-12-29,2011,December,16,Thursday,Spring,Clear,177,155,22
2011-12-29,2011,December,17,Thursday,Spring,Clear,240,226,14
2011-12-29,2011,December,18,Thursday,Spring,Clear,207,192,15
2011-12-29,2011,December,19,Thursday,Spring,Clear,135,124,11
2011-12-29,2011,December,20,Thursday,Spring,Clear,96,88,8
2011-12-29,2011,December,21,Thursday,Spring,Cloudy,68,60,8
2011-12-29,2011,December,22,Thursday,Spring,Clear,55,48,7
2011-12-29,2011,December,23,Thursday,Spring,Clear,45,44,1
2011-12-30,2011,December,0,Friday,Spring,Clear,30,26,4
2011-12-30,2011,December,1,Friday,Spring,Clear,20,11,9
2011-12-30,2011,December,2,Friday,Spring,Clear,12,10,2
2011-12-30,2011,December,3,Friday,Spring,Clear,6,6,0
2011-12-30,2011,December,4,Friday,Spring,Clear,2,2,0
2011-12-30,2011,December,5,Friday,Spring,Clear,10,10,0
2011-12-30,2011,December,6,Friday,Spring,Clear,32,31,1
2011-12-30,2011,December,7,Friday,Spring,Clear,95,92,3
2011-12-30,2011,December,8,Friday,Spring,Cloudy,205,193,12
2011-12-30,2011,December,9,Friday,Spring,Clear,194,175,19
2011-12-30,2011,December,10,Friday,Spring,Clear,118,108,10
2011-12-30,2011,December,11,Friday,Spring,Clear,171,126,45
2011-12-30,2011,December,12,Friday,Spring,Clear,197,159,38
2011-12-30,2011,December,13,Friday,Spring,Cloudy,207,154,53
2011-12-30,2011,December,14,Friday,Spring,Cloudy,245,178,67
2011-12-30,2011,December,15,Friday,Spring,Clear,292,236,56
2011-12-30,2011,December,16,Friday,Spring,Clear,283,247,36
2011-12-30,2011,December,17,Friday,Spring,Clear,242,188,54
2011-12-30,2011,December,18,Friday,Spring,Clear,182,163,19
2011-12-30,2011,December,19,Friday,Spring,Cloudy,112,96,16
2011-12-30,2011,December,20,Friday,Spring,Cloudy,91,75,16
2011-12-30,2011,December,21,Friday,Spring,Cloudy,95,84,11
2011-12-30,2011,December,22,Friday,Spring,Cloudy,85,78,7
2011-12-30,2011,December,23,Friday,Spring,Cloudy,73,60,13
2011-12-31,2011,December,0,Saturday,Spring,Cloudy,44,37,7
2011-12-31,2011,December,1,Saturday,Spring,Cloudy,35,31,4
2011-12-31,2011,December,2,Saturday,Spring,Cloudy,28,27,1
2011-12-31,2011,December,3,Saturday,Spring,Cloudy,18,17,1
2011-12-31,2011,December,4,Saturday,Spring,Clear,10,9,1
2011-12-31,2011,December,5,Saturday,Spring,Cloudy,1,0,1
2011-12-31,2011,December,6,Saturday,Spring,Cloudy,6,5,1
2011-12-31,2011,December,7,Saturday,Spring,Light Snow/Rain,19,13,6
2011-12-31,2011,December,8,Saturday,Spring,Clear,49,42,7
2011-12-31,2011,December,9,Saturday,Spring,Clear,90,72,18
2011-12-31,2011,December,10,Saturday,Spring,Clear,128,108,20
2011-12-31,2011,December,11,Saturday,Spring,Clear,217,152,65
2011-12-31,2011,December,12,Saturday,Spring,Clear,273,180,93
2011-12-31,2011,December,13,Saturday,Spring,Clear,313,205,108
2011-12-31,2011,December,14,Saturday,Spring,Clear,300,185,115
2011-12-31,2011,December,15,Saturday,Spring,Clear,253,164,89
2011-12-31,2011,December,16,Saturday,Spring,Clear,195,143,52
2011-12-31,2011,December,17,Saturday,Spring,Clear,129,101,28
2011-12-31,2011,December,18,Saturday,Spring,Clear,93,80,13
2011-12-31,2011,December,19,Saturday,Spring,Clear,92,73,19
2011-12-31,2011,December,20,Saturday,Spring,Clear,71,63,8
2011-12-31,2011,December,21,Saturday,Spring,Clear,52,50,2
2011-12-31,2011,December,22,Saturday,Spring,Clear,38,36,2
2011-12-31,2011,December,23,Saturday,Spring,Clear,31,27,4
2012-01-01,2012,January,0,Sunday,Spring,Clear,48,43,5
2012-01-01,2012,January,1,Sunday,Spring,Clear,93,78,15
2012-01-01,2012,January,2,Sunday,Spring,Clear,75,59,16
2012-01-01,2012,January,3,Sunday,Spring,Clear,52,41,11
2012-01-01,2012,January,4,Sunday,Spring,Clear,8,8,0
2012-01-01,2012,January,5,Sunday,Spring,Clear,5,5,0
2012-01-01,2012,January,6,Sunday,Spring,Clear,2,1,1
2012-01-01,2012,January,7,Sunday,Spring,Clear,7,6,1
2012-01-01,2012,January,8,Sunday,Spring,Clear,14,10,4
2012-01-01,2012,January,9,Sunday,Spring,Clear,40,27,13
2012-01-01,2012,January,10,Sunday,Spring,Clear,70,52,18
2012-01-01,2012,January,11,Sunday,Spring,Clear,138,98,40
2012-01-01,2012,January,12,Sunday,Spring,Clear,201,143,58
2012-01-01,2012,January,13,Sunday,Spring,Clear,223,141,82
2012-01-01,2012,January,14,Sunday,Spring,Clear,267,147,120
2012-01-01,2012,January,15,Sunday,Spring,Clear,265,164,101
2012-01-01,2012,January,16,Sunday,Spring,Cloudy,215,147,68
2012-01-01,2012,January,17,Sunday,Spring,Cloudy,111,75,36
2012-01-01,2012,January,18,Sunday,Spring,Light Snow/Rain,106,81,25
2012-01-01,2012,January,19,Sunday,Spring,Light Snow/Rain,105,85,20
2012-01-01,2012,January,20,Sunday,Spring,Cloudy,83,58,25
2012-01-01,2012,January,21,Sunday,Spring,Cloudy,71,61,10
2012-01-01,2012,January,22,Sunday,Spring,Clear,66,53,13
2012-01-01,2012,January,23,Sunday,Spring,Clear,29,25,4
2012-01-02,2012,January,0,Monday,Spring,Clear,39,31,8
2012-01-02,2012,January,1,Monday,Spring,Clear,12,11,1
2012-01-02,2012,January,2,Monday,Spring,Clear,7,6,1
2012-01-02,2012,January,4,Monday,Spring,Clear,4,4,0
2012-01-02,2012,January,5,Monday,Spring,Clear,4,3,1
2012-01-02,2012,January,6,Monday,Spring,Clear,14,14,0
2012-01-02,2012,January,7,Monday,Spring,Clear,16,16,0
2012-01-02,2012,January,8,Monday,Spring,Clear,53,51,2
2012-01-02,2012,January,9,Monday,Spring,Clear,68,53,15
2012-01-02,2012,January,10,Monday,Spring,Clear,109,89,20
2012-01-02,2012,January,11,Monday,Spring,Clear,175,142,33
2012-01-02,2012,January,12,Monday,Spring,Clear,202,161,41
2012-01-02,2012,January,13,Monday,Spring,Clear,176,150,26
2012-01-02,2012,January,14,Monday,Spring,Clear,151,141,10
2012-01-02,2012,January,15,Monday,Spring,Clear,168,139,29
2012-01-02,2012,January,16,Monday,Spring,Clear,154,144,10
2012-01-02,2012,January,17,Monday,Spring,Clear,153,136,17
2012-01-02,2012,January,18,Monday,Spring,Clear,126,113,13
2012-01-02,2012,January,19,Monday,Spring,Clear,93,89,4
2012-01-02,2012,January,20,Monday,Spring,Clear,88,83,5
2012-01-02,2012,January,21,Monday,Spring,Cloudy,66,63,3
2012-01-02,2012,January,22,Monday,Spring,Cloudy,39,36,3
2012-01-02,2012,January,23,Monday,Spring,Clear,34,32,2
2012-01-03,2012,January,0,Tuesday,Spring,Clear,13,13,0
2012-01-03,2012,January,1,Tuesday,Spring,Clear,6,5,1
2012-01-03,2012,January,2,Tuesday,Spring,Clear,3,3,0
2012-01-03,2012,January,3,Tuesday,Spring,Clear,2,2,0
2012-01-03,2012,January,4,Tuesday,Spring,Clear,5,5,0
2012-01-03,2012,January,5,Tuesday,Spring,Clear,12,12,0
2012-01-03,2012,January,6,Tuesday,Spring,Clear,85,81,4
2012-01-03,2012,January,7,Tuesday,Spring,Clear,170,168,2
2012-01-03,2012,January,8,Tuesday,Spring,Clear,354,349,5
2012-01-03,2012,January,9,Tuesday,Spring,Clear,153,145,8
2012-01-03,2012,January,10,Tuesday,Spring,Clear,60,55,5
2012-01-03,2012,January,11,Tuesday,Spring,Clear,75,63,12
2012-01-03,2012,January,12,Tuesday,Spring,Clear,74,70,4
2012-01-03,2012,January,13,Tuesday,Spring,Clear,73,68,5
2012-01-03,2012,January,14,Tuesday,Spring,Clear,79,72,7
2012-01-03,2012,January,15,Tuesday,Spring,Clear,77,68,9
2012-01-03,2012,January,16,Tuesday,Spring,Clear,136,129,7
2012-01-03,2012,January,17,Tuesday,Spring,Clear,245,241,4
2012-01-03,2012,January,18,Tuesday,Spring,Clear,224,214,10
2012-01-03,2012,January,19,Tuesday,Spring,Clear,156,152,4
2012-01-03,2012,January,20,Tuesday,Spring,Clear,115,115,0
2012-01-03,2012,January,21,Tuesday,Spring,Clear,68,66,2
2012-01-03,2012,January,22,Tuesday,Spring,Clear,33,33,0
2012-01-03,2012,January,23,Tuesday,Spring,Clear,18,18,0
2012-01-04,2012,January,0,Wednesday,Spring,Clear,9,9,0
2012-01-04,2012,January,1,Wednesday,Spring,Clear,3,3,0
2012-01-04,2012,January,2,Wednesday,Spring,Clear,1,1,0
2012-01-04,2012,January,3,Wednesday,Spring,Clear,1,1,0
2012-01-04,2012,January,4,Wednesday,Spring,Clear,2,2,0
2012-01-04,2012,January,5,Wednesday,Spring,Clear,14,14,0
2012-01-04,2012,January,6,Wednesday,Spring,Clear,59,59,0
2012-01-04,2012,January,7,Wednesday,Spring,Clear,152,151,1
2012-01-04,2012,January,8,Wednesday,Spring,Clear,315,310,5
2012-01-04,2012,January,9,Wednesday,Spring,Clear,180,173,7
2012-01-04,2012,January,10,Wednesday,Spring,Clear,64,57,7
2012-01-04,2012,January,11,Wednesday,Spring,Cloudy,46,40,6
2012-01-04,2012,January,12,Wednesday,Spring,Cloudy,84,75,9
2012-01-04,2012,January,13,Wednesday,Spring,Cloudy,91,82,9
2012-01-04,2012,January,14,Wednesday,Spring,Cloudy,75,69,6
2012-01-04,2012,January,15,Wednesday,Spring,Cloudy,90,81,9
2012-01-04,2012,January,16,Wednesday,Spring,Cloudy,131,123,8
2012-01-04,2012,January,17,Wednesday,Spring,Cloudy,281,272,9
2012-01-04,2012,January,18,Wednesday,Spring,Cloudy,289,280,9
2012-01-04,2012,January,19,Wednesday,Spring,Cloudy,184,182,2
2012-01-04,2012,January,20,Wednesday,Spring,Cloudy,123,121,2
2012-01-04,2012,January,21,Wednesday,Spring,Cloudy,90,88,2
2012-01-04,2012,January,22,Wednesday,Spring,Cloudy,52,48,4
2012-01-04,2012,January,23,Wednesday,Spring,Cloudy,32,32,0
2012-01-05,2012,January,0,Thursday,Spring,Cloudy,14,13,1
2012-01-05,2012,January,1,Thursday,Spring,Clear,5,5,0
2012-01-05,2012,January,2,Thursday,Spring,Clear,4,4,0
2012-01-05,2012,January,3,Thursday,Spring,Clear,4,4,0
2012-01-05,2012,January,4,Thursday,Spring,Cloudy,5,5,0
2012-01-05,2012,January,5,Thursday,Spring,Cloudy,26,26,0
2012-01-05,2012,January,6,Thursday,Spring,Cloudy,78,78,0
2012-01-05,2012,January,7,Thursday,Spring,Cloudy,215,212,3
2012-01-05,2012,January,8,Thursday,Spring,Cloudy,388,377,11
2012-01-05,2012,January,9,Thursday,Spring,Cloudy,227,220,7
2012-01-05,2012,January,10,Thursday,Spring,Cloudy,86,81,5
2012-01-05,2012,January,11,Thursday,Spring,Clear,84,78,6
2012-01-05,2012,January,12,Thursday,Spring,Clear,120,114,6
2012-01-05,2012,January,13,Thursday,Spring,Clear,118,112,6
2012-01-05,2012,January,14,Thursday,Spring,Clear,117,104,13
2012-01-05,2012,January,15,Thursday,Spring,Clear,119,113,6
2012-01-05,2012,January,16,Thursday,Spring,Clear,197,178,19
2012-01-05,2012,January,17,Thursday,Spring,Cloudy,412,393,19
2012-01-05,2012,January,18,Thursday,Spring,Clear,383,374,9
2012-01-05,2012,January,19,Thursday,Spring,Clear,265,255,10
2012-01-05,2012,January,20,Thursday,Spring,Clear,177,172,5
2012-01-05,2012,January,21,Thursday,Spring,Clear,97,88,9
2012-01-05,2012,January,22,Thursday,Spring,Clear,71,70,1
2012-01-05,2012,January,23,Thursday,Spring,Clear,60,56,4
2012-01-06,2012,January,0,Friday,Spring,Clear,25,24,1
2012-01-06,2012,January,1,Friday,Spring,Clear,8,6,2
2012-01-06,2012,January,2,Friday,Spring,Clear,5,3,2
2012-01-06,2012,January,3,Friday,Spring,Clear,4,3,1
2012-01-06,2012,January,4,Friday,Spring,Clear,3,3,0
2012-01-06,2012,January,5,Friday,Spring,Cloudy,13,13,0
2012-01-06,2012,January,6,Friday,Spring,Cloudy,70,69,1
2012-01-06,2012,January,7,Friday,Spring,Cloudy,205,201,4
2012-01-06,2012,January,8,Friday,Spring,Clear,447,436,11
2012-01-06,2012,January,9,Friday,Spring,Clear,241,237,4
2012-01-06,2012,January,10,Friday,Spring,Clear,116,102,14
2012-01-06,2012,January,11,Friday,Spring,Clear,138,130,8
2012-01-06,2012,January,12,Friday,Spring,Clear,191,168,23
2012-01-06,2012,January,13,Friday,Spring,Clear,204,188,16
2012-01-06,2012,January,14,Friday,Spring,Clear,178,152,26
2012-01-06,2012,January,15,Friday,Spring,Clear,222,178,44
2012-01-06,2012,January,16,Friday,Spring,Clear,294,259,35
2012-01-06,2012,January,17,Friday,Spring,Clear,476,456,20
2012-01-06,2012,January,18,Friday,Spring,Clear,419,391,28
2012-01-06,2012,January,19,Friday,Spring,Clear,272,261,11
2012-01-06,2012,January,20,Friday,Spring,Clear,177,163,14
2012-01-06,2012,January,21,Friday,Spring,Clear,154,137,17
2012-01-06,2012,January,22,Friday,Spring,Clear,135,123,12
2012-01-06,2012,January,23,Friday,Spring,Clear,101,88,13
2012-01-07,2012,January,0,Saturday,Spring,Clear,79,77,2
2012-01-07,2012,January,1,Saturday,Spring,Clear,62,56,6
2012-01-07,2012,January,2,Saturday,Spring,Clear,38,36,2
2012-01-07,2012,January,3,Saturday,Spring,Clear,20,19,1
2012-01-07,2012,January,4,Saturday,Spring,Clear,10,9,1
2012-01-07,2012,January,5,Saturday,Spring,Clear,9,7,2
2012-01-07,2012,January,6,Saturday,Spring,Clear,7,7,0
2012-01-07,2012,January,7,Saturday,Spring,Clear,20,20,0
2012-01-07,2012,January,8,Saturday,Spring,Clear,64,64,0
2012-01-07,2012,January,9,Saturday,Spring,Clear,130,116,14
2012-01-07,2012,January,10,Saturday,Spring,Clear,203,160,43
2012-01-07,2012,January,11,Saturday,Spring,Clear,324,250,74
2012-01-07,2012,January,12,Saturday,Spring,Clear,376,276,100
2012-01-07,2012,January,13,Saturday,Spring,Clear,445,296,149
2012-01-07,2012,January,14,Saturday,Spring,Clear,512,356,156
2012-01-07,2012,January,15,Saturday,Spring,Clear,449,317,132
2012-01-07,2012,January,16,Saturday,Spring,Cloudy,401,268,133
2012-01-07,2012,January,17,Saturday,Spring,Cloudy,322,235,87
2012-01-07,2012,January,18,Saturday,Spring,Clear,297,248,49
2012-01-07,2012,January,19,Saturday,Spring,Clear,215,171,44
2012-01-07,2012,January,20,Saturday,Spring,Clear,170,149,21
2012-01-07,2012,January,21,Saturday,Spring,Clear,140,118,22
2012-01-07,2012,January,22,Saturday,Spring,Clear,109,93,16
2012-01-07,2012,January,23,Saturday,Spring,Clear,119,103,16
2012-01-08,2012,January,0,Sunday,Spring,Clear,91,77,14
2012-01-08,2012,January,1,Sunday,Spring,Clear,72,62,10
2012-01-08,2012,January,2,Sunday,Spring,Clear,67,57,10
2012-01-08,2012,January,3,Sunday,Spring,Clear,32,26,6
2012-01-08,2012,January,4,Sunday,Spring,Clear,6,4,2
2012-01-08,2012,January,5,Sunday,Spring,Cloudy,2,2,0
2012-01-08,2012,January,6,Sunday,Spring,Cloudy,2,2,0
2012-01-08,2012,January,7,Sunday,Spring,Cloudy,24,23,1
2012-01-08,2012,January,8,Sunday,Spring,Clear,57,53,4
2012-01-08,2012,January,9,Sunday,Spring,Clear,125,102,23
2012-01-08,2012,January,10,Sunday,Spring,Clear,208,181,27
2012-01-08,2012,January,11,Sunday,Spring,Clear,256,201,55
2012-01-08,2012,January,12,Sunday,Spring,Clear,351,273,78
2012-01-08,2012,January,13,Sunday,Spring,Clear,343,266,77
2012-01-08,2012,January,14,Sunday,Spring,Clear,328,253,75
2012-01-08,2012,January,15,Sunday,Spring,Clear,330,241,89
2012-01-08,2012,January,16,Sunday,Spring,Clear,314,256,58
2012-01-08,2012,January,17,Sunday,Spring,Clear,219,197,22
2012-01-08,2012,January,18,Sunday,Spring,Clear,181,162,19
2012-01-08,2012,January,19,Sunday,Spring,Clear,112,104,8
2012-01-08,2012,January,20,Sunday,Spring,Clear,126,119,7
2012-01-08,2012,January,21,Sunday,Spring,Clear,91,81,10
2012-01-08,2012,January,22,Sunday,Spring,Clear,58,54,4
2012-01-08,2012,January,23,Sunday,Spring,Clear,30,30,0
2012-01-09,2012,January,0,Monday,Spring,Clear,15,12,3
2012-01-09,2012,January,1,Monday,Spring,Clear,5,4,1
2012-01-09,2012,January,2,Monday,Spring,Clear,5,3,2
2012-01-09,2012,January,3,Monday,Spring,Clear,3,3,0
2012-01-09,2012,January,4,Monday,Spring,Clear,4,4,0
2012-01-09,2012,January,5,Monday,Spring,Cloudy,21,21,0
2012-01-09,2012,January,6,Monday,Spring,Cloudy,88,85,3
2012-01-09,2012,January,7,Monday,Spring,Cloudy,240,239,1
2012-01-09,2012,January,8,Monday,Spring,Cloudy,420,407,13
2012-01-09,2012,January,9,Monday,Spring,Cloudy,197,188,9
2012-01-09,2012,January,10,Monday,Spring,Clear,108,95,13
2012-01-09,2012,January,11,Monday,Spring,Cloudy,88,82,6
2012-01-09,2012,January,12,Monday,Spring,Cloudy,103,93,10
2012-01-09,2012,January,13,Monday,Spring,Cloudy,80,77,3
2012-01-09,2012,January,14,Monday,Spring,Light Snow/Rain,50,45,5
2012-01-09,2012,January,15,Monday,Spring,Light Snow/Rain,69,64,5
2012-01-09,2012,January,16,Monday,Spring,Light Snow/Rain,49,46,3
2012-01-09,2012,January,17,Monday,Spring,Light Snow/Rain,152,147,5
2012-01-09,2012,January,18,Monday,Spring,Heavy Rain/Ice Pallets,164,158,6
2012-01-09,2012,January,19,Monday,Spring,Light Snow/Rain,190,187,3
2012-01-09,2012,January,20,Monday,Spring,Cloudy,132,127,5
2012-01-09,2012,January,21,Monday,Spring,Cloudy,79,78,1
2012-01-09,2012,January,22,Monday,Spring,Cloudy,62,54,8
2012-01-09,2012,January,23,Monday,Spring,Cloudy,52,51,1
2012-01-10,2012,January,0,Tuesday,Spring,Cloudy,14,14,0
2012-01-10,2012,January,1,Tuesday,Spring,Cloudy,5,3,2
2012-01-10,2012,January,2,Tuesday,Spring,Cloudy,4,2,2
2012-01-10,2012,January,4,Tuesday,Spring,Cloudy,4,4,0
2012-01-10,2012,January,5,Tuesday,Spring,Clear,23,23,0
2012-01-10,2012,January,6,Tuesday,Spring,Cloudy,79,79,0
2012-01-10,2012,January,7,Tuesday,Spring,Cloudy,222,219,3
2012-01-10,2012,January,8,Tuesday,Spring,Cloudy,471,465,6
2012-01-10,2012,January,9,Tuesday,Spring,Cloudy,195,184,11
2012-01-10,2012,January,10,Tuesday,Spring,Cloudy,83,80,3
2012-01-10,2012,January,11,Tuesday,Spring,Clear,101,93,8
2012-01-10,2012,January,12,Tuesday,Spring,Clear,140,127,13
2012-01-10,2012,January,13,Tuesday,Spring,Clear,178,163,15
2012-01-10,2012,January,14,Tuesday,Spring,Clear,106,96,10
2012-01-10,2012,January,15,Tuesday,Spring,Clear,136,119,17
2012-01-10,2012,January,16,Tuesday,Spring,Clear,240,225,15
2012-01-10,2012,January,17,Tuesday,Spring,Clear,460,446,14
2012-01-10,2012,January,18,Tuesday,Spring,Clear,385,372,13
2012-01-10,2012,January,19,Tuesday,Spring,Clear,281,270,11
2012-01-10,2012,January,20,Tuesday,Spring,Clear,200,190,10
2012-01-10,2012,January,21,Tuesday,Spring,Clear,116,109,7
2012-01-10,2012,January,22,Tuesday,Spring,Clear,114,104,10
2012-01-10,2012,January,23,Tuesday,Spring,Clear,41,38,3
2012-01-11,2012,January,0,Wednesday,Spring,Clear,28,26,2
2012-01-11,2012,January,1,Wednesday,Spring,Clear,7,6,1
2012-01-11,2012,January,2,Wednesday,Spring,Clear,5,5,0
2012-01-11,2012,January,3,Wednesday,Spring,Clear,4,4,0
2012-01-11,2012,January,4,Wednesday,Spring,Clear,2,2,0
2012-01-11,2012,January,5,Wednesday,Spring,Clear,22,22,0
2012-01-11,2012,January,6,Wednesday,Spring,Clear,74,72,2
2012-01-11,2012,January,7,Wednesday,Spring,Clear,256,247,9
2012-01-11,2012,January,8,Wednesday,Spring,Clear,499,488,11
2012-01-11,2012,January,9,Wednesday,Spring,Cloudy,225,218,7
2012-01-11,2012,January,10,Wednesday,Spring,Cloudy,97,84,13
2012-01-11,2012,January,11,Wednesday,Spring,Cloudy,99,90,9
2012-01-11,2012,January,12,Wednesday,Spring,Light Snow/Rain,55,51,4
2012-01-11,2012,January,13,Wednesday,Spring,Light Snow/Rain,65,57,8
2012-01-11,2012,January,14,Wednesday,Spring,Light Snow/Rain,73,70,3
2012-01-11,2012,January,15,Wednesday,Spring,Cloudy,79,73,6
2012-01-11,2012,January,16,Wednesday,Spring,Cloudy,118,112,6
2012-01-11,2012,January,17,Wednesday,Spring,Light Snow/Rain,134,128,6
2012-01-11,2012,January,18,Wednesday,Spring,Light Snow/Rain,98,96,2
2012-01-11,2012,January,19,Wednesday,Spring,Light Snow/Rain,93,92,1
2012-01-11,2012,January,20,Wednesday,Spring,Light Snow/Rain,57,55,2
2012-01-11,2012,January,21,Wednesday,Spring,Light Snow/Rain,29,29,0
2012-01-11,2012,January,22,Wednesday,Spring,Light Snow/Rain,49,49,0
2012-01-11,2012,January,23,Wednesday,Spring,Light Snow/Rain,9,9,0
2012-01-12,2012,January,0,Thursday,Spring,Light Snow/Rain,3,3,0
2012-01-12,2012,January,1,Thursday,Spring,Light Snow/Rain,3,3,0
2012-01-12,2012,January,2,Thursday,Spring,Light Snow/Rain,2,1,1
2012-01-12,2012,January,3,Thursday,Spring,Light Snow/Rain,3,3,0
2012-01-12,2012,January,4,Thursday,Spring,Light Snow/Rain,2,2,0
2012-01-12,2012,January,5,Thursday,Spring,Light Snow/Rain,16,16,0
2012-01-12,2012,January,6,Thursday,Spring,Light Snow/Rain,89,88,1
2012-01-12,2012,January,7,Thursday,Spring,Cloudy,220,218,2
2012-01-12,2012,January,8,Thursday,Spring,Clear,508,497,11
2012-01-12,2012,January,9,Thursday,Spring,Clear,230,220,10
2012-01-12,2012,January,10,Thursday,Spring,Clear,90,84,6
2012-01-12,2012,January,11,Thursday,Spring,Cloudy,119,101,18
2012-01-12,2012,January,12,Thursday,Spring,Cloudy,144,130,14
2012-01-12,2012,January,13,Thursday,Spring,Clear,183,170,13
2012-01-12,2012,January,14,Thursday,Spring,Clear,156,132,24
2012-01-12,2012,January,15,Thursday,Spring,Clear,188,156,32
2012-01-12,2012,January,16,Thursday,Spring,Clear,281,248,33
2012-01-12,2012,January,17,Thursday,Spring,Clear,495,472,23
2012-01-12,2012,January,18,Thursday,Spring,Clear,421,399,22
2012-01-12,2012,January,19,Thursday,Spring,Cloudy,330,313,17
2012-01-12,2012,January,20,Thursday,Spring,Cloudy,240,229,11
2012-01-12,2012,January,21,Thursday,Spring,Clear,174,162,12
2012-01-12,2012,January,22,Thursday,Spring,Clear,133,121,12
2012-01-12,2012,January,23,Thursday,Spring,Clear,67,60,7
2012-01-13,2012,January,0,Friday,Spring,Cloudy,42,38,4
2012-01-13,2012,January,1,Friday,Spring,Cloudy,12,12,0
2012-01-13,2012,January,2,Friday,Spring,Clear,14,13,1
2012-01-13,2012,January,3,Friday,Spring,Clear,7,4,3
2012-01-13,2012,January,4,Friday,Spring,Light Snow/Rain,3,2,1
2012-01-13,2012,January,5,Friday,Spring,Cloudy,21,21,0
2012-01-13,2012,January,6,Friday,Spring,Cloudy,73,71,2
2012-01-13,2012,January,7,Friday,Spring,Clear,177,174,3
2012-01-13,2012,January,8,Friday,Spring,Clear,419,408,11
2012-01-13,2012,January,9,Friday,Spring,Clear,214,204,10
2012-01-13,2012,January,10,Friday,Spring,Clear,103,101,2
2012-01-13,2012,January,11,Friday,Spring,Clear,114,102,12
2012-01-13,2012,January,12,Friday,Spring,Clear,154,140,14
2012-01-13,2012,January,13,Friday,Spring,Clear,154,140,14
2012-01-13,2012,January,14,Friday,Spring,Clear,129,119,10
2012-01-13,2012,January,15,Friday,Spring,Clear,138,123,15
2012-01-13,2012,January,16,Friday,Spring,Clear,233,215,18
2012-01-13,2012,January,17,Friday,Spring,Clear,332,317,15
2012-01-13,2012,January,18,Friday,Spring,Clear,301,294,7
2012-01-13,2012,January,19,Friday,Spring,Clear,206,199,7
2012-01-13,2012,January,20,Friday,Spring,Clear,136,130,6
2012-01-13,2012,January,21,Friday,Spring,Clear,102,95,7
2012-01-13,2012,January,22,Friday,Spring,Clear,65,58,7
2012-01-13,2012,January,23,Friday,Spring,Clear,65,60,5
2012-01-14,2012,January,0,Saturday,Spring,Clear,44,42,2
2012-01-14,2012,January,1,Saturday,Spring,Clear,50,44,6
2012-01-14,2012,January,2,Saturday,Spring,Clear,38,32,6
2012-01-14,2012,January,3,Saturday,Spring,Clear,20,14,6
2012-01-14,2012,January,4,Saturday,Spring,Clear,3,3,0
2012-01-14,2012,January,5,Saturday,Spring,Clear,4,4,0
2012-01-14,2012,January,6,Saturday,Spring,Clear,5,5,0
2012-01-14,2012,January,7,Saturday,Spring,Clear,24,24,0
2012-01-14,2012,January,8,Saturday,Spring,Clear,92,89,3
2012-01-14,2012,January,9,Saturday,Spring,Clear,81,78,3
2012-01-14,2012,January,10,Saturday,Spring,Clear,149,135,14
2012-01-14,2012,January,11,Saturday,Spring,Clear,178,150,28
2012-01-14,2012,January,12,Saturday,Spring,Clear,219,189,30
2012-01-14,2012,January,13,Saturday,Spring,Clear,220,182,38
2012-01-14,2012,January,14,Saturday,Spring,Clear,231,179,52
2012-01-14,2012,January,15,Saturday,Spring,Clear,226,177,49
2012-01-14,2012,January,16,Saturday,Spring,Clear,206,178,28
2012-01-14,2012,January,17,Saturday,Spring,Clear,144,129,15
2012-01-14,2012,January,18,Saturday,Spring,Clear,143,122,21
2012-01-14,2012,January,19,Saturday,Spring,Clear,102,90,12
2012-01-14,2012,January,20,Saturday,Spring,Clear,103,95,8
2012-01-14,2012,January,21,Saturday,Spring,Clear,69,66,3
2012-01-14,2012,January,22,Saturday,Spring,Clear,66,62,4
2012-01-14,2012,January,23,Saturday,Spring,Clear,76,71,5
2012-01-15,2012,January,0,Sunday,Spring,Clear,59,50,9
2012-01-15,2012,January,1,Sunday,Spring,Cloudy,42,40,2
2012-01-15,2012,January,2,Sunday,Spring,Cloudy,43,38,5
2012-01-15,2012,January,3,Sunday,Spring,Cloudy,25,24,1
2012-01-15,2012,January,4,Sunday,Spring,Cloudy,6,5,1
2012-01-15,2012,January,5,Sunday,Spring,Cloudy,5,5,0
2012-01-15,2012,January,6,Sunday,Spring,Cloudy,8,7,1
2012-01-15,2012,January,7,Sunday,Spring,Clear,17,14,3
2012-01-15,2012,January,8,Sunday,Spring,Clear,36,34,2
2012-01-15,2012,January,9,Sunday,Spring,Clear,90,80,10
2012-01-15,2012,January,10,Sunday,Spring,Clear,126,115,11
2012-01-15,2012,January,11,Sunday,Spring,Clear,165,144,21
2012-01-15,2012,January,12,Sunday,Spring,Clear,234,192,42
2012-01-15,2012,January,13,Sunday,Spring,Clear,224,184,40
2012-01-15,2012,January,14,Sunday,Spring,Clear,188,163,25
2012-01-15,2012,January,15,Sunday,Spring,Clear,206,173,33
2012-01-15,2012,January,16,Sunday,Spring,Clear,205,174,31
2012-01-15,2012,January,17,Sunday,Spring,Clear,146,131,15
2012-01-15,2012,January,18,Sunday,Spring,Clear,120,113,7
2012-01-15,2012,January,19,Sunday,Spring,Clear,110,101,9
2012-01-15,2012,January,20,Sunday,Spring,Clear,95,85,10
2012-01-15,2012,January,21,Sunday,Spring,Clear,72,71,1
2012-01-15,2012,January,22,Sunday,Spring,Clear,60,58,2
2012-01-15,2012,January,23,Sunday,Spring,Clear,29,26,3
2012-01-16,2012,January,0,Monday,Spring,Clear,25,23,2
2012-01-16,2012,January,1,Monday,Spring,Clear,20,18,2
2012-01-16,2012,January,2,Monday,Spring,Clear,17,14,3
2012-01-16,2012,January,3,Monday,Spring,Clear,3,3,0
2012-01-16,2012,January,4,Monday,Spring,Clear,8,6,2
2012-01-16,2012,January,5,Monday,Spring,Clear,6,5,1
2012-01-16,2012,January,6,Monday,Spring,Clear,13,13,0
2012-01-16,2012,January,7,Monday,Spring,Clear,33,28,5
2012-01-16,2012,January,8,Monday,Spring,Clear,78,75,3
2012-01-16,2012,January,9,Monday,Spring,Clear,96,89,7
2012-01-16,2012,January,10,Monday,Spring,Cloudy,126,107,19
2012-01-16,2012,January,11,Monday,Spring,Clear,179,158,21
2012-01-16,2012,January,12,Monday,Spring,Clear,185,165,20
2012-01-16,2012,January,13,Monday,Spring,Cloudy,228,202,26
2012-01-16,2012,January,14,Monday,Spring,Clear,181,158,23
2012-01-16,2012,January,15,Monday,Spring,Clear,192,175,17
2012-01-16,2012,January,16,Monday,Spring,Clear,180,158,22
2012-01-16,2012,January,17,Monday,Spring,Clear,193,174,19
2012-01-16,2012,January,18,Monday,Spring,Clear,181,175,6
2012-01-16,2012,January,19,Monday,Spring,Clear,144,134,10
2012-01-16,2012,January,20,Monday,Spring,Clear,90,88,2
2012-01-16,2012,January,21,Monday,Spring,Clear,49,46,3
2012-01-16,2012,January,22,Monday,Spring,Cloudy,43,39,4
2012-01-16,2012,January,23,Monday,Spring,Light Snow/Rain,28,28,0
2012-01-17,2012,January,0,Tuesday,Spring,Cloudy,12,12,0
2012-01-17,2012,January,1,Tuesday,Spring,Cloudy,2,2,0
2012-01-17,2012,January,2,Tuesday,Spring,Light Snow/Rain,12,12,0
2012-01-17,2012,January,4,Tuesday,Spring,Light Snow/Rain,2,2,0
2012-01-17,2012,January,5,Tuesday,Spring,Light Snow/Rain,13,13,0
2012-01-17,2012,January,6,Tuesday,Spring,Light Snow/Rain,57,57,0
2012-01-17,2012,January,7,Tuesday,Spring,Light Snow/Rain,126,121,5
2012-01-17,2012,January,8,Tuesday,Spring,Light Snow/Rain,93,90,3
2012-01-17,2012,January,9,Tuesday,Spring,Light Snow/Rain,68,61,7
2012-01-17,2012,January,10,Tuesday,Spring,Light Snow/Rain,62,61,1
2012-01-17,2012,January,11,Tuesday,Spring,Cloudy,75,73,2
2012-01-17,2012,January,12,Tuesday,Spring,Cloudy,86,83,3
2012-01-17,2012,January,13,Tuesday,Spring,Cloudy,103,95,8
2012-01-17,2012,January,14,Tuesday,Spring,Clear,132,120,12
2012-01-17,2012,January,15,Tuesday,Spring,Clear,129,123,6
2012-01-17,2012,January,16,Tuesday,Spring,Clear,219,205,14
2012-01-17,2012,January,17,Tuesday,Spring,Clear,462,442,20
2012-01-17,2012,January,18,Tuesday,Spring,Clear,463,451,12
2012-01-17,2012,January,19,Tuesday,Spring,Clear,308,297,11
2012-01-17,2012,January,20,Tuesday,Spring,Clear,180,169,11
2012-01-17,2012,January,21,Tuesday,Spring,Clear,180,174,6
2012-01-17,2012,January,22,Tuesday,Spring,Clear,90,85,5
2012-01-17,2012,January,23,Tuesday,Spring,Clear,61,60,1
2012-01-18,2012,January,0,Wednesday,Spring,Cloudy,17,14,3
2012-01-18,2012,January,1,Wednesday,Spring,Cloudy,10,10,0
2012-01-18,2012,January,2,Wednesday,Spring,Cloudy,2,1,1
2012-01-18,2012,January,3,Wednesday,Spring,Cloudy,4,3,1
2012-01-18,2012,January,4,Wednesday,Spring,Clear,1,1,0
2012-01-18,2012,January,5,Wednesday,Spring,Clear,29,29,0
2012-01-18,2012,January,6,Wednesday,Spring,Clear,88,88,0
2012-01-18,2012,January,7,Wednesday,Spring,Clear,263,262,1
2012-01-18,2012,January,8,Wednesday,Spring,Clear,489,474,15
2012-01-18,2012,January,9,Wednesday,Spring,Clear,202,196,6
2012-01-18,2012,January,10,Wednesday,Spring,Clear,93,88,5
2012-01-18,2012,January,11,Wednesday,Spring,Clear,114,110,4
2012-01-18,2012,January,12,Wednesday,Spring,Clear,161,155,6
2012-01-18,2012,January,13,Wednesday,Spring,Clear,130,124,6
2012-01-18,2012,January,14,Wednesday,Spring,Clear,105,98,7
2012-01-18,2012,January,15,Wednesday,Spring,Clear,130,122,8
2012-01-18,2012,January,16,Wednesday,Spring,Clear,176,163,13
2012-01-18,2012,January,17,Wednesday,Spring,Clear,346,338,8
2012-01-18,2012,January,18,Wednesday,Spring,Clear,355,347,8
2012-01-18,2012,January,19,Wednesday,Spring,Clear,256,251,5
2012-01-18,2012,January,20,Wednesday,Spring,Clear,165,164,1
2012-01-18,2012,January,21,Wednesday,Spring,Clear,124,119,5
2012-01-18,2012,January,22,Wednesday,Spring,Clear,78,74,4
2012-01-18,2012,January,23,Wednesday,Spring,Clear,38,36,2
2012-01-19,2012,January,0,Thursday,Spring,Clear,16,16,0
2012-01-19,2012,January,1,Thursday,Spring,Clear,5,5,0
2012-01-19,2012,January,2,Thursday,Spring,Clear,3,3,0
2012-01-19,2012,January,3,Thursday,Spring,Clear,4,4,0
2012-01-19,2012,January,4,Thursday,Spring,Clear,1,1,0
2012-01-19,2012,January,5,Thursday,Spring,Clear,19,19,0
2012-01-19,2012,January,6,Thursday,Spring,Clear,86,86,0
2012-01-19,2012,January,7,Thursday,Spring,Clear,206,204,2
2012-01-19,2012,January,8,Thursday,Spring,Clear,423,414,9
2012-01-19,2012,January,9,Thursday,Spring,Clear,210,204,6
2012-01-19,2012,January,10,Thursday,Spring,Clear,108,98,10
2012-01-19,2012,January,11,Thursday,Spring,Clear,99,93,6
2012-01-19,2012,January,12,Thursday,Spring,Clear,111,106,5
2012-01-19,2012,January,13,Thursday,Spring,Clear,124,118,6
2012-01-19,2012,January,14,Thursday,Spring,Clear,119,104,15
2012-01-19,2012,January,15,Thursday,Spring,Clear,127,118,9
2012-01-19,2012,January,16,Thursday,Spring,Clear,193,185,8
2012-01-19,2012,January,17,Thursday,Spring,Cloudy,385,364,21
2012-01-19,2012,January,18,Thursday,Spring,Cloudy,361,345,16
2012-01-19,2012,January,19,Thursday,Spring,Cloudy,234,229,5
2012-01-19,2012,January,20,Thursday,Spring,Clear,191,184,7
2012-01-19,2012,January,21,Thursday,Spring,Clear,121,117,4
2012-01-19,2012,January,22,Thursday,Spring,Cloudy,90,90,0
2012-01-19,2012,January,23,Thursday,Spring,Clear,56,55,1
2012-01-20,2012,January,0,Friday,Spring,Cloudy,27,24,3
2012-01-20,2012,January,1,Friday,Spring,Clear,15,15,0
2012-01-20,2012,January,2,Friday,Spring,Clear,11,11,0
2012-01-20,2012,January,3,Friday,Spring,Clear,4,4,0
2012-01-20,2012,January,4,Friday,Spring,Clear,3,3,0
2012-01-20,2012,January,5,Friday,Spring,Clear,19,19,0
2012-01-20,2012,January,6,Friday,Spring,Clear,68,68,0
2012-01-20,2012,January,7,Friday,Spring,Clear,185,183,2
2012-01-20,2012,January,8,Friday,Spring,Clear,425,421,4
2012-01-20,2012,January,9,Friday,Spring,Clear,263,242,21
2012-01-20,2012,January,10,Friday,Spring,Cloudy,97,96,1
2012-01-20,2012,January,11,Friday,Spring,Cloudy,123,117,6
2012-01-20,2012,January,12,Friday,Spring,Cloudy,124,119,5
2012-01-20,2012,January,13,Friday,Spring,Clear,156,144,12
2012-01-20,2012,January,14,Friday,Spring,Cloudy,115,107,8
2012-01-20,2012,January,15,Friday,Spring,Cloudy,156,144,12
2012-01-20,2012,January,16,Friday,Spring,Cloudy,174,163,11
2012-01-20,2012,January,17,Friday,Spring,Cloudy,349,340,9
2012-01-20,2012,January,18,Friday,Spring,Cloudy,301,296,5
2012-01-20,2012,January,19,Friday,Spring,Cloudy,192,186,6
2012-01-20,2012,January,20,Friday,Spring,Cloudy,142,141,1
2012-01-20,2012,January,21,Friday,Spring,Cloudy,104,99,5
2012-01-20,2012,January,22,Friday,Spring,Cloudy,72,71,1
2012-01-20,2012,January,23,Friday,Spring,Light Snow/Rain,38,35,3
2012-01-21,2012,January,0,Saturday,Spring,Light Snow/Rain,24,24,0
2012-01-21,2012,January,1,Saturday,Spring,Heavy Rain/Ice Pallets,23,22,1
2012-01-21,2012,January,2,Saturday,Spring,Light Snow/Rain,26,25,1
2012-01-21,2012,January,3,Saturday,Spring,Light Snow/Rain,13,13,0
2012-01-21,2012,January,4,Saturday,Spring,Light Snow/Rain,1,1,0
2012-01-21,2012,January,5,Saturday,Spring,Light Snow/Rain,2,2,0
2012-01-21,2012,January,6,Saturday,Spring,Light Snow/Rain,1,1,0
2012-01-21,2012,January,7,Saturday,Spring,Light Snow/Rain,13,10,3
2012-01-21,2012,January,8,Saturday,Spring,Cloudy,25,22,3
2012-01-21,2012,January,9,Saturday,Spring,Cloudy,42,40,2
2012-01-21,2012,January,10,Saturday,Spring,Light Snow/Rain,45,45,0
2012-01-21,2012,January,11,Saturday,Spring,Cloudy,63,62,1
2012-01-21,2012,January,12,Saturday,Spring,Cloudy,67,62,5
2012-01-21,2012,January,13,Saturday,Spring,Cloudy,76,66,10
2012-01-21,2012,January,14,Saturday,Spring,Light Snow/Rain,95,89,6
2012-01-21,2012,January,15,Saturday,Spring,Light Snow/Rain,119,113,6
2012-01-21,2012,January,16,Saturday,Spring,Cloudy,118,113,5
2012-01-21,2012,January,17,Saturday,Spring,Cloudy,106,99,7
2012-01-21,2012,January,18,Saturday,Spring,Cloudy,110,107,3
2012-01-21,2012,January,19,Saturday,Spring,Cloudy,85,85,0
2012-01-21,2012,January,20,Saturday,Spring,Cloudy,67,62,5
2012-01-21,2012,January,21,Saturday,Spring,Clear,69,64,5
2012-01-21,2012,January,22,Saturday,Spring,Cloudy,59,56,3
2012-01-21,2012,January,23,Saturday,Spring,Cloudy,52,51,1
2012-01-22,2012,January,0,Sunday,Spring,Clear,52,51,1
2012-01-22,2012,January,1,Sunday,Spring,Cloudy,50,49,1
2012-01-22,2012,January,2,Sunday,Spring,Cloudy,47,46,1
2012-01-22,2012,January,3,Sunday,Spring,Cloudy,21,20,1
2012-01-22,2012,January,4,Sunday,Spring,Light Snow/Rain,2,1,1
2012-01-22,2012,January,5,Sunday,Spring,Light Snow/Rain,3,2,1
2012-01-22,2012,January,6,Sunday,Spring,Cloudy,4,4,0
2012-01-22,2012,January,7,Sunday,Spring,Cloudy,13,11,2
2012-01-22,2012,January,8,Sunday,Spring,Cloudy,32,29,3
2012-01-22,2012,January,9,Sunday,Spring,Cloudy,63,54,9
2012-01-22,2012,January,10,Sunday,Spring,Cloudy,129,120,9
2012-01-22,2012,January,11,Sunday,Spring,Light Snow/Rain,133,115,18
2012-01-22,2012,January,12,Sunday,Spring,Cloudy,185,161,24
2012-01-22,2012,January,13,Sunday,Spring,Cloudy,199,175,24
2012-01-22,2012,January,14,Sunday,Spring,Cloudy,182,163,19
2012-01-22,2012,January,15,Sunday,Spring,Cloudy,176,149,27
2012-01-22,2012,January,16,Sunday,Spring,Cloudy,155,143,12
2012-01-22,2012,January,17,Sunday,Spring,Cloudy,108,100,8
2012-01-22,2012,January,18,Sunday,Spring,Light Snow/Rain,121,110,11
2012-01-22,2012,January,19,Sunday,Spring,Light Snow/Rain,89,80,9
2012-01-22,2012,January,20,Sunday,Spring,Light Snow/Rain,74,69,5
2012-01-22,2012,January,21,Sunday,Spring,Light Snow/Rain,44,36,8
2012-01-22,2012,January,22,Sunday,Spring,Cloudy,58,58,0
2012-01-22,2012,January,23,Sunday,Spring,Cloudy,37,35,2
2012-01-23,2012,January,0,Monday,Spring,Cloudy,19,17,2
2012-01-23,2012,January,1,Monday,Spring,Cloudy,4,4,0
2012-01-23,2012,January,2,Monday,Spring,Cloudy,2,2,0
2012-01-23,2012,January,3,Monday,Spring,Cloudy,1,1,0
2012-01-23,2012,January,4,Monday,Spring,Cloudy,1,1,0
2012-01-23,2012,January,5,Monday,Spring,Cloudy,19,19,0
2012-01-23,2012,January,6,Monday,Spring,Cloudy,42,36,6
2012-01-23,2012,January,7,Monday,Spring,Light Snow/Rain,122,114,8
2012-01-23,2012,January,8,Monday,Spring,Light Snow/Rain,272,267,5
2012-01-23,2012,January,9,Monday,Spring,Cloudy,211,198,13
2012-01-23,2012,January,10,Monday,Spring,Cloudy,149,139,10
2012-01-23,2012,January,11,Monday,Spring,Cloudy,62,57,5
2012-01-23,2012,January,12,Monday,Spring,Cloudy,62,52,10
2012-01-23,2012,January,13,Monday,Spring,Light Snow/Rain,37,32,5
2012-01-23,2012,January,14,Monday,Spring,Light Snow/Rain,61,48,13
2012-01-23,2012,January,15,Monday,Spring,Cloudy,74,64,10
2012-01-23,2012,January,16,Monday,Spring,Cloudy,122,108,14
2012-01-23,2012,January,17,Monday,Spring,Cloudy,276,270,6
2012-01-23,2012,January,18,Monday,Spring,Cloudy,282,275,7
2012-01-23,2012,January,19,Monday,Spring,Cloudy,220,211,9
2012-01-23,2012,January,20,Monday,Spring,Cloudy,169,161,8
2012-01-23,2012,January,21,Monday,Spring,Cloudy,120,112,8
2012-01-23,2012,January,22,Monday,Spring,Cloudy,68,64,4
2012-01-23,2012,January,23,Monday,Spring,Cloudy,37,35,2
2012-01-24,2012,January,0,Tuesday,Spring,Cloudy,25,19,6
2012-01-24,2012,January,1,Tuesday,Spring,Cloudy,9,7,2
2012-01-24,2012,January,2,Tuesday,Spring,Cloudy,8,6,2
2012-01-24,2012,January,3,Tuesday,Spring,Cloudy,3,3,0
2012-01-24,2012,January,4,Tuesday,Spring,Cloudy,2,2,0
2012-01-24,2012,January,5,Tuesday,Spring,Cloudy,26,26,0
2012-01-24,2012,January,6,Tuesday,Spring,Cloudy,89,88,1
2012-01-24,2012,January,7,Tuesday,Spring,Cloudy,232,221,11
2012-01-24,2012,January,8,Tuesday,Spring,Cloudy,490,479,11
2012-01-24,2012,January,9,Tuesday,Spring,Cloudy,255,244,11
2012-01-24,2012,January,10,Tuesday,Spring,Clear,116,93,23
2012-01-24,2012,January,11,Tuesday,Spring,Clear,153,123,30
2012-01-24,2012,January,12,Tuesday,Spring,Clear,175,150,25
2012-01-24,2012,January,13,Tuesday,Spring,Clear,203,170,33
2012-01-24,2012,January,14,Tuesday,Spring,Clear,173,138,35
2012-01-24,2012,January,15,Tuesday,Spring,Cloudy,208,156,52
2012-01-24,2012,January,16,Tuesday,Spring,Clear,278,243,35
2012-01-24,2012,January,17,Tuesday,Spring,Clear,515,474,41
2012-01-24,2012,January,18,Tuesday,Spring,Clear,423,391,32
2012-01-24,2012,January,19,Tuesday,Spring,Clear,331,311,20
2012-01-24,2012,January,20,Tuesday,Spring,Clear,229,211,18
2012-01-24,2012,January,21,Tuesday,Spring,Clear,172,154,18
2012-01-24,2012,January,22,Tuesday,Spring,Clear,125,111,14
2012-01-24,2012,January,23,Tuesday,Spring,Clear,99,80,19
2012-01-25,2012,January,0,Wednesday,Spring,Clear,31,25,6
2012-01-25,2012,January,1,Wednesday,Spring,Clear,13,9,4
2012-01-25,2012,January,2,Wednesday,Spring,Clear,6,3,3
2012-01-25,2012,January,3,Wednesday,Spring,Clear,1,1,0
2012-01-25,2012,January,4,Wednesday,Spring,Clear,4,4,0
2012-01-25,2012,January,5,Wednesday,Spring,Clear,33,33,0
2012-01-25,2012,January,6,Wednesday,Spring,Clear,88,87,1
2012-01-25,2012,January,7,Wednesday,Spring,Clear,257,243,14
2012-01-25,2012,January,8,Wednesday,Spring,Clear,513,495,18
2012-01-25,2012,January,9,Wednesday,Spring,Clear,236,218,18
2012-01-25,2012,January,10,Wednesday,Spring,Cloudy,141,111,30
2012-01-25,2012,January,11,Wednesday,Spring,Cloudy,157,105,52
2012-01-25,2012,January,12,Wednesday,Spring,Clear,193,147,46
2012-01-25,2012,January,13,Wednesday,Spring,Clear,212,149,63
2012-01-25,2012,January,14,Wednesday,Spring,Clear,160,107,53
2012-01-25,2012,January,15,Wednesday,Spring,Clear,155,125,30
2012-01-25,2012,January,16,Wednesday,Spring,Clear,246,217,29
2012-01-25,2012,January,17,Wednesday,Spring,Clear,470,443,27
2012-01-25,2012,January,18,Wednesday,Spring,Clear,439,415,24
2012-01-25,2012,January,19,Wednesday,Spring,Cloudy,316,311,5
2012-01-25,2012,January,20,Wednesday,Spring,Clear,235,225,10
2012-01-25,2012,January,21,Wednesday,Spring,Clear,185,166,19
2012-01-25,2012,January,22,Wednesday,Spring,Clear,113,101,12
2012-01-25,2012,January,23,Wednesday,Spring,Cloudy,66,63,3
2012-01-26,2012,January,0,Thursday,Spring,Cloudy,25,22,3
2012-01-26,2012,January,1,Thursday,Spring,Cloudy,21,16,5
2012-01-26,2012,January,2,Thursday,Spring,Cloudy,7,6,1
2012-01-26,2012,January,3,Thursday,Spring,Cloudy,6,5,1
2012-01-26,2012,January,4,Thursday,Spring,Clear,3,3,0
2012-01-26,2012,January,5,Thursday,Spring,Cloudy,28,28,0
2012-01-26,2012,January,6,Thursday,Spring,Cloudy,88,88,0
2012-01-26,2012,January,7,Thursday,Spring,Cloudy,239,228,11
2012-01-26,2012,January,8,Thursday,Spring,Cloudy,530,514,16
2012-01-26,2012,January,9,Thursday,Spring,Cloudy,274,256,18
2012-01-26,2012,January,10,Thursday,Spring,Cloudy,108,92,16
2012-01-26,2012,January,11,Thursday,Spring,Cloudy,111,100,11
2012-01-26,2012,January,12,Thursday,Spring,Cloudy,165,136,29
2012-01-26,2012,January,13,Thursday,Spring,Cloudy,173,156,17
2012-01-26,2012,January,14,Thursday,Spring,Cloudy,128,112,16
2012-01-26,2012,January,15,Thursday,Spring,Cloudy,164,142,22
2012-01-26,2012,January,16,Thursday,Spring,Cloudy,224,209,15
2012-01-26,2012,January,17,Thursday,Spring,Cloudy,413,397,16
2012-01-26,2012,January,18,Thursday,Spring,Cloudy,406,394,12
2012-01-26,2012,January,19,Thursday,Spring,Cloudy,313,302,11
2012-01-26,2012,January,20,Thursday,Spring,Cloudy,224,216,8
2012-01-26,2012,January,21,Thursday,Spring,Cloudy,192,184,8
2012-01-26,2012,January,22,Thursday,Spring,Clear,142,139,3
2012-01-26,2012,January,23,Thursday,Spring,Cloudy,91,86,5
2012-01-27,2012,January,0,Friday,Spring,Cloudy,38,32,6
2012-01-27,2012,January,1,Friday,Spring,Cloudy,29,23,6
2012-01-27,2012,January,2,Friday,Spring,Clear,13,11,2
2012-01-27,2012,January,3,Friday,Spring,Cloudy,8,5,3
2012-01-27,2012,January,4,Friday,Spring,Cloudy,4,3,1
2012-01-27,2012,January,5,Friday,Spring,Cloudy,24,24,0
2012-01-27,2012,January,6,Friday,Spring,Cloudy,72,72,0
2012-01-27,2012,January,7,Friday,Spring,Cloudy,134,128,6
2012-01-27,2012,January,8,Friday,Spring,Light Snow/Rain,220,206,14
2012-01-27,2012,January,9,Friday,Spring,Light Snow/Rain,107,101,6
2012-01-27,2012,January,10,Friday,Spring,Light Snow/Rain,126,117,9
2012-01-27,2012,January,11,Friday,Spring,Cloudy,105,95,10
2012-01-27,2012,January,12,Friday,Spring,Cloudy,180,155,25
2012-01-27,2012,January,13,Friday,Spring,Clear,201,175,26
2012-01-27,2012,January,14,Friday,Spring,Clear,176,153,23
2012-01-27,2012,January,15,Friday,Spring,Clear,197,170,27
2012-01-27,2012,January,16,Friday,Spring,Clear,267,241,26
2012-01-27,2012,January,17,Friday,Spring,Clear,422,406,16
2012-01-27,2012,January,18,Friday,Spring,Clear,383,363,20
2012-01-27,2012,January,19,Friday,Spring,Clear,251,241,10
2012-01-27,2012,January,20,Friday,Spring,Clear,159,153,6
2012-01-27,2012,January,21,Friday,Spring,Clear,135,127,8
2012-01-27,2012,January,22,Friday,Spring,Clear,119,108,11
2012-01-27,2012,January,23,Friday,Spring,Clear,86,78,8
2012-01-28,2012,January,0,Saturday,Spring,Clear,69,68,1
2012-01-28,2012,January,1,Saturday,Spring,Clear,58,57,1
2012-01-28,2012,January,2,Saturday,Spring,Clear,41,38,3
2012-01-28,2012,January,3,Saturday,Spring,Clear,17,16,1
2012-01-28,2012,January,4,Saturday,Spring,Clear,8,8,0
2012-01-28,2012,January,5,Saturday,Spring,Clear,10,10,0
2012-01-28,2012,January,6,Saturday,Spring,Clear,15,12,3
2012-01-28,2012,January,7,Saturday,Spring,Clear,31,28,3
2012-01-28,2012,January,8,Saturday,Spring,Clear,91,82,9
2012-01-28,2012,January,9,Saturday,Spring,Clear,158,145,13
2012-01-28,2012,January,10,Saturday,Spring,Clear,191,164,27
2012-01-28,2012,January,11,Saturday,Spring,Clear,296,241,55
2012-01-28,2012,January,12,Saturday,Spring,Clear,314,244,70
2012-01-28,2012,January,13,Saturday,Spring,Clear,373,293,80
2012-01-28,2012,January,14,Saturday,Spring,Clear,362,239,123
2012-01-28,2012,January,15,Saturday,Spring,Clear,410,320,90
2012-01-28,2012,January,16,Saturday,Spring,Clear,407,276,131
2012-01-28,2012,January,17,Saturday,Spring,Clear,290,233,57
2012-01-28,2012,January,18,Saturday,Spring,Clear,241,201,40
2012-01-28,2012,January,19,Saturday,Spring,Cloudy,206,173,33
2012-01-28,2012,January,20,Saturday,Spring,Clear,120,115,5
2012-01-28,2012,January,21,Saturday,Spring,Clear,127,109,18
2012-01-28,2012,January,22,Saturday,Spring,Clear,103,97,6
2012-01-28,2012,January,23,Saturday,Spring,Clear,85,79,6
2012-01-29,2012,January,0,Sunday,Spring,Clear,96,81,15
2012-01-29,2012,January,1,Sunday,Spring,Clear,73,68,5
2012-01-29,2012,January,2,Sunday,Spring,Clear,51,48,3
2012-01-29,2012,January,3,Sunday,Spring,Clear,21,17,4
2012-01-29,2012,January,4,Sunday,Spring,Clear,5,5,0
2012-01-29,2012,January,5,Sunday,Spring,Clear,7,6,1
2012-01-29,2012,January,6,Sunday,Spring,Clear,5,4,1
2012-01-29,2012,January,7,Sunday,Spring,Clear,12,12,0
2012-01-29,2012,January,8,Sunday,Spring,Clear,70,61,9
2012-01-29,2012,January,9,Sunday,Spring,Clear,111,98,13
2012-01-29,2012,January,10,Sunday,Spring,Clear,191,153,38
2012-01-29,2012,January,11,Sunday,Spring,Clear,255,198,57
2012-01-29,2012,January,12,Sunday,Spring,Clear,288,215,73
2012-01-29,2012,January,13,Sunday,Spring,Clear,316,238,78
2012-01-29,2012,January,14,Sunday,Spring,Clear,280,229,51
2012-01-29,2012,January,15,Sunday,Spring,Clear,310,242,68
2012-01-29,2012,January,16,Sunday,Spring,Clear,322,268,54
2012-01-29,2012,January,17,Sunday,Spring,Clear,234,201,33
2012-01-29,2012,January,18,Sunday,Spring,Clear,168,151,17
2012-01-29,2012,January,19,Sunday,Spring,Clear,159,145,14
2012-01-29,2012,January,20,Sunday,Spring,Clear,111,98,13
2012-01-29,2012,January,21,Sunday,Spring,Clear,69,69,0
2012-01-29,2012,January,22,Sunday,Spring,Clear,64,57,7
2012-01-29,2012,January,23,Sunday,Spring,Clear,25,21,4
2012-01-30,2012,January,0,Monday,Spring,Cloudy,10,10,0
2012-01-30,2012,January,1,Monday,Spring,Clear,9,9,0
2012-01-30,2012,January,2,Monday,Spring,Clear,7,6,1
2012-01-30,2012,January,3,Monday,Spring,Clear,4,4,0
2012-01-30,2012,January,4,Monday,Spring,Clear,5,5,0
2012-01-30,2012,January,5,Monday,Spring,Clear,26,26,0
2012-01-30,2012,January,6,Monday,Spring,Clear,80,80,0
2012-01-30,2012,January,7,Monday,Spring,Clear,225,221,4
2012-01-30,2012,January,8,Monday,Spring,Clear,493,481,12
2012-01-30,2012,January,9,Monday,Spring,Clear,198,193,5
2012-01-30,2012,January,10,Monday,Spring,Clear,85,82,3
2012-01-30,2012,January,11,Monday,Spring,Clear,99,93,6
2012-01-30,2012,January,12,Monday,Spring,Clear,134,129,5
2012-01-30,2012,January,13,Monday,Spring,Clear,132,117,15
2012-01-30,2012,January,14,Monday,Spring,Clear,115,100,15
2012-01-30,2012,January,15,Monday,Spring,Clear,138,131,7
2012-01-30,2012,January,16,Monday,Spring,Clear,221,210,11
2012-01-30,2012,January,17,Monday,Spring,Clear,438,422,16
2012-01-30,2012,January,18,Monday,Spring,Clear,410,399,11
2012-01-30,2012,January,19,Monday,Spring,Clear,306,298,8
2012-01-30,2012,January,20,Monday,Spring,Clear,181,179,2
2012-01-30,2012,January,21,Monday,Spring,Clear,162,159,3
2012-01-30,2012,January,22,Monday,Spring,Clear,94,92,2
2012-01-30,2012,January,23,Monday,Spring,Clear,52,52,0
2012-01-31,2012,January,0,Tuesday,Spring,Clear,15,15,0
2012-01-31,2012,January,1,Tuesday,Spring,Clear,8,7,1
2012-01-31,2012,January,2,Tuesday,Spring,Clear,2,2,0
2012-01-31,2012,January,3,Tuesday,Spring,Clear,2,2,0
2012-01-31,2012,January,4,Tuesday,Spring,Clear,1,1,0
2012-01-31,2012,January,5,Tuesday,Spring,Clear,22,22,0
2012-01-31,2012,January,6,Tuesday,Spring,Clear,104,104,0
2012-01-31,2012,January,7,Tuesday,Spring,Clear,279,273,6
2012-01-31,2012,January,8,Tuesday,Spring,Clear,512,498,14
2012-01-31,2012,January,9,Tuesday,Spring,Clear,261,231,30
2012-01-31,2012,January,10,Tuesday,Spring,Cloudy,144,110,34
2012-01-31,2012,January,11,Tuesday,Spring,Clear,139,125,14
2012-01-31,2012,January,12,Tuesday,Spring,Clear,194,181,13
2012-01-31,2012,January,13,Tuesday,Spring,Clear,198,171,27
2012-01-31,2012,January,14,Tuesday,Spring,Clear,160,142,18
2012-01-31,2012,January,15,Tuesday,Spring,Clear,177,150,27
2012-01-31,2012,January,16,Tuesday,Spring,Clear,307,277,30
2012-01-31,2012,January,17,Tuesday,Spring,Clear,559,518,41
2012-01-31,2012,January,18,Tuesday,Spring,Clear,502,486,16
2012-01-31,2012,January,19,Tuesday,Spring,Clear,328,306,22
2012-01-31,2012,January,20,Tuesday,Spring,Clear,238,223,15
2012-01-31,2012,January,21,Tuesday,Spring,Clear,165,162,3
2012-01-31,2012,January,22,Tuesday,Spring,Clear,129,118,11
2012-01-31,2012,January,23,Tuesday,Spring,Clear,63,61,2
2012-02-01,2012,February,0,Wednesday,Spring,Clear,31,31,0
2012-02-01,2012,February,1,Wednesday,Spring,Clear,4,4,0
2012-02-01,2012,February,2,Wednesday,Spring,Clear,7,6,1
2012-02-01,2012,February,3,Wednesday,Spring,Clear,3,3,0
2012-02-01,2012,February,4,Wednesday,Spring,Clear,1,1,0
2012-02-01,2012,February,5,Wednesday,Spring,Clear,18,18,0
2012-02-01,2012,February,6,Wednesday,Spring,Light Snow/Rain,67,67,0
2012-02-01,2012,February,7,Wednesday,Spring,Light Snow/Rain,208,201,7
2012-02-01,2012,February,8,Wednesday,Spring,Light Snow/Rain,520,505,15
2012-02-01,2012,February,9,Wednesday,Spring,Cloudy,276,267,9
2012-02-01,2012,February,10,Wednesday,Spring,Clear,133,124,9
2012-02-01,2012,February,11,Wednesday,Spring,Clear,143,116,27
2012-02-01,2012,February,12,Wednesday,Spring,Clear,179,153,26
2012-02-01,2012,February,13,Wednesday,Spring,Clear,186,174,12
2012-02-01,2012,February,14,Wednesday,Spring,Clear,192,159,33
2012-02-01,2012,February,15,Wednesday,Spring,Clear,194,169,25
2012-02-01,2012,February,16,Wednesday,Spring,Clear,283,261,22
2012-02-01,2012,February,17,Wednesday,Spring,Clear,539,508,31
2012-02-01,2012,February,18,Wednesday,Spring,Clear,526,514,12
2012-02-01,2012,February,19,Wednesday,Spring,Clear,335,315,20
2012-02-01,2012,February,20,Wednesday,Spring,Clear,264,254,10
2012-02-01,2012,February,21,Wednesday,Spring,Clear,233,217,16
2012-02-01,2012,February,22,Wednesday,Spring,Clear,140,133,7
2012-02-01,2012,February,23,Wednesday,Spring,Clear,97,75,22
2012-02-02,2012,February,0,Thursday,Spring,Clear,31,24,7
2012-02-02,2012,February,1,Thursday,Spring,Cloudy,17,14,3
2012-02-02,2012,February,2,Thursday,Spring,Cloudy,9,7,2
2012-02-02,2012,February,3,Thursday,Spring,Cloudy,2,2,0
2012-02-02,2012,February,4,Thursday,Spring,Light Snow/Rain,1,1,0
2012-02-02,2012,February,5,Thursday,Spring,Light Snow/Rain,19,19,0
2012-02-02,2012,February,6,Thursday,Spring,Light Snow/Rain,74,73,1
2012-02-02,2012,February,7,Thursday,Spring,Light Snow/Rain,205,201,4
2012-02-02,2012,February,8,Thursday,Spring,Light Snow/Rain,445,436,9
2012-02-02,2012,February,9,Thursday,Spring,Light Snow/Rain,228,213,15
2012-02-02,2012,February,10,Thursday,Spring,Light Snow/Rain,78,72,6
2012-02-02,2012,February,11,Thursday,Spring,Light Snow/Rain,105,99,6
2012-02-02,2012,February,12,Thursday,Spring,Clear,148,140,8
2012-02-02,2012,February,13,Thursday,Spring,Cloudy,137,124,13
2012-02-02,2012,February,14,Thursday,Spring,Clear,141,129,12
2012-02-02,2012,February,15,Thursday,Spring,Clear,174,150,24
2012-02-02,2012,February,16,Thursday,Spring,Clear,229,211,18
2012-02-02,2012,February,17,Thursday,Spring,Clear,450,437,13
2012-02-02,2012,February,18,Thursday,Spring,Clear,410,393,17
2012-02-02,2012,February,19,Thursday,Spring,Clear,327,311,16
2012-02-02,2012,February,20,Thursday,Spring,Clear,213,204,9
2012-02-02,2012,February,21,Thursday,Spring,Clear,148,144,4
2012-02-02,2012,February,22,Thursday,Spring,Clear,109,106,3
2012-02-02,2012,February,23,Thursday,Spring,Clear,61,61,0
2012-02-03,2012,February,0,Friday,Spring,Clear,38,37,1
2012-02-03,2012,February,1,Friday,Spring,Clear,22,19,3
2012-02-03,2012,February,2,Friday,Spring,Clear,6,6,0
2012-02-03,2012,February,3,Friday,Spring,Clear,4,4,0
2012-02-03,2012,February,4,Friday,Spring,Clear,2,2,0
2012-02-03,2012,February,5,Friday,Spring,Clear,17,17,0
2012-02-03,2012,February,6,Friday,Spring,Clear,88,88,0
2012-02-03,2012,February,7,Friday,Spring,Clear,226,216,10
2012-02-03,2012,February,8,Friday,Spring,Clear,441,429,12
2012-02-03,2012,February,9,Friday,Spring,Clear,270,252,18
2012-02-03,2012,February,10,Friday,Spring,Clear,129,114,15
2012-02-03,2012,February,11,Friday,Spring,Clear,164,149,15
2012-02-03,2012,February,12,Friday,Spring,Clear,216,191,25
2012-02-03,2012,February,13,Friday,Spring,Clear,198,173,25
2012-02-03,2012,February,14,Friday,Spring,Clear,170,148,22
2012-02-03,2012,February,15,Friday,Spring,Clear,216,168,48
2012-02-03,2012,February,16,Friday,Spring,Clear,311,275,36
2012-02-03,2012,February,17,Friday,Spring,Clear,488,458,30
2012-02-03,2012,February,18,Friday,Spring,Clear,385,368,17
2012-02-03,2012,February,19,Friday,Spring,Clear,267,256,11
2012-02-03,2012,February,20,Friday,Spring,Clear,163,155,8
2012-02-03,2012,February,21,Friday,Spring,Clear,134,126,8
2012-02-03,2012,February,22,Friday,Spring,Clear,119,116,3
2012-02-03,2012,February,23,Friday,Spring,Clear,77,74,3
2012-02-04,2012,February,0,Saturday,Spring,Clear,86,76,10
2012-02-04,2012,February,1,Saturday,Spring,Clear,43,43,0
2012-02-04,2012,February,2,Saturday,Spring,Clear,44,38,6
2012-02-04,2012,February,3,Saturday,Spring,Clear,18,17,1
2012-02-04,2012,February,4,Saturday,Spring,Clear,6,5,1
2012-02-04,2012,February,5,Saturday,Spring,Clear,4,3,1
2012-02-04,2012,February,6,Saturday,Spring,Clear,5,4,1
2012-02-04,2012,February,7,Saturday,Spring,Cloudy,28,27,1
2012-02-04,2012,February,8,Saturday,Spring,Clear,90,86,4
2012-02-04,2012,February,9,Saturday,Spring,Clear,157,141,16
2012-02-04,2012,February,10,Saturday,Spring,Clear,224,193,31
2012-02-04,2012,February,11,Saturday,Spring,Clear,270,224,46
2012-02-04,2012,February,12,Saturday,Spring,Cloudy,300,260,40
2012-02-04,2012,February,13,Saturday,Spring,Cloudy,302,244,58
2012-02-04,2012,February,14,Saturday,Spring,Cloudy,276,229,47
2012-02-04,2012,February,15,Saturday,Spring,Cloudy,305,244,61
2012-02-04,2012,February,16,Saturday,Spring,Cloudy,143,123,20
2012-02-04,2012,February,17,Saturday,Spring,Light Snow/Rain,67,54,13
2012-02-04,2012,February,18,Saturday,Spring,Light Snow/Rain,64,58,6
2012-02-04,2012,February,19,Saturday,Spring,Light Snow/Rain,80,75,5
2012-02-04,2012,February,20,Saturday,Spring,Light Snow/Rain,77,73,4
2012-02-04,2012,February,21,Saturday,Spring,Light Snow/Rain,78,74,4
2012-02-04,2012,February,22,Saturday,Spring,Cloudy,95,91,4
2012-02-04,2012,February,23,Saturday,Spring,Cloudy,70,66,4
2012-02-05,2012,February,0,Sunday,Spring,Cloudy,61,58,3
2012-02-05,2012,February,1,Sunday,Spring,Cloudy,51,46,5
2012-02-05,2012,February,2,Sunday,Spring,Cloudy,63,59,4
2012-02-05,2012,February,3,Sunday,Spring,Light Snow/Rain,17,13,4
2012-02-05,2012,February,4,Sunday,Spring,Cloudy,9,9,0
2012-02-05,2012,February,5,Sunday,Spring,Light Snow/Rain,4,4,0
2012-02-05,2012,February,6,Sunday,Spring,Cloudy,4,4,0
2012-02-05,2012,February,7,Sunday,Spring,Cloudy,16,16,0
2012-02-05,2012,February,8,Sunday,Spring,Cloudy,62,58,4
2012-02-05,2012,February,9,Sunday,Spring,Cloudy,92,83,9
2012-02-05,2012,February,10,Sunday,Spring,Cloudy,148,138,10
2012-02-05,2012,February,11,Sunday,Spring,Cloudy,182,160,22
2012-02-05,2012,February,12,Sunday,Spring,Cloudy,248,223,25
2012-02-05,2012,February,13,Sunday,Spring,Cloudy,274,241,33
2012-02-05,2012,February,14,Sunday,Spring,Clear,243,203,40
2012-02-05,2012,February,15,Sunday,Spring,Cloudy,272,217,55
2012-02-05,2012,February,16,Sunday,Spring,Clear,296,261,35
2012-02-05,2012,February,17,Sunday,Spring,Clear,306,275,31
2012-02-05,2012,February,18,Sunday,Spring,Clear,181,171,10
2012-02-05,2012,February,19,Sunday,Spring,Clear,69,63,6
2012-02-05,2012,February,20,Sunday,Spring,Clear,50,47,3
2012-02-05,2012,February,21,Sunday,Spring,Clear,66,60,6
2012-02-05,2012,February,22,Sunday,Spring,Clear,191,182,9
2012-02-05,2012,February,23,Sunday,Spring,Clear,42,38,4
2012-02-06,2012,February,0,Monday,Spring,Clear,21,14,7
2012-02-06,2012,February,1,Monday,Spring,Clear,6,6,0
2012-02-06,2012,February,2,Monday,Spring,Clear,3,3,0
2012-02-06,2012,February,4,Monday,Spring,Clear,2,2,0
2012-02-06,2012,February,5,Monday,Spring,Clear,17,17,0
2012-02-06,2012,February,6,Monday,Spring,Clear,72,72,0
2012-02-06,2012,February,7,Monday,Spring,Clear,234,229,5
2012-02-06,2012,February,8,Monday,Spring,Clear,444,434,10
2012-02-06,2012,February,9,Monday,Spring,Clear,277,269,8
2012-02-06,2012,February,10,Monday,Spring,Clear,116,96,20
2012-02-06,2012,February,11,Monday,Spring,Clear,116,104,12
2012-02-06,2012,February,12,Monday,Spring,Clear,150,131,19
2012-02-06,2012,February,13,Monday,Spring,Clear,141,124,17
2012-02-06,2012,February,14,Monday,Spring,Clear,140,126,14
2012-02-06,2012,February,15,Monday,Spring,Clear,171,146,25
2012-02-06,2012,February,16,Monday,Spring,Clear,228,215,13
2012-02-06,2012,February,17,Monday,Spring,Clear,430,417,13
2012-02-06,2012,February,18,Monday,Spring,Clear,437,426,11
2012-02-06,2012,February,19,Monday,Spring,Clear,291,284,7
2012-02-06,2012,February,20,Monday,Spring,Clear,201,194,7
2012-02-06,2012,February,21,Monday,Spring,Clear,154,143,11
2012-02-06,2012,February,22,Monday,Spring,Clear,87,83,4
2012-02-06,2012,February,23,Monday,Spring,Clear,46,43,3
2012-02-07,2012,February,0,Tuesday,Spring,Clear,23,22,1
2012-02-07,2012,February,1,Tuesday,Spring,Clear,14,6,8
2012-02-07,2012,February,2,Tuesday,Spring,Clear,4,4,0
2012-02-07,2012,February,3,Tuesday,Spring,Cloudy,2,1,1
2012-02-07,2012,February,4,Tuesday,Spring,Cloudy,3,3,0
2012-02-07,2012,February,5,Tuesday,Spring,Clear,15,15,0
2012-02-07,2012,February,6,Tuesday,Spring,Clear,100,98,2
2012-02-07,2012,February,7,Tuesday,Spring,Clear,299,293,6
2012-02-07,2012,February,8,Tuesday,Spring,Clear,529,522,7
2012-02-07,2012,February,9,Tuesday,Spring,Clear,289,278,11
2012-02-07,2012,February,10,Tuesday,Spring,Clear,116,104,12
2012-02-07,2012,February,11,Tuesday,Spring,Clear,129,120,9
2012-02-07,2012,February,12,Tuesday,Spring,Clear,172,163,9
2012-02-07,2012,February,13,Tuesday,Spring,Clear,184,169,15
2012-02-07,2012,February,14,Tuesday,Spring,Clear,138,127,11
2012-02-07,2012,February,15,Tuesday,Spring,Clear,146,133,13
2012-02-07,2012,February,16,Tuesday,Spring,Clear,276,257,19
2012-02-07,2012,February,17,Tuesday,Spring,Clear,509,494,15
2012-02-07,2012,February,18,Tuesday,Spring,Clear,518,508,10
2012-02-07,2012,February,19,Tuesday,Spring,Clear,338,327,11
2012-02-07,2012,February,20,Tuesday,Spring,Clear,212,206,6
2012-02-07,2012,February,21,Tuesday,Spring,Clear,190,170,20
2012-02-07,2012,February,22,Tuesday,Spring,Clear,118,107,11
2012-02-07,2012,February,23,Tuesday,Spring,Clear,51,49,2
2012-02-08,2012,February,0,Wednesday,Spring,Clear,23,21,2
2012-02-08,2012,February,1,Wednesday,Spring,Clear,10,9,1
2012-02-08,2012,February,2,Wednesday,Spring,Clear,1,1,0
2012-02-08,2012,February,3,Wednesday,Spring,Clear,1,1,0
2012-02-08,2012,February,4,Wednesday,Spring,Clear,1,1,0
2012-02-08,2012,February,5,Wednesday,Spring,Clear,20,20,0
2012-02-08,2012,February,6,Wednesday,Spring,Cloudy,98,95,3
2012-02-08,2012,February,7,Wednesday,Spring,Cloudy,281,276,5
2012-02-08,2012,February,8,Wednesday,Spring,Cloudy,508,495,13
2012-02-08,2012,February,9,Wednesday,Spring,Cloudy,253,245,8
2012-02-08,2012,February,10,Wednesday,Spring,Cloudy,108,107,1
2012-02-08,2012,February,11,Wednesday,Spring,Cloudy,102,97,5
2012-02-08,2012,February,12,Wednesday,Spring,Cloudy,138,124,14
2012-02-08,2012,February,13,Wednesday,Spring,Cloudy,126,111,15
2012-02-08,2012,February,14,Wednesday,Spring,Cloudy,108,100,8
2012-02-08,2012,February,15,Wednesday,Spring,Light Snow/Rain,54,49,5
2012-02-08,2012,February,16,Wednesday,Spring,Light Snow/Rain,75,73,2
2012-02-08,2012,February,17,Wednesday,Spring,Light Snow/Rain,155,147,8
2012-02-08,2012,February,18,Wednesday,Spring,Light Snow/Rain,167,163,4
2012-02-08,2012,February,19,Wednesday,Spring,Light Snow/Rain,161,158,3
2012-02-08,2012,February,20,Wednesday,Spring,Light Snow/Rain,125,122,3
2012-02-08,2012,February,21,Wednesday,Spring,Light Snow/Rain,129,126,3
2012-02-08,2012,February,22,Wednesday,Spring,Cloudy,98,95,3
2012-02-08,2012,February,23,Wednesday,Spring,Cloudy,60,57,3
2012-02-09,2012,February,0,Thursday,Spring,Cloudy,26,23,3
2012-02-09,2012,February,1,Thursday,Spring,Cloudy,12,10,2
2012-02-09,2012,February,2,Thursday,Spring,Clear,2,2,0
2012-02-09,2012,February,3,Thursday,Spring,Clear,4,4,0
2012-02-09,2012,February,4,Thursday,Spring,Cloudy,1,1,0
2012-02-09,2012,February,5,Thursday,Spring,Clear,18,18,0
2012-02-09,2012,February,6,Thursday,Spring,Clear,76,75,1
2012-02-09,2012,February,7,Thursday,Spring,Clear,267,263,4
2012-02-09,2012,February,8,Thursday,Spring,Clear,484,473,11
2012-02-09,2012,February,9,Thursday,Spring,Clear,238,229,9
2012-02-09,2012,February,10,Thursday,Spring,Clear,97,90,7
2012-02-09,2012,February,11,Thursday,Spring,Clear,99,95,4
2012-02-09,2012,February,12,Thursday,Spring,Clear,158,148,10
2012-02-09,2012,February,13,Thursday,Spring,Clear,154,144,10
2012-02-09,2012,February,14,Thursday,Spring,Clear,144,126,18
2012-02-09,2012,February,15,Thursday,Spring,Clear,134,120,14
2012-02-09,2012,February,16,Thursday,Spring,Clear,238,223,15
2012-02-09,2012,February,17,Thursday,Spring,Clear,399,387,12
2012-02-09,2012,February,18,Thursday,Spring,Clear,417,404,13
2012-02-09,2012,February,19,Thursday,Spring,Clear,295,287,8
2012-02-09,2012,February,20,Thursday,Spring,Clear,199,197,2
2012-02-09,2012,February,21,Thursday,Spring,Clear,177,169,8
2012-02-09,2012,February,22,Thursday,Spring,Cloudy,107,104,3
2012-02-09,2012,February,23,Thursday,Spring,Cloudy,84,75,9
2012-02-10,2012,February,0,Friday,Spring,Cloudy,43,39,4
2012-02-10,2012,February,1,Friday,Spring,Cloudy,13,11,2
2012-02-10,2012,February,2,Friday,Spring,Clear,16,9,7
2012-02-10,2012,February,3,Friday,Spring,Clear,5,5,0
2012-02-10,2012,February,4,Friday,Spring,Clear,2,2,0
2012-02-10,2012,February,5,Friday,Spring,Clear,17,17,0
2012-02-10,2012,February,6,Friday,Spring,Clear,64,61,3
2012-02-10,2012,February,7,Friday,Spring,Clear,230,225,5
2012-02-10,2012,February,8,Friday,Spring,Clear,448,447,1
2012-02-10,2012,February,9,Friday,Spring,Clear,275,265,10
2012-02-10,2012,February,10,Friday,Spring,Cloudy,124,119,5
2012-02-10,2012,February,11,Friday,Spring,Cloudy,153,134,19
2012-02-10,2012,February,12,Friday,Spring,Cloudy,176,168,8
2012-02-10,2012,February,13,Friday,Spring,Cloudy,192,170,22
2012-02-10,2012,February,14,Friday,Spring,Cloudy,146,138,8
2012-02-10,2012,February,15,Friday,Spring,Cloudy,191,164,27
2012-02-10,2012,February,16,Friday,Spring,Cloudy,268,240,28
2012-02-10,2012,February,17,Friday,Spring,Cloudy,396,381,15
2012-02-10,2012,February,18,Friday,Spring,Light Snow/Rain,359,345,14
2012-02-10,2012,February,19,Friday,Spring,Cloudy,262,246,16
2012-02-10,2012,February,20,Friday,Spring,Cloudy,151,144,7
2012-02-10,2012,February,21,Friday,Spring,Cloudy,122,108,14
2012-02-10,2012,February,22,Friday,Spring,Cloudy,113,102,11
2012-02-10,2012,February,23,Friday,Spring,Cloudy,65,64,1
2012-02-11,2012,February,0,Saturday,Spring,Cloudy,53,50,3
2012-02-11,2012,February,1,Saturday,Spring,Light Snow/Rain,45,43,2
2012-02-11,2012,February,2,Saturday,Spring,Light Snow/Rain,26,24,2
2012-02-11,2012,February,3,Saturday,Spring,Light Snow/Rain,9,9,0
2012-02-11,2012,February,4,Saturday,Spring,Light Snow/Rain,4,4,0
2012-02-11,2012,February,5,Saturday,Spring,Light Snow/Rain,2,2,0
2012-02-11,2012,February,6,Saturday,Spring,Light Snow/Rain,9,8,1
2012-02-11,2012,February,7,Saturday,Spring,Light Snow/Rain,19,19,0
2012-02-11,2012,February,8,Saturday,Spring,Light Snow/Rain,78,77,1
2012-02-11,2012,February,9,Saturday,Spring,Light Snow/Rain,90,85,5
2012-02-11,2012,February,10,Saturday,Spring,Light Snow/Rain,166,143,23
2012-02-11,2012,February,11,Saturday,Spring,Cloudy,183,157,26
2012-02-11,2012,February,12,Saturday,Spring,Cloudy,221,196,25
2012-02-11,2012,February,13,Saturday,Spring,Cloudy,235,217,18
2012-02-11,2012,February,14,Saturday,Spring,Cloudy,243,205,38
2012-02-11,2012,February,15,Saturday,Spring,Cloudy,124,112,12
2012-02-11,2012,February,16,Saturday,Spring,Light Snow/Rain,146,134,12
2012-02-11,2012,February,17,Saturday,Spring,Light Snow/Rain,144,131,13
2012-02-11,2012,February,18,Saturday,Spring,Cloudy,108,105,3
2012-02-11,2012,February,19,Saturday,Spring,Cloudy,87,85,2
2012-02-11,2012,February,20,Saturday,Spring,Cloudy,63,62,1
2012-02-11,2012,February,21,Saturday,Spring,Clear,48,43,5
2012-02-11,2012,February,22,Saturday,Spring,Cloudy,46,46,0
2012-02-11,2012,February,23,Saturday,Spring,Light Snow/Rain,20,20,0
2012-02-12,2012,February,0,Sunday,Spring,Light Snow/Rain,21,21,0
2012-02-12,2012,February,1,Sunday,Spring,Light Snow/Rain,24,24,0
2012-02-12,2012,February,2,Sunday,Spring,Cloudy,27,26,1
2012-02-12,2012,February,3,Sunday,Spring,Cloudy,14,14,0
2012-02-12,2012,February,4,Sunday,Spring,Cloudy,1,1,0
2012-02-12,2012,February,5,Sunday,Spring,Clear,3,3,0
2012-02-12,2012,February,6,Sunday,Spring,Clear,2,2,0
2012-02-12,2012,February,7,Sunday,Spring,Clear,18,18,0
2012-02-12,2012,February,8,Sunday,Spring,Clear,26,26,0
2012-02-12,2012,February,9,Sunday,Spring,Clear,63,60,3
2012-02-12,2012,February,10,Sunday,Spring,Clear,91,83,8
2012-02-12,2012,February,11,Sunday,Spring,Clear,124,121,3
2012-02-12,2012,February,12,Sunday,Spring,Clear,140,133,7
2012-02-12,2012,February,13,Sunday,Spring,Clear,138,128,10
2012-02-12,2012,February,14,Sunday,Spring,Clear,111,102,9
2012-02-12,2012,February,15,Sunday,Spring,Clear,155,150,5
2012-02-12,2012,February,16,Sunday,Spring,Clear,164,148,16
2012-02-12,2012,February,17,Sunday,Spring,Clear,87,83,4
2012-02-12,2012,February,18,Sunday,Spring,Clear,96,92,4
2012-02-12,2012,February,19,Sunday,Spring,Clear,80,78,2
2012-02-12,2012,February,20,Sunday,Spring,Clear,57,56,1
2012-02-12,2012,February,21,Sunday,Spring,Clear,36,36,0
2012-02-12,2012,February,22,Sunday,Spring,Clear,28,28,0
2012-02-12,2012,February,23,Sunday,Spring,Clear,23,23,0
2012-02-13,2012,February,0,Monday,Spring,Clear,9,9,0
2012-02-13,2012,February,1,Monday,Spring,Clear,6,6,0
2012-02-13,2012,February,2,Monday,Spring,Clear,4,4,0
2012-02-13,2012,February,3,Monday,Spring,Clear,1,1,0
2012-02-13,2012,February,4,Monday,Spring,Clear,2,2,0
2012-02-13,2012,February,5,Monday,Spring,Clear,17,17,0
2012-02-13,2012,February,6,Monday,Spring,Clear,72,71,1
2012-02-13,2012,February,7,Monday,Spring,Clear,195,194,1
2012-02-13,2012,February,8,Monday,Spring,Clear,417,413,4
2012-02-13,2012,February,9,Monday,Spring,Clear,205,198,7
2012-02-13,2012,February,10,Monday,Spring,Clear,71,70,1
2012-02-13,2012,February,11,Monday,Spring,Clear,90,85,5
2012-02-13,2012,February,12,Monday,Spring,Clear,118,111,7
2012-02-13,2012,February,13,Monday,Spring,Clear,140,129,11
2012-02-13,2012,February,14,Monday,Spring,Clear,135,125,10
2012-02-13,2012,February,15,Monday,Spring,Clear,155,145,10
2012-02-13,2012,February,16,Monday,Spring,Clear,211,206,5
2012-02-13,2012,February,17,Monday,Spring,Clear,407,399,8
2012-02-13,2012,February,18,Monday,Spring,Clear,405,399,6
2012-02-13,2012,February,19,Monday,Spring,Clear,263,256,7
2012-02-13,2012,February,20,Monday,Spring,Clear,214,210,4
2012-02-13,2012,February,21,Monday,Spring,Clear,147,145,2
2012-02-13,2012,February,22,Monday,Spring,Clear,102,99,3
2012-02-13,2012,February,23,Monday,Spring,Clear,36,34,2
2012-02-14,2012,February,0,Tuesday,Spring,Cloudy,14,14,0
2012-02-14,2012,February,1,Tuesday,Spring,Cloudy,6,6,0
2012-02-14,2012,February,2,Tuesday,Spring,Cloudy,3,3,0
2012-02-14,2012,February,3,Tuesday,Spring,Cloudy,3,3,0
2012-02-14,2012,February,4,Tuesday,Spring,Cloudy,2,2,0
2012-02-14,2012,February,5,Tuesday,Spring,Cloudy,22,20,2
2012-02-14,2012,February,6,Tuesday,Spring,Cloudy,90,89,1
2012-02-14,2012,February,7,Tuesday,Spring,Cloudy,280,276,4
2012-02-14,2012,February,8,Tuesday,Spring,Cloudy,513,510,3
2012-02-14,2012,February,9,Tuesday,Spring,Cloudy,262,256,6
2012-02-14,2012,February,10,Tuesday,Spring,Cloudy,98,90,8
2012-02-14,2012,February,11,Tuesday,Spring,Cloudy,112,107,5
2012-02-14,2012,February,12,Tuesday,Spring,Cloudy,172,162,10
2012-02-14,2012,February,13,Tuesday,Spring,Cloudy,173,167,6
2012-02-14,2012,February,14,Tuesday,Spring,Clear,124,111,13
2012-02-14,2012,February,15,Tuesday,Spring,Cloudy,145,138,7
2012-02-14,2012,February,16,Tuesday,Spring,Clear,266,251,15
2012-02-14,2012,February,17,Tuesday,Spring,Clear,523,504,19
2012-02-14,2012,February,18,Tuesday,Spring,Cloudy,406,398,8
2012-02-14,2012,February,19,Tuesday,Spring,Cloudy,281,270,11
2012-02-14,2012,February,20,Tuesday,Spring,Cloudy,184,178,6
2012-02-14,2012,February,21,Tuesday,Spring,Cloudy,109,105,4
2012-02-14,2012,February,22,Tuesday,Spring,Cloudy,77,72,5
2012-02-14,2012,February,23,Tuesday,Spring,Cloudy,57,55,2
2012-02-15,2012,February,0,Wednesday,Spring,Clear,22,22,0
2012-02-15,2012,February,1,Wednesday,Spring,Clear,5,5,0
2012-02-15,2012,February,2,Wednesday,Spring,Clear,4,4,0
2012-02-15,2012,February,3,Wednesday,Spring,Clear,3,3,0
2012-02-15,2012,February,4,Wednesday,Spring,Clear,1,1,0
2012-02-15,2012,February,5,Wednesday,Spring,Clear,25,25,0
2012-02-15,2012,February,6,Wednesday,Spring,Clear,95,92,3
2012-02-15,2012,February,7,Wednesday,Spring,Cloudy,321,318,3
2012-02-15,2012,February,8,Wednesday,Spring,Clear,515,508,7
2012-02-15,2012,February,9,Wednesday,Spring,Clear,231,226,5
2012-02-15,2012,February,10,Wednesday,Spring,Clear,120,108,12
2012-02-15,2012,February,11,Wednesday,Spring,Clear,138,125,13
2012-02-15,2012,February,12,Wednesday,Spring,Clear,163,152,11
2012-02-15,2012,February,13,Wednesday,Spring,Clear,170,159,11
2012-02-15,2012,February,14,Wednesday,Spring,Clear,134,128,6
2012-02-15,2012,February,15,Wednesday,Spring,Clear,171,164,7
2012-02-15,2012,February,16,Wednesday,Spring,Clear,231,222,9
2012-02-15,2012,February,17,Wednesday,Spring,Clear,487,470,17
2012-02-15,2012,February,18,Wednesday,Spring,Clear,468,459,9
2012-02-15,2012,February,19,Wednesday,Spring,Clear,311,302,9
2012-02-15,2012,February,20,Wednesday,Spring,Clear,211,207,4
2012-02-15,2012,February,21,Wednesday,Spring,Clear,178,170,8
2012-02-15,2012,February,22,Wednesday,Spring,Clear,107,104,3
2012-02-15,2012,February,23,Wednesday,Spring,Clear,58,54,4
2012-02-16,2012,February,0,Thursday,Spring,Cloudy,23,22,1
2012-02-16,2012,February,1,Thursday,Spring,Cloudy,5,5,0
2012-02-16,2012,February,2,Thursday,Spring,Cloudy,7,6,1
2012-02-16,2012,February,3,Thursday,Spring,Cloudy,1,1,0
2012-02-16,2012,February,4,Thursday,Spring,Light Snow/Rain,3,3,0
2012-02-16,2012,February,5,Thursday,Spring,Cloudy,20,20,0
2012-02-16,2012,February,6,Thursday,Spring,Cloudy,87,83,4
2012-02-16,2012,February,7,Thursday,Spring,Cloudy,288,285,3
2012-02-16,2012,February,8,Thursday,Spring,Cloudy,498,489,9
2012-02-16,2012,February,9,Thursday,Spring,Cloudy,202,199,3
2012-02-16,2012,February,10,Thursday,Spring,Light Snow/Rain,44,42,2
2012-02-16,2012,February,11,Thursday,Spring,Light Snow/Rain,71,69,2
2012-02-16,2012,February,12,Thursday,Spring,Light Snow/Rain,45,44,1
2012-02-16,2012,February,13,Thursday,Spring,Light Snow/Rain,64,62,2
2012-02-16,2012,February,14,Thursday,Spring,Light Snow/Rain,31,30,1
2012-02-16,2012,February,15,Thursday,Spring,Light Snow/Rain,53,50,3
2012-02-16,2012,February,16,Thursday,Spring,Light Snow/Rain,118,110,8
2012-02-16,2012,February,17,Thursday,Spring,Light Snow/Rain,289,281,8
2012-02-16,2012,February,18,Thursday,Spring,Light Snow/Rain,353,345,8
2012-02-16,2012,February,19,Thursday,Spring,Cloudy,258,254,4
2012-02-16,2012,February,20,Thursday,Spring,Cloudy,216,211,5
2012-02-16,2012,February,21,Thursday,Spring,Cloudy,145,142,3
2012-02-16,2012,February,22,Thursday,Spring,Cloudy,111,108,3
2012-02-16,2012,February,23,Thursday,Spring,Clear,73,70,3
2012-02-17,2012,February,0,Friday,Spring,Cloudy,34,32,2
2012-02-17,2012,February,1,Friday,Spring,Cloudy,18,16,2
2012-02-17,2012,February,2,Friday,Spring,Cloudy,12,11,1
2012-02-17,2012,February,3,Friday,Spring,Cloudy,1,1,0
2012-02-17,2012,February,4,Friday,Spring,Cloudy,1,1,0
2012-02-17,2012,February,5,Friday,Spring,Cloudy,16,16,0
2012-02-17,2012,February,6,Friday,Spring,Cloudy,71,70,1
2012-02-17,2012,February,7,Friday,Spring,Cloudy,226,222,4
2012-02-17,2012,February,8,Friday,Spring,Cloudy,520,516,4
2012-02-17,2012,February,9,Friday,Spring,Cloudy,283,275,8
2012-02-17,2012,February,10,Friday,Spring,Clear,116,103,13
2012-02-17,2012,February,11,Friday,Spring,Clear,142,133,9
2012-02-17,2012,February,12,Friday,Spring,Clear,198,177,21
2012-02-17,2012,February,13,Friday,Spring,Clear,205,171,34
2012-02-17,2012,February,14,Friday,Spring,Clear,170,137,33
2012-02-17,2012,February,15,Friday,Spring,Clear,221,180,41
2012-02-17,2012,February,16,Friday,Spring,Clear,307,251,56
2012-02-17,2012,February,17,Friday,Spring,Clear,465,429,36
2012-02-17,2012,February,18,Friday,Spring,Clear,377,362,15
2012-02-17,2012,February,19,Friday,Spring,Clear,282,266,16
2012-02-17,2012,February,20,Friday,Spring,Clear,171,158,13
2012-02-17,2012,February,21,Friday,Spring,Clear,129,114,15
2012-02-17,2012,February,22,Friday,Spring,Clear,107,92,15
2012-02-17,2012,February,23,Friday,Spring,Clear,82,72,10
2012-02-18,2012,February,0,Saturday,Spring,Clear,86,81,5
2012-02-18,2012,February,1,Saturday,Spring,Clear,45,38,7
2012-02-18,2012,February,2,Saturday,Spring,Clear,45,39,6
2012-02-18,2012,February,3,Saturday,Spring,Clear,18,15,3
2012-02-18,2012,February,4,Saturday,Spring,Clear,7,4,3
2012-02-18,2012,February,5,Saturday,Spring,Clear,1,1,0
2012-02-18,2012,February,6,Saturday,Spring,Clear,9,8,1
2012-02-18,2012,February,7,Saturday,Spring,Clear,41,33,8
2012-02-18,2012,February,8,Saturday,Spring,Clear,102,92,10
2012-02-18,2012,February,9,Saturday,Spring,Clear,138,116,22
2012-02-18,2012,February,10,Saturday,Spring,Clear,205,157,48
2012-02-18,2012,February,11,Saturday,Spring,Clear,286,184,102
2012-02-18,2012,February,12,Saturday,Spring,Clear,369,241,128
2012-02-18,2012,February,13,Saturday,Spring,Clear,384,219,165
2012-02-18,2012,February,14,Saturday,Spring,Clear,427,244,183
2012-02-18,2012,February,15,Saturday,Spring,Clear,499,270,229
2012-02-18,2012,February,16,Saturday,Spring,Clear,404,218,186
2012-02-18,2012,February,17,Saturday,Spring,Clear,364,222,142
2012-02-18,2012,February,18,Saturday,Spring,Clear,246,176,70
2012-02-18,2012,February,19,Saturday,Spring,Clear,188,150,38
2012-02-18,2012,February,20,Saturday,Spring,Clear,148,123,25
2012-02-18,2012,February,21,Saturday,Spring,Clear,114,89,25
2012-02-18,2012,February,22,Saturday,Spring,Clear,118,101,17
2012-02-18,2012,February,23,Saturday,Spring,Cloudy,74,62,12
2012-02-19,2012,February,0,Sunday,Spring,Cloudy,74,65,9
2012-02-19,2012,February,1,Sunday,Spring,Cloudy,72,62,10
2012-02-19,2012,February,2,Sunday,Spring,Cloudy,48,45,3
2012-02-19,2012,February,3,Sunday,Spring,Cloudy,15,12,3
2012-02-19,2012,February,4,Sunday,Spring,Cloudy,3,3,0
2012-02-19,2012,February,5,Sunday,Spring,Cloudy,2,1,1
2012-02-19,2012,February,6,Sunday,Spring,Clear,5,5,0
2012-02-19,2012,February,7,Sunday,Spring,Cloudy,14,12,2
2012-02-19,2012,February,8,Sunday,Spring,Cloudy,56,48,8
2012-02-19,2012,February,9,Sunday,Spring,Cloudy,93,73,20
2012-02-19,2012,February,10,Sunday,Spring,Cloudy,191,142,49
2012-02-19,2012,February,11,Sunday,Spring,Cloudy,226,144,82
2012-02-19,2012,February,12,Sunday,Spring,Cloudy,255,184,71
2012-02-19,2012,February,13,Sunday,Spring,Clear,261,197,64
2012-02-19,2012,February,14,Sunday,Spring,Cloudy,237,189,48
2012-02-19,2012,February,15,Sunday,Spring,Cloudy,253,168,85
2012-02-19,2012,February,16,Sunday,Spring,Cloudy,212,150,62
2012-02-19,2012,February,17,Sunday,Spring,Cloudy,157,135,22
2012-02-19,2012,February,18,Sunday,Spring,Cloudy,167,144,23
2012-02-19,2012,February,19,Sunday,Spring,Cloudy,119,101,18
2012-02-19,2012,February,20,Sunday,Spring,Cloudy,103,81,22
2012-02-19,2012,February,21,Sunday,Spring,Light Snow/Rain,36,33,3
2012-02-19,2012,February,22,Sunday,Spring,Light Snow/Rain,55,47,8
2012-02-19,2012,February,23,Sunday,Spring,Cloudy,35,30,5
2012-02-20,2012,February,0,Monday,Spring,Cloudy,41,36,5
2012-02-20,2012,February,1,Monday,Spring,Cloudy,15,12,3
2012-02-20,2012,February,2,Monday,Spring,Cloudy,20,19,1
2012-02-20,2012,February,3,Monday,Spring,Cloudy,8,8,0
2012-02-20,2012,February,5,Monday,Spring,Cloudy,6,6,0
2012-02-20,2012,February,6,Monday,Spring,Clear,10,9,1
2012-02-20,2012,February,7,Monday,Spring,Cloudy,44,42,2
2012-02-20,2012,February,8,Monday,Spring,Clear,120,111,9
2012-02-20,2012,February,9,Monday,Spring,Clear,110,98,12
2012-02-20,2012,February,10,Monday,Spring,Clear,143,113,30
2012-02-20,2012,February,11,Monday,Spring,Clear,208,163,45
2012-02-20,2012,February,12,Monday,Spring,Clear,281,216,65
2012-02-20,2012,February,13,Monday,Spring,Clear,312,246,66
2012-02-20,2012,February,14,Monday,Spring,Clear,263,206,57
2012-02-20,2012,February,15,Monday,Spring,Clear,289,235,54
2012-02-20,2012,February,16,Monday,Spring,Clear,280,216,64
2012-02-20,2012,February,17,Monday,Spring,Clear,253,226,27
2012-02-20,2012,February,18,Monday,Spring,Clear,242,215,27
2012-02-20,2012,February,19,Monday,Spring,Clear,172,164,8
2012-02-20,2012,February,20,Monday,Spring,Clear,126,117,9
2012-02-20,2012,February,21,Monday,Spring,Clear,98,90,8
2012-02-20,2012,February,22,Monday,Spring,Clear,62,53,9
2012-02-20,2012,February,23,Monday,Spring,Clear,26,26,0
2012-02-21,2012,February,0,Tuesday,Spring,Clear,12,11,1
2012-02-21,2012,February,1,Tuesday,Spring,Clear,7,7,0
2012-02-21,2012,February,2,Tuesday,Spring,Clear,3,3,0
2012-02-21,2012,February,4,Tuesday,Spring,Clear,2,2,0
2012-02-21,2012,February,5,Tuesday,Spring,Clear,15,15,0
2012-02-21,2012,February,6,Tuesday,Spring,Clear,86,83,3
2012-02-21,2012,February,7,Tuesday,Spring,Clear,279,273,6
2012-02-21,2012,February,8,Tuesday,Spring,Clear,464,459,5
2012-02-21,2012,February,9,Tuesday,Spring,Clear,217,211,6
2012-02-21,2012,February,10,Tuesday,Spring,Clear,85,77,8
2012-02-21,2012,February,11,Tuesday,Spring,Cloudy,86,81,5
2012-02-21,2012,February,12,Tuesday,Spring,Cloudy,163,147,16
2012-02-21,2012,February,13,Tuesday,Spring,Clear,131,123,8
2012-02-21,2012,February,14,Tuesday,Spring,Cloudy,124,108,16
2012-02-21,2012,February,15,Tuesday,Spring,Clear,160,137,23
2012-02-21,2012,February,16,Tuesday,Spring,Clear,254,240,14
2012-02-21,2012,February,17,Tuesday,Spring,Clear,432,411,21
2012-02-21,2012,February,18,Tuesday,Spring,Clear,425,414,11
2012-02-21,2012,February,19,Tuesday,Spring,Clear,304,299,5
2012-02-21,2012,February,20,Tuesday,Spring,Clear,227,223,4
2012-02-21,2012,February,21,Tuesday,Spring,Clear,154,147,7
2012-02-21,2012,February,22,Tuesday,Spring,Cloudy,100,97,3
2012-02-21,2012,February,23,Tuesday,Spring,Clear,47,46,1
2012-02-22,2012,February,0,Wednesday,Spring,Clear,24,19,5
2012-02-22,2012,February,1,Wednesday,Spring,Clear,7,4,3
2012-02-22,2012,February,2,Wednesday,Spring,Clear,6,5,1
2012-02-22,2012,February,3,Wednesday,Spring,Cloudy,4,3,1
2012-02-22,2012,February,4,Wednesday,Spring,Clear,2,2,0
2012-02-22,2012,February,5,Wednesday,Spring,Clear,30,29,1
2012-02-22,2012,February,6,Wednesday,Spring,Clear,90,85,5
2012-02-22,2012,February,7,Wednesday,Spring,Clear,302,292,10
2012-02-22,2012,February,8,Wednesday,Spring,Clear,576,567,9
2012-02-22,2012,February,9,Wednesday,Spring,Clear,252,241,11
2012-02-22,2012,February,10,Wednesday,Spring,Clear,139,122,17
2012-02-22,2012,February,11,Wednesday,Spring,Clear,171,149,22
2012-02-22,2012,February,12,Wednesday,Spring,Clear,207,186,21
2012-02-22,2012,February,13,Wednesday,Spring,Clear,190,175,15
2012-02-22,2012,February,14,Wednesday,Spring,Clear,177,142,35
2012-02-22,2012,February,15,Wednesday,Spring,Clear,195,161,34
2012-02-22,2012,February,16,Wednesday,Spring,Clear,298,268,30
2012-02-22,2012,February,17,Wednesday,Spring,Clear,529,486,43
2012-02-22,2012,February,18,Wednesday,Spring,Cloudy,525,483,42
2012-02-22,2012,February,19,Wednesday,Spring,Cloudy,327,305,22
2012-02-22,2012,February,20,Wednesday,Spring,Cloudy,274,249,25
2012-02-22,2012,February,21,Wednesday,Spring,Cloudy,239,220,19
2012-02-22,2012,February,22,Wednesday,Spring,Cloudy,147,129,18
2012-02-22,2012,February,23,Wednesday,Spring,Cloudy,62,57,5
2012-02-23,2012,February,0,Thursday,Spring,Cloudy,42,30,12
2012-02-23,2012,February,1,Thursday,Spring,Cloudy,15,12,3
2012-02-23,2012,February,2,Thursday,Spring,Cloudy,9,4,5
2012-02-23,2012,February,3,Thursday,Spring,Light Snow/Rain,6,4,2
2012-02-23,2012,February,4,Thursday,Spring,Clear,1,1,0
2012-02-23,2012,February,5,Thursday,Spring,Clear,32,30,2
2012-02-23,2012,February,6,Thursday,Spring,Clear,91,88,3
2012-02-23,2012,February,7,Thursday,Spring,Clear,326,317,9
2012-02-23,2012,February,8,Thursday,Spring,Clear,560,549,11
2012-02-23,2012,February,9,Thursday,Spring,Clear,242,228,14
2012-02-23,2012,February,10,Thursday,Spring,Clear,148,107,41
2012-02-23,2012,February,11,Thursday,Spring,Clear,182,128,54
2012-02-23,2012,February,12,Thursday,Spring,Clear,224,199,25
2012-02-23,2012,February,13,Thursday,Spring,Clear,218,188,30
2012-02-23,2012,February,14,Thursday,Spring,Clear,192,156,36
2012-02-23,2012,February,15,Thursday,Spring,Clear,217,171,46
2012-02-23,2012,February,16,Thursday,Spring,Clear,343,298,45
2012-02-23,2012,February,17,Thursday,Spring,Clear,610,561,49
2012-02-23,2012,February,18,Thursday,Spring,Clear,522,486,36
2012-02-23,2012,February,19,Thursday,Spring,Clear,369,349,20
2012-02-23,2012,February,20,Thursday,Spring,Clear,269,246,23
2012-02-23,2012,February,21,Thursday,Spring,Clear,222,205,17
2012-02-23,2012,February,22,Thursday,Spring,Clear,137,118,19
2012-02-23,2012,February,23,Thursday,Spring,Clear,85,71,14
2012-02-24,2012,February,0,Friday,Spring,Cloudy,46,34,12
2012-02-24,2012,February,1,Friday,Spring,Clear,18,15,3
2012-02-24,2012,February,2,Friday,Spring,Light Snow/Rain,5,4,1
2012-02-24,2012,February,3,Friday,Spring,Clear,5,5,0
2012-02-24,2012,February,4,Friday,Spring,Clear,2,2,0
2012-02-24,2012,February,5,Friday,Spring,Cloudy,26,25,1
2012-02-24,2012,February,6,Friday,Spring,Cloudy,82,80,2
2012-02-24,2012,February,7,Friday,Spring,Cloudy,272,265,7
2012-02-24,2012,February,8,Friday,Spring,Cloudy,469,452,17
2012-02-24,2012,February,9,Friday,Spring,Light Snow/Rain,244,229,15
2012-02-24,2012,February,10,Friday,Spring,Light Snow/Rain,141,119,22
2012-02-24,2012,February,11,Friday,Spring,Cloudy,163,136,27
2012-02-24,2012,February,12,Friday,Spring,Cloudy,228,201,27
2012-02-24,2012,February,13,Friday,Spring,Cloudy,183,153,30
2012-02-24,2012,February,14,Friday,Spring,Cloudy,31,26,5
2012-02-24,2012,February,15,Friday,Spring,Light Snow/Rain,94,83,11
2012-02-24,2012,February,16,Friday,Spring,Light Snow/Rain,178,166,12
2012-02-24,2012,February,17,Friday,Spring,Light Snow/Rain,256,242,14
2012-02-24,2012,February,18,Friday,Spring,Cloudy,300,289,11
2012-02-24,2012,February,19,Friday,Spring,Cloudy,233,227,6
2012-02-24,2012,February,20,Friday,Spring,Clear,167,159,8
2012-02-24,2012,February,21,Friday,Spring,Clear,152,151,1
2012-02-24,2012,February,22,Friday,Spring,Clear,106,102,4
2012-02-24,2012,February,23,Friday,Spring,Clear,86,76,10
2012-02-25,2012,February,0,Saturday,Spring,Clear,61,56,5
2012-02-25,2012,February,1,Saturday,Spring,Clear,46,42,4
2012-02-25,2012,February,2,Saturday,Spring,Clear,38,37,1
2012-02-25,2012,February,3,Saturday,Spring,Clear,7,7,0
2012-02-25,2012,February,4,Saturday,Spring,Clear,2,2,0
2012-02-25,2012,February,5,Saturday,Spring,Cloudy,3,3,0
2012-02-25,2012,February,6,Saturday,Spring,Cloudy,13,12,1
2012-02-25,2012,February,7,Saturday,Spring,Clear,23,20,3
2012-02-25,2012,February,8,Saturday,Spring,Clear,93,90,3
2012-02-25,2012,February,9,Saturday,Spring,Light Snow/Rain,122,107,15
2012-02-25,2012,February,10,Saturday,Spring,Clear,183,159,24
2012-02-25,2012,February,11,Saturday,Spring,Clear,210,187,23
2012-02-25,2012,February,12,Saturday,Spring,Clear,258,217,41
2012-02-25,2012,February,13,Saturday,Spring,Clear,226,178,48
2012-02-25,2012,February,14,Saturday,Spring,Clear,216,181,35
2012-02-25,2012,February,15,Saturday,Spring,Clear,232,211,21
2012-02-25,2012,February,16,Saturday,Spring,Clear,195,163,32
2012-02-25,2012,February,17,Saturday,Spring,Clear,159,143,16
2012-02-25,2012,February,18,Saturday,Spring,Clear,133,126,7
2012-02-25,2012,February,19,Saturday,Spring,Clear,149,137,12
2012-02-25,2012,February,20,Saturday,Spring,Clear,105,95,10
2012-02-25,2012,February,21,Saturday,Spring,Clear,85,80,5
2012-02-25,2012,February,22,Saturday,Spring,Clear,82,78,4
2012-02-25,2012,February,23,Saturday,Spring,Clear,91,84,7
2012-02-26,2012,February,0,Sunday,Spring,Clear,70,63,7
2012-02-26,2012,February,1,Sunday,Spring,Clear,55,50,5
2012-02-26,2012,February,2,Sunday,Spring,Clear,42,37,5
2012-02-26,2012,February,3,Sunday,Spring,Clear,21,21,0
2012-02-26,2012,February,4,Sunday,Spring,Clear,6,5,1
2012-02-26,2012,February,5,Sunday,Spring,Clear,5,5,0
2012-02-26,2012,February,6,Sunday,Spring,Clear,2,2,0
2012-02-26,2012,February,7,Sunday,Spring,Clear,22,20,2
2012-02-26,2012,February,8,Sunday,Spring,Clear,59,57,2
2012-02-26,2012,February,9,Sunday,Spring,Clear,87,76,11
2012-02-26,2012,February,10,Sunday,Spring,Clear,188,161,27
2012-02-26,2012,February,11,Sunday,Spring,Clear,227,184,43
2012-02-26,2012,February,12,Sunday,Spring,Clear,305,256,49
2012-02-26,2012,February,13,Sunday,Spring,Clear,325,267,58
2012-02-26,2012,February,14,Sunday,Spring,Clear,331,263,68
2012-02-26,2012,February,15,Sunday,Spring,Clear,353,281,72
2012-02-26,2012,February,16,Sunday,Spring,Clear,339,275,64
2012-02-26,2012,February,17,Sunday,Spring,Clear,287,241,46
2012-02-26,2012,February,18,Sunday,Spring,Clear,216,199,17
2012-02-26,2012,February,19,Sunday,Spring,Clear,143,130,13
2012-02-26,2012,February,20,Sunday,Spring,Clear,88,79,9
2012-02-26,2012,February,21,Sunday,Spring,Clear,83,75,8
2012-02-26,2012,February,22,Sunday,Spring,Clear,71,68,3
2012-02-26,2012,February,23,Sunday,Spring,Clear,64,59,5
2012-02-27,2012,February,0,Monday,Spring,Clear,29,27,2
2012-02-27,2012,February,1,Monday,Spring,Clear,6,6,0
2012-02-27,2012,February,2,Monday,Spring,Clear,4,4,0
2012-02-27,2012,February,3,Monday,Spring,Clear,2,2,0
2012-02-27,2012,February,4,Monday,Spring,Clear,1,1,0
2012-02-27,2012,February,5,Monday,Spring,Clear,16,16,0
2012-02-27,2012,February,6,Monday,Spring,Clear,90,89,1
2012-02-27,2012,February,7,Monday,Spring,Clear,280,278,2
2012-02-27,2012,February,8,Monday,Spring,Clear,528,514,14
2012-02-27,2012,February,9,Monday,Spring,Clear,230,219,11
2012-02-27,2012,February,10,Monday,Spring,Clear,104,88,16
2012-02-27,2012,February,11,Monday,Spring,Clear,103,92,11
2012-02-27,2012,February,12,Monday,Spring,Clear,177,164,13
2012-02-27,2012,February,13,Monday,Spring,Clear,182,159,23
2012-02-27,2012,February,14,Monday,Spring,Clear,158,134,24
2012-02-27,2012,February,15,Monday,Spring,Clear,174,150,24
2012-02-27,2012,February,16,Monday,Spring,Clear,286,266,20
2012-02-27,2012,February,17,Monday,Spring,Clear,529,503,26
2012-02-27,2012,February,18,Monday,Spring,Clear,527,517,10
2012-02-27,2012,February,19,Monday,Spring,Clear,334,318,16
2012-02-27,2012,February,20,Monday,Spring,Clear,219,208,11
2012-02-27,2012,February,21,Monday,Spring,Clear,195,181,14
2012-02-27,2012,February,22,Monday,Spring,Clear,92,83,9
2012-02-27,2012,February,23,Monday,Spring,Clear,56,50,6
2012-02-28,2012,February,0,Tuesday,Spring,Clear,10,10,0
2012-02-28,2012,February,1,Tuesday,Spring,Clear,6,6,0
2012-02-28,2012,February,2,Tuesday,Spring,Clear,3,2,1
2012-02-28,2012,February,3,Tuesday,Spring,Clear,6,6,0
2012-02-28,2012,February,4,Tuesday,Spring,Clear,2,2,0
2012-02-28,2012,February,5,Tuesday,Spring,Clear,21,20,1
2012-02-28,2012,February,6,Tuesday,Spring,Clear,101,100,1
2012-02-28,2012,February,7,Tuesday,Spring,Clear,325,313,12
2012-02-28,2012,February,8,Tuesday,Spring,Clear,559,543,16
2012-02-28,2012,February,9,Tuesday,Spring,Clear,232,225,7
2012-02-28,2012,February,10,Tuesday,Spring,Clear,132,118,14
2012-02-28,2012,February,11,Tuesday,Spring,Clear,163,155,8
2012-02-28,2012,February,12,Tuesday,Spring,Clear,183,164,19
2012-02-28,2012,February,13,Tuesday,Spring,Clear,190,174,16
2012-02-28,2012,February,14,Tuesday,Spring,Clear,134,121,13
2012-02-28,2012,February,15,Tuesday,Spring,Clear,166,149,17
2012-02-28,2012,February,16,Tuesday,Spring,Clear,287,270,17
2012-02-28,2012,February,17,Tuesday,Spring,Clear,530,497,33
2012-02-28,2012,February,18,Tuesday,Spring,Clear,449,432,17
2012-02-28,2012,February,19,Tuesday,Spring,Clear,306,291,15
2012-02-28,2012,February,20,Tuesday,Spring,Clear,204,202,2
2012-02-28,2012,February,21,Tuesday,Spring,Clear,188,178,10
2012-02-28,2012,February,22,Tuesday,Spring,Clear,101,95,6
2012-02-28,2012,February,23,Tuesday,Spring,Clear,65,61,4
2012-02-29,2012,February,0,Wednesday,Spring,Clear,32,30,2
2012-02-29,2012,February,1,Wednesday,Spring,Clear,6,6,0
2012-02-29,2012,February,2,Wednesday,Spring,Clear,4,4,0
2012-02-29,2012,February,3,Wednesday,Spring,Clear,2,2,0
2012-02-29,2012,February,5,Wednesday,Spring,Clear,29,29,0
2012-02-29,2012,February,6,Wednesday,Spring,Cloudy,104,100,4
2012-02-29,2012,February,7,Wednesday,Spring,Cloudy,253,242,11
2012-02-29,2012,February,8,Wednesday,Spring,Cloudy,116,114,2
2012-02-29,2012,February,9,Wednesday,Spring,Light Snow/Rain,38,33,5
2012-02-29,2012,February,10,Wednesday,Spring,Light Snow/Rain,10,10,0
2012-02-29,2012,February,11,Wednesday,Spring,Light Snow/Rain,10,9,1
2012-02-29,2012,February,12,Wednesday,Spring,Light Snow/Rain,70,69,1
2012-02-29,2012,February,13,Wednesday,Spring,Cloudy,76,72,4
2012-02-29,2012,February,14,Wednesday,Spring,Cloudy,56,54,2
2012-02-29,2012,February,15,Wednesday,Spring,Cloudy,90,87,3
2012-02-29,2012,February,16,Wednesday,Spring,Light Snow/Rain,167,162,5
2012-02-29,2012,February,17,Wednesday,Spring,Cloudy,253,246,7
2012-02-29,2012,February,18,Wednesday,Spring,Light Snow/Rain,192,181,11
2012-02-29,2012,February,19,Wednesday,Spring,Cloudy,102,102,0
2012-02-29,2012,February,20,Wednesday,Spring,Light Snow/Rain,97,95,2
2012-02-29,2012,February,21,Wednesday,Spring,Light Snow/Rain,39,39,0
2012-02-29,2012,February,22,Wednesday,Spring,Light Snow/Rain,55,53,2
2012-02-29,2012,February,23,Wednesday,Spring,Light Snow/Rain,33,30,3
2012-03-01,2012,March,0,Thursday,Spring,Cloudy,11,10,1
2012-03-01,2012,March,1,Thursday,Spring,Light Snow/Rain,12,12,0
2012-03-01,2012,March,2,Thursday,Spring,Cloudy,6,6,0
2012-03-01,2012,March,3,Thursday,Spring,Clear,3,3,0
2012-03-01,2012,March,4,Thursday,Spring,Clear,5,5,0
2012-03-01,2012,March,5,Thursday,Spring,Clear,18,18,0
2012-03-01,2012,March,6,Thursday,Spring,Cloudy,109,107,2
2012-03-01,2012,March,7,Thursday,Spring,Cloudy,304,296,8
2012-03-01,2012,March,8,Thursday,Spring,Clear,594,579,15
2012-03-01,2012,March,9,Thursday,Spring,Clear,286,281,5
2012-03-01,2012,March,10,Thursday,Spring,Clear,133,122,11
2012-03-01,2012,March,11,Thursday,Spring,Clear,168,149,19
2012-03-01,2012,March,12,Thursday,Spring,Clear,220,204,16
2012-03-01,2012,March,13,Thursday,Spring,Clear,211,187,24
2012-03-01,2012,March,14,Thursday,Spring,Clear,211,174,37
2012-03-01,2012,March,15,Thursday,Spring,Clear,223,192,31
2012-03-01,2012,March,16,Thursday,Spring,Clear,361,323,38
2012-03-01,2012,March,17,Thursday,Spring,Clear,600,551,49
2012-03-01,2012,March,18,Thursday,Spring,Clear,525,498,27
2012-03-01,2012,March,19,Thursday,Spring,Clear,328,317,11
2012-03-01,2012,March,20,Thursday,Spring,Clear,254,242,12
2012-03-01,2012,March,21,Thursday,Spring,Clear,197,190,7
2012-03-01,2012,March,22,Thursday,Spring,Clear,126,123,3
2012-03-01,2012,March,23,Thursday,Spring,Clear,85,76,9
2012-03-02,2012,March,0,Friday,Spring,Clear,46,45,1
2012-03-02,2012,March,1,Friday,Spring,Clear,20,18,2
2012-03-02,2012,March,2,Friday,Spring,Clear,6,4,2
2012-03-02,2012,March,3,Friday,Spring,Clear,3,3,0
2012-03-02,2012,March,4,Friday,Spring,Clear,2,2,0
2012-03-02,2012,March,5,Friday,Spring,Clear,24,24,0
2012-03-02,2012,March,6,Friday,Spring,Clear,92,88,4
2012-03-02,2012,March,7,Friday,Spring,Clear,262,258,4
2012-03-02,2012,March,8,Friday,Spring,Clear,549,533,16
2012-03-02,2012,March,9,Friday,Spring,Clear,314,299,15
2012-03-02,2012,March,10,Friday,Spring,Clear,132,118,14
2012-03-02,2012,March,11,Friday,Spring,Clear,194,154,40
2012-03-02,2012,March,12,Friday,Spring,Clear,234,194,40
2012-03-02,2012,March,13,Friday,Spring,Clear,222,191,31
2012-03-02,2012,March,14,Friday,Spring,Cloudy,205,176,29
2012-03-02,2012,March,15,Friday,Spring,Cloudy,78,73,5
2012-03-02,2012,March,16,Friday,Spring,Light Snow/Rain,50,49,1
2012-03-02,2012,March,17,Friday,Spring,Light Snow/Rain,128,123,5
2012-03-02,2012,March,18,Friday,Spring,Light Snow/Rain,160,154,6
2012-03-02,2012,March,19,Friday,Spring,Light Snow/Rain,174,162,12
2012-03-02,2012,March,20,Friday,Spring,Cloudy,100,93,7
2012-03-02,2012,March,21,Friday,Spring,Light Snow/Rain,101,99,2
2012-03-02,2012,March,22,Friday,Spring,Cloudy,75,69,6
2012-03-02,2012,March,23,Friday,Spring,Cloudy,23,19,4
2012-03-03,2012,March,0,Saturday,Spring,Light Snow/Rain,22,21,1
2012-03-03,2012,March,1,Saturday,Spring,Light Snow/Rain,44,44,0
2012-03-03,2012,March,2,Saturday,Spring,Light Snow/Rain,38,34,4
2012-03-03,2012,March,3,Saturday,Spring,Cloudy,21,20,1
2012-03-03,2012,March,4,Saturday,Spring,Cloudy,2,2,0
2012-03-03,2012,March,5,Saturday,Spring,Cloudy,2,1,1
2012-03-03,2012,March,6,Saturday,Spring,Cloudy,7,6,1
2012-03-03,2012,March,7,Saturday,Spring,Cloudy,16,14,2
2012-03-03,2012,March,8,Saturday,Spring,Light Snow/Rain,48,46,2
2012-03-03,2012,March,9,Saturday,Spring,Light Snow/Rain,94,87,7
2012-03-03,2012,March,10,Saturday,Spring,Cloudy,168,137,31
2012-03-03,2012,March,11,Saturday,Spring,Cloudy,214,181,33
2012-03-03,2012,March,12,Saturday,Spring,Cloudy,299,252,47
2012-03-03,2012,March,13,Saturday,Spring,Clear,339,252,87
2012-03-03,2012,March,14,Saturday,Spring,Cloudy,430,279,151
2012-03-03,2012,March,15,Saturday,Spring,Clear,399,254,145
2012-03-03,2012,March,16,Saturday,Spring,Clear,467,300,167
2012-03-03,2012,March,17,Saturday,Spring,Clear,385,279,106
2012-03-03,2012,March,18,Saturday,Spring,Clear,303,250,53
2012-03-03,2012,March,19,Saturday,Spring,Clear,225,191,34
2012-03-03,2012,March,20,Saturday,Spring,Clear,149,121,28
2012-03-03,2012,March,21,Saturday,Spring,Clear,154,130,24
2012-03-03,2012,March,22,Saturday,Spring,Clear,134,115,19
2012-03-03,2012,March,23,Saturday,Spring,Clear,106,94,12
2012-03-04,2012,March,0,Sunday,Spring,Cloudy,72,67,5
2012-03-04,2012,March,1,Sunday,Spring,Cloudy,76,60,16
2012-03-04,2012,March,2,Sunday,Spring,Cloudy,80,66,14
2012-03-04,2012,March,3,Sunday,Spring,Cloudy,26,21,5
2012-03-04,2012,March,4,Sunday,Spring,Cloudy,14,11,3
2012-03-04,2012,March,5,Sunday,Spring,Cloudy,5,5,0
2012-03-04,2012,March,6,Sunday,Spring,Cloudy,5,5,0
2012-03-04,2012,March,7,Sunday,Spring,Cloudy,23,21,2
2012-03-04,2012,March,8,Sunday,Spring,Clear,66,54,12
2012-03-04,2012,March,9,Sunday,Spring,Clear,118,104,14
2012-03-04,2012,March,10,Sunday,Spring,Clear,192,161,31
2012-03-04,2012,March,11,Sunday,Spring,Clear,256,192,64
2012-03-04,2012,March,12,Sunday,Spring,Clear,327,256,71
2012-03-04,2012,March,13,Sunday,Spring,Clear,364,256,108
2012-03-04,2012,March,14,Sunday,Spring,Clear,332,226,106
2012-03-04,2012,March,15,Sunday,Spring,Clear,334,252,82
2012-03-04,2012,March,16,Sunday,Spring,Clear,299,231,68
2012-03-04,2012,March,17,Sunday,Spring,Clear,263,214,49
2012-03-04,2012,March,18,Sunday,Spring,Clear,184,164,20
2012-03-04,2012,March,19,Sunday,Spring,Clear,132,120,12
2012-03-04,2012,March,20,Sunday,Spring,Clear,88,80,8
2012-03-04,2012,March,21,Sunday,Spring,Clear,79,70,9
2012-03-04,2012,March,22,Sunday,Spring,Clear,62,53,9
2012-03-04,2012,March,23,Sunday,Spring,Clear,26,24,2
2012-03-05,2012,March,0,Monday,Spring,Clear,17,15,2
2012-03-05,2012,March,1,Monday,Spring,Clear,6,3,3
2012-03-05,2012,March,2,Monday,Spring,Clear,4,3,1
2012-03-05,2012,March,3,Monday,Spring,Clear,1,1,0
2012-03-05,2012,March,4,Monday,Spring,Clear,1,1,0
2012-03-05,2012,March,5,Monday,Spring,Clear,18,17,1
2012-03-05,2012,March,6,Monday,Spring,Clear,91,89,2
2012-03-05,2012,March,7,Monday,Spring,Clear,260,253,7
2012-03-05,2012,March,8,Monday,Spring,Clear,428,415,13
2012-03-05,2012,March,9,Monday,Spring,Cloudy,197,186,11
2012-03-05,2012,March,10,Monday,Spring,Cloudy,86,74,12
2012-03-05,2012,March,11,Monday,Spring,Cloudy,103,86,17
2012-03-05,2012,March,12,Monday,Spring,Cloudy,137,122,15
2012-03-05,2012,March,13,Monday,Spring,Cloudy,120,109,11
2012-03-05,2012,March,14,Monday,Spring,Cloudy,128,115,13
2012-03-05,2012,March,15,Monday,Spring,Cloudy,130,110,20
2012-03-05,2012,March,16,Monday,Spring,Clear,210,180,30
2012-03-05,2012,March,17,Monday,Spring,Light Snow/Rain,387,376,11
2012-03-05,2012,March,18,Monday,Spring,Light Snow/Rain,375,363,12
2012-03-05,2012,March,19,Monday,Spring,Clear,226,220,6
2012-03-05,2012,March,20,Monday,Spring,Clear,179,171,8
2012-03-05,2012,March,21,Monday,Spring,Clear,120,116,4
2012-03-05,2012,March,22,Monday,Spring,Clear,78,76,2
2012-03-05,2012,March,23,Monday,Spring,Clear,31,29,2
2012-03-06,2012,March,0,Tuesday,Spring,Clear,8,8,0
2012-03-06,2012,March,1,Tuesday,Spring,Clear,6,6,0
2012-03-06,2012,March,2,Tuesday,Spring,Clear,4,4,0
2012-03-06,2012,March,3,Tuesday,Spring,Clear,1,1,0
2012-03-06,2012,March,4,Tuesday,Spring,Clear,3,3,0
2012-03-06,2012,March,5,Tuesday,Spring,Clear,25,25,0
2012-03-06,2012,March,6,Tuesday,Spring,Clear,102,99,3
2012-03-06,2012,March,7,Tuesday,Spring,Clear,275,270,5
2012-03-06,2012,March,8,Tuesday,Spring,Clear,501,487,14
2012-03-06,2012,March,9,Tuesday,Spring,Clear,233,222,11
2012-03-06,2012,March,10,Tuesday,Spring,Clear,129,113,16
2012-03-06,2012,March,11,Tuesday,Spring,Clear,130,110,20
2012-03-06,2012,March,12,Tuesday,Spring,Clear,138,129,9
2012-03-06,2012,March,13,Tuesday,Spring,Clear,164,148,16
2012-03-06,2012,March,14,Tuesday,Spring,Clear,136,116,20
2012-03-06,2012,March,15,Tuesday,Spring,Clear,166,142,24
2012-03-06,2012,March,16,Tuesday,Spring,Clear,250,228,22
2012-03-06,2012,March,17,Tuesday,Spring,Clear,446,425,21
2012-03-06,2012,March,18,Tuesday,Spring,Clear,457,442,15
2012-03-06,2012,March,19,Tuesday,Spring,Clear,287,278,9
2012-03-06,2012,March,20,Tuesday,Spring,Clear,187,184,3
2012-03-06,2012,March,21,Tuesday,Spring,Clear,148,143,5
2012-03-06,2012,March,22,Tuesday,Spring,Clear,106,101,5
2012-03-06,2012,March,23,Tuesday,Spring,Clear,54,51,3
2012-03-07,2012,March,0,Wednesday,Spring,Clear,15,12,3
2012-03-07,2012,March,1,Wednesday,Spring,Clear,5,4,1
2012-03-07,2012,March,2,Wednesday,Spring,Clear,4,4,0
2012-03-07,2012,March,3,Wednesday,Spring,Clear,3,2,1
2012-03-07,2012,March,4,Wednesday,Spring,Clear,3,3,0
2012-03-07,2012,March,5,Wednesday,Spring,Clear,18,18,0
2012-03-07,2012,March,6,Wednesday,Spring,Clear,108,104,4
2012-03-07,2012,March,7,Wednesday,Spring,Clear,344,332,12
2012-03-07,2012,March,8,Wednesday,Spring,Clear,566,554,12
2012-03-07,2012,March,9,Wednesday,Spring,Clear,264,252,12
2012-03-07,2012,March,10,Wednesday,Spring,Clear,147,127,20
2012-03-07,2012,March,11,Wednesday,Spring,Clear,161,128,33
2012-03-07,2012,March,12,Wednesday,Spring,Clear,215,175,40
2012-03-07,2012,March,13,Wednesday,Spring,Clear,205,179,26
2012-03-07,2012,March,14,Wednesday,Spring,Clear,175,137,38
2012-03-07,2012,March,15,Wednesday,Spring,Clear,209,165,44
2012-03-07,2012,March,16,Wednesday,Spring,Clear,288,254,34
2012-03-07,2012,March,17,Wednesday,Spring,Clear,612,554,58
2012-03-07,2012,March,18,Wednesday,Spring,Clear,544,509,35
2012-03-07,2012,March,19,Wednesday,Spring,Clear,361,345,16
2012-03-07,2012,March,20,Wednesday,Spring,Clear,260,242,18
2012-03-07,2012,March,21,Wednesday,Spring,Clear,188,177,11
2012-03-07,2012,March,22,Wednesday,Spring,Clear,159,149,10
2012-03-07,2012,March,23,Wednesday,Spring,Clear,62,58,4
2012-03-08,2012,March,0,Thursday,Spring,Clear,46,35,11
2012-03-08,2012,March,1,Thursday,Spring,Clear,21,17,4
2012-03-08,2012,March,2,Thursday,Spring,Clear,11,5,6
2012-03-08,2012,March,3,Thursday,Spring,Clear,3,3,0
2012-03-08,2012,March,4,Thursday,Spring,Clear,2,2,0
2012-03-08,2012,March,5,Thursday,Spring,Clear,29,28,1
2012-03-08,2012,March,6,Thursday,Spring,Clear,109,105,4
2012-03-08,2012,March,7,Thursday,Spring,Clear,334,326,8
2012-03-08,2012,March,8,Thursday,Spring,Clear,585,573,12
2012-03-08,2012,March,9,Thursday,Spring,Clear,301,282,19
2012-03-08,2012,March,10,Thursday,Spring,Clear,138,119,19
2012-03-08,2012,March,11,Thursday,Spring,Cloudy,204,156,48
2012-03-08,2012,March,12,Thursday,Spring,Cloudy,251,224,27
2012-03-08,2012,March,13,Thursday,Spring,Cloudy,233,198,35
2012-03-08,2012,March,14,Thursday,Spring,Cloudy,203,155,48
2012-03-08,2012,March,15,Thursday,Spring,Clear,185,161,24
2012-03-08,2012,March,16,Thursday,Spring,Cloudy,342,305,37
2012-03-08,2012,March,17,Thursday,Spring,Clear,597,545,52
2012-03-08,2012,March,18,Thursday,Spring,Cloudy,590,545,45
2012-03-08,2012,March,19,Thursday,Spring,Cloudy,416,395,21
2012-03-08,2012,March,20,Thursday,Spring,Cloudy,302,282,20
2012-03-08,2012,March,21,Thursday,Spring,Clear,233,206,27
2012-03-08,2012,March,22,Thursday,Spring,Clear,153,141,12
2012-03-08,2012,March,23,Thursday,Spring,Cloudy,94,88,6
2012-03-09,2012,March,0,Friday,Spring,Cloudy,54,51,3
2012-03-09,2012,March,1,Friday,Spring,Light Snow/Rain,26,22,4
2012-03-09,2012,March,2,Friday,Spring,Light Snow/Rain,11,9,2
2012-03-09,2012,March,3,Friday,Spring,Clear,7,7,0
2012-03-09,2012,March,4,Friday,Spring,Light Snow/Rain,1,1,0
2012-03-09,2012,March,5,Friday,Spring,Light Snow/Rain,29,27,2
2012-03-09,2012,March,6,Friday,Spring,Cloudy,85,83,2
2012-03-09,2012,March,7,Friday,Spring,Cloudy,268,262,6
2012-03-09,2012,March,8,Friday,Spring,Cloudy,501,484,17
2012-03-09,2012,March,9,Friday,Spring,Cloudy,284,267,17
2012-03-09,2012,March,10,Friday,Spring,Cloudy,159,145,14
2012-03-09,2012,March,11,Friday,Spring,Cloudy,187,170,17
2012-03-09,2012,March,12,Friday,Spring,Clear,201,174,27
2012-03-09,2012,March,13,Friday,Spring,Cloudy,224,175,49
2012-03-09,2012,March,14,Friday,Spring,Clear,178,129,49
2012-03-09,2012,March,15,Friday,Spring,Clear,238,188,50
2012-03-09,2012,March,16,Friday,Spring,Clear,343,292,51
2012-03-09,2012,March,17,Friday,Spring,Clear,566,498,68
2012-03-09,2012,March,18,Friday,Spring,Clear,470,440,30
2012-03-09,2012,March,19,Friday,Spring,Clear,244,232,12
2012-03-09,2012,March,20,Friday,Spring,Clear,159,156,3
2012-03-09,2012,March,21,Friday,Spring,Clear,141,133,8
2012-03-09,2012,March,22,Friday,Spring,Clear,107,100,7
2012-03-09,2012,March,23,Friday,Spring,Clear,86,77,9
2012-03-10,2012,March,0,Saturday,Spring,Clear,77,68,9
2012-03-10,2012,March,1,Saturday,Spring,Clear,51,50,1
2012-03-10,2012,March,2,Saturday,Spring,Clear,42,30,12
2012-03-10,2012,March,3,Saturday,Spring,Clear,16,16,0
2012-03-10,2012,March,4,Saturday,Spring,Clear,4,3,1
2012-03-10,2012,March,5,Saturday,Spring,Clear,10,7,3
2012-03-10,2012,March,6,Saturday,Spring,Clear,12,11,1
2012-03-10,2012,March,7,Saturday,Spring,Clear,40,36,4
2012-03-10,2012,March,8,Saturday,Spring,Clear,111,96,15
2012-03-10,2012,March,9,Saturday,Spring,Clear,148,127,21
2012-03-10,2012,March,10,Saturday,Spring,Clear,223,176,47
2012-03-10,2012,March,11,Saturday,Spring,Clear,274,218,56
2012-03-10,2012,March,12,Saturday,Spring,Clear,329,241,88
2012-03-10,2012,March,13,Saturday,Spring,Clear,357,268,89
2012-03-10,2012,March,14,Saturday,Spring,Clear,379,262,117
2012-03-10,2012,March,15,Saturday,Spring,Clear,406,274,132
2012-03-10,2012,March,16,Saturday,Spring,Clear,390,275,115
2012-03-10,2012,March,17,Saturday,Spring,Clear,354,250,104
2012-03-10,2012,March,18,Saturday,Spring,Clear,297,230,67
2012-03-10,2012,March,19,Saturday,Spring,Clear,184,159,25
2012-03-10,2012,March,20,Saturday,Spring,Clear,121,101,20
2012-03-10,2012,March,21,Saturday,Spring,Clear,110,94,16
2012-03-10,2012,March,22,Saturday,Spring,Clear,100,81,19
2012-03-10,2012,March,23,Saturday,Spring,Clear,83,77,6
2012-03-11,2012,March,0,Sunday,Spring,Clear,69,62,7
2012-03-11,2012,March,1,Sunday,Spring,Clear,61,57,4
2012-03-11,2012,March,3,Sunday,Spring,Clear,66,51,15
2012-03-11,2012,March,4,Sunday,Spring,Clear,22,15,7
2012-03-11,2012,March,5,Sunday,Spring,Clear,7,5,2
2012-03-11,2012,March,6,Sunday,Spring,Clear,10,8,2
2012-03-11,2012,March,7,Sunday,Spring,Clear,17,15,2
2012-03-11,2012,March,8,Sunday,Spring,Clear,72,68,4
2012-03-11,2012,March,9,Sunday,Spring,Clear,90,70,20
2012-03-11,2012,March,10,Sunday,Spring,Clear,218,147,71
2012-03-11,2012,March,11,Sunday,Spring,Clear,299,209,90
2012-03-11,2012,March,12,Sunday,Spring,Clear,410,264,146
2012-03-11,2012,March,13,Sunday,Spring,Clear,464,288,176
2012-03-11,2012,March,14,Sunday,Spring,Clear,501,289,212
2012-03-11,2012,March,15,Sunday,Spring,Clear,487,286,201
2012-03-11,2012,March,16,Sunday,Spring,Clear,509,301,208
2012-03-11,2012,March,17,Sunday,Spring,Clear,498,299,199
2012-03-11,2012,March,18,Sunday,Spring,Clear,389,256,133
2012-03-11,2012,March,19,Sunday,Spring,Clear,258,203,55
2012-03-11,2012,March,20,Sunday,Spring,Clear,171,129,42
2012-03-11,2012,March,21,Sunday,Spring,Clear,147,110,37
2012-03-11,2012,March,22,Sunday,Spring,Clear,94,81,13
2012-03-11,2012,March,23,Sunday,Spring,Clear,52,40,12
2012-03-12,2012,March,0,Monday,Spring,Clear,24,20,4
2012-03-12,2012,March,1,Monday,Spring,Clear,10,9,1
2012-03-12,2012,March,2,Monday,Spring,Clear,9,5,4
2012-03-12,2012,March,3,Monday,Spring,Clear,2,2,0
2012-03-12,2012,March,4,Monday,Spring,Clear,3,3,0
2012-03-12,2012,March,5,Monday,Spring,Clear,16,15,1
2012-03-12,2012,March,6,Monday,Spring,Clear,88,86,2
2012-03-12,2012,March,7,Monday,Spring,Clear,268,259,9
2012-03-12,2012,March,8,Monday,Spring,Clear,564,547,17
2012-03-12,2012,March,9,Monday,Spring,Clear,281,260,21
2012-03-12,2012,March,10,Monday,Spring,Clear,137,98,39
2012-03-12,2012,March,11,Monday,Spring,Clear,150,111,39
2012-03-12,2012,March,12,Monday,Spring,Clear,221,162,59
2012-03-12,2012,March,13,Monday,Spring,Cloudy,250,176,74
2012-03-12,2012,March,14,Monday,Spring,Cloudy,221,145,76
2012-03-12,2012,March,15,Monday,Spring,Clear,233,159,74
2012-03-12,2012,March,16,Monday,Spring,Clear,332,255,77
2012-03-12,2012,March,17,Monday,Spring,Cloudy,644,557,87
2012-03-12,2012,March,18,Monday,Spring,Cloudy,712,623,89
2012-03-12,2012,March,19,Monday,Spring,Cloudy,446,379,67
2012-03-12,2012,March,20,Monday,Spring,Cloudy,286,237,49
2012-03-12,2012,March,21,Monday,Spring,Cloudy,205,183,22
2012-03-12,2012,March,22,Monday,Spring,Cloudy,133,116,17
2012-03-12,2012,March,23,Monday,Spring,Clear,63,53,10
2012-03-13,2012,March,0,Tuesday,Spring,Cloudy,26,21,5
2012-03-13,2012,March,1,Tuesday,Spring,Cloudy,16,14,2
2012-03-13,2012,March,2,Tuesday,Spring,Light Snow/Rain,1,1,0
2012-03-13,2012,March,3,Tuesday,Spring,Light Snow/Rain,2,2,0
2012-03-13,2012,March,4,Tuesday,Spring,Cloudy,1,1,0
2012-03-13,2012,March,5,Tuesday,Spring,Cloudy,24,24,0
2012-03-13,2012,March,6,Tuesday,Spring,Light Snow/Rain,113,108,5
2012-03-13,2012,March,7,Tuesday,Spring,Cloudy,308,292,16
2012-03-13,2012,March,8,Tuesday,Spring,Clear,593,571,22
2012-03-13,2012,March,9,Tuesday,Spring,Clear,342,324,18
2012-03-13,2012,March,10,Tuesday,Spring,Clear,143,115,28
2012-03-13,2012,March,11,Tuesday,Spring,Clear,219,155,64
2012-03-13,2012,March,12,Tuesday,Spring,Clear,244,197,47
2012-03-13,2012,March,13,Tuesday,Spring,Clear,233,180,53
2012-03-13,2012,March,14,Tuesday,Spring,Clear,212,160,52
2012-03-13,2012,March,15,Tuesday,Spring,Clear,264,196,68
2012-03-13,2012,March,16,Tuesday,Spring,Clear,365,312,53
2012-03-13,2012,March,17,Tuesday,Spring,Clear,676,614,62
2012-03-13,2012,March,18,Tuesday,Spring,Clear,734,638,96
2012-03-13,2012,March,19,Tuesday,Spring,Clear,479,429,50
2012-03-13,2012,March,20,Tuesday,Spring,Clear,351,306,45
2012-03-13,2012,March,21,Tuesday,Spring,Clear,244,200,44
2012-03-13,2012,March,22,Tuesday,Spring,Clear,170,146,24
2012-03-13,2012,March,23,Tuesday,Spring,Clear,87,79,8
2012-03-14,2012,March,0,Wednesday,Spring,Clear,39,34,5
2012-03-14,2012,March,1,Wednesday,Spring,Clear,27,25,2
2012-03-14,2012,March,2,Wednesday,Spring,Clear,2,2,0
2012-03-14,2012,March,3,Wednesday,Spring,Clear,4,3,1
2012-03-14,2012,March,4,Wednesday,Spring,Clear,5,4,1
2012-03-14,2012,March,5,Wednesday,Spring,Clear,27,25,2
2012-03-14,2012,March,6,Wednesday,Spring,Clear,121,120,1
2012-03-14,2012,March,7,Wednesday,Spring,Clear,368,348,20
2012-03-14,2012,March,8,Wednesday,Spring,Clear,662,628,34
2012-03-14,2012,March,9,Wednesday,Spring,Clear,351,325,26
2012-03-14,2012,March,10,Wednesday,Spring,Clear,188,150,38
2012-03-14,2012,March,11,Wednesday,Spring,Cloudy,220,155,65
2012-03-14,2012,March,12,Wednesday,Spring,Cloudy,267,212,55
2012-03-14,2012,March,13,Wednesday,Spring,Clear,254,197,57
2012-03-14,2012,March,14,Wednesday,Spring,Clear,224,163,61
2012-03-14,2012,March,15,Wednesday,Spring,Clear,283,197,86
2012-03-14,2012,March,16,Wednesday,Spring,Clear,356,278,78
2012-03-14,2012,March,17,Wednesday,Spring,Clear,782,642,140
2012-03-14,2012,March,18,Wednesday,Spring,Clear,749,647,102
2012-03-14,2012,March,19,Wednesday,Spring,Clear,472,402,70
2012-03-14,2012,March,20,Wednesday,Spring,Clear,330,286,44
2012-03-14,2012,March,21,Wednesday,Spring,Clear,288,241,47
2012-03-14,2012,March,22,Wednesday,Spring,Clear,202,159,43
2012-03-14,2012,March,23,Wednesday,Spring,Clear,91,72,19
2012-03-15,2012,March,0,Thursday,Spring,Clear,60,46,14
2012-03-15,2012,March,1,Thursday,Spring,Clear,23,8,15
2012-03-15,2012,March,2,Thursday,Spring,Clear,19,5,14
2012-03-15,2012,March,3,Thursday,Spring,Clear,7,7,0
2012-03-15,2012,March,4,Thursday,Spring,Clear,14,3,11
2012-03-15,2012,March,5,Thursday,Spring,Clear,26,24,2
2012-03-15,2012,March,6,Thursday,Spring,Clear,117,113,4
2012-03-15,2012,March,7,Thursday,Spring,Clear,381,367,14
2012-03-15,2012,March,8,Thursday,Spring,Clear,623,602,21
2012-03-15,2012,March,9,Thursday,Spring,Clear,315,285,30
2012-03-15,2012,March,10,Thursday,Spring,Clear,164,130,34
2012-03-15,2012,March,11,Thursday,Spring,Clear,211,151,60
2012-03-15,2012,March,12,Thursday,Spring,Cloudy,265,206,59
2012-03-15,2012,March,13,Thursday,Spring,Cloudy,273,211,62
2012-03-15,2012,March,14,Thursday,Spring,Cloudy,258,177,81
2012-03-15,2012,March,15,Thursday,Spring,Clear,287,187,100
2012-03-15,2012,March,16,Thursday,Spring,Clear,426,331,95
2012-03-15,2012,March,17,Thursday,Spring,Clear,713,634,79
2012-03-15,2012,March,18,Thursday,Spring,Clear,746,648,98
2012-03-15,2012,March,19,Thursday,Spring,Cloudy,425,353,72
2012-03-15,2012,March,20,Thursday,Spring,Cloudy,330,270,60
2012-03-15,2012,March,21,Thursday,Spring,Clear,243,207,36
2012-03-15,2012,March,22,Thursday,Spring,Clear,169,137,32
2012-03-15,2012,March,23,Thursday,Spring,Clear,97,85,12
2012-03-16,2012,March,0,Friday,Spring,Clear,57,49,8
2012-03-16,2012,March,1,Friday,Spring,Cloudy,26,22,4
2012-03-16,2012,March,2,Friday,Spring,Cloudy,4,4,0
2012-03-16,2012,March,3,Friday,Spring,Cloudy,3,3,0
2012-03-16,2012,March,4,Friday,Spring,Cloudy,3,3,0
2012-03-16,2012,March,5,Friday,Spring,Cloudy,32,30,2
2012-03-16,2012,March,6,Friday,Spring,Cloudy,99,96,3
2012-03-16,2012,March,7,Friday,Spring,Cloudy,278,265,13
2012-03-16,2012,March,8,Friday,Spring,Cloudy,562,534,28
2012-03-16,2012,March,9,Friday,Spring,Cloudy,312,277,35
2012-03-16,2012,March,10,Friday,Spring,Cloudy,180,136,44
2012-03-16,2012,March,11,Friday,Spring,Cloudy,207,167,40
2012-03-16,2012,March,12,Friday,Spring,Cloudy,294,222,72
2012-03-16,2012,March,13,Friday,Spring,Cloudy,260,208,52
2012-03-16,2012,March,14,Friday,Spring,Cloudy,202,146,56
2012-03-16,2012,March,15,Friday,Spring,Light Snow/Rain,107,88,19
2012-03-16,2012,March,16,Friday,Spring,Light Snow/Rain,129,111,18
2012-03-16,2012,March,17,Friday,Spring,Light Snow/Rain,258,235,23
2012-03-16,2012,March,18,Friday,Spring,Light Snow/Rain,408,377,31
2012-03-16,2012,March,19,Friday,Spring,Cloudy,296,273,23
2012-03-16,2012,March,20,Friday,Spring,Clear,235,204,31
2012-03-16,2012,March,21,Friday,Spring,Cloudy,152,144,8
2012-03-16,2012,March,22,Friday,Spring,Cloudy,148,132,16
2012-03-16,2012,March,23,Friday,Spring,Cloudy,126,104,22
2012-03-17,2012,March,0,Saturday,Spring,Cloudy,100,87,13
2012-03-17,2012,March,1,Saturday,Spring,Cloudy,69,57,12
2012-03-17,2012,March,2,Saturday,Spring,Cloudy,42,32,10
2012-03-17,2012,March,3,Saturday,Spring,Cloudy,26,24,2
2012-03-17,2012,March,4,Saturday,Spring,Cloudy,2,2,0
2012-03-17,2012,March,5,Saturday,Spring,Cloudy,8,3,5
2012-03-17,2012,March,6,Saturday,Spring,Cloudy,30,29,1
2012-03-17,2012,March,7,Saturday,Spring,Cloudy,86,57,29
2012-03-17,2012,March,8,Saturday,Spring,Cloudy,218,155,63
2012-03-17,2012,March,9,Saturday,Spring,Cloudy,321,217,104
2012-03-17,2012,March,10,Saturday,Spring,Cloudy,443,303,140
2012-03-17,2012,March,11,Saturday,Spring,Cloudy,585,359,226
2012-03-17,2012,March,12,Saturday,Spring,Clear,651,365,286
2012-03-17,2012,March,13,Saturday,Spring,Clear,686,400,286
2012-03-17,2012,March,14,Saturday,Spring,Clear,690,338,352
2012-03-17,2012,March,15,Saturday,Spring,Clear,679,322,357
2012-03-17,2012,March,16,Saturday,Spring,Clear,685,318,367
2012-03-17,2012,March,17,Saturday,Spring,Clear,648,357,291
2012-03-17,2012,March,18,Saturday,Spring,Clear,560,339,221
2012-03-17,2012,March,19,Saturday,Spring,Clear,417,262,155
2012-03-17,2012,March,20,Saturday,Spring,Clear,271,182,89
2012-03-17,2012,March,21,Saturday,Spring,Clear,223,169,54
2012-03-17,2012,March,22,Saturday,Spring,Clear,211,153,58
2012-03-17,2012,March,23,Saturday,Spring,Clear,185,151,34
2012-03-18,2012,March,0,Sunday,Spring,Clear,107,80,27
2012-03-18,2012,March,1,Sunday,Spring,Clear,113,88,25
2012-03-18,2012,March,2,Sunday,Spring,Cloudy,56,41,15
2012-03-18,2012,March,3,Sunday,Spring,Cloudy,18,15,3
2012-03-18,2012,March,4,Sunday,Spring,Cloudy,14,8,6
2012-03-18,2012,March,5,Sunday,Spring,Cloudy,6,6,0
2012-03-18,2012,March,6,Sunday,Spring,Cloudy,11,9,2
2012-03-18,2012,March,7,Sunday,Spring,Light Snow/Rain,42,25,17
2012-03-18,2012,March,8,Sunday,Spring,Cloudy,96,71,25
2012-03-18,2012,March,9,Sunday,Spring,Cloudy,178,113,65
2012-03-18,2012,March,10,Sunday,Spring,Cloudy,351,212,139
2012-03-18,2012,March,11,Sunday,Spring,Cloudy,368,239,129
2012-03-18,2012,March,12,Sunday,Spring,Cloudy,503,281,222
2012-03-18,2012,March,13,Sunday,Spring,Cloudy,544,346,198
2012-03-18,2012,March,14,Sunday,Spring,Cloudy,521,303,218
2012-03-18,2012,March,15,Sunday,Spring,Clear,554,314,240
2012-03-18,2012,March,16,Sunday,Spring,Clear,541,312,229
2012-03-18,2012,March,17,Sunday,Spring,Clear,541,308,233
2012-03-18,2012,March,18,Sunday,Spring,Clear,459,294,165
2012-03-18,2012,March,19,Sunday,Spring,Clear,352,234,118
2012-03-18,2012,March,20,Sunday,Spring,Clear,198,139,59
2012-03-18,2012,March,21,Sunday,Spring,Clear,173,129,44
2012-03-18,2012,March,22,Sunday,Spring,Clear,100,79,21
2012-03-18,2012,March,23,Sunday,Spring,Clear,46,39,7
2012-03-19,2012,March,0,Monday,Spring,Clear,23,19,4
2012-03-19,2012,March,1,Monday,Spring,Clear,15,15,0
2012-03-19,2012,March,2,Monday,Spring,Clear,8,7,1
2012-03-19,2012,March,3,Monday,Spring,Clear,2,2,0
2012-03-19,2012,March,4,Monday,Spring,Clear,3,3,0
2012-03-19,2012,March,5,Monday,Spring,Clear,31,31,0
2012-03-19,2012,March,6,Monday,Spring,Clear,120,118,2
2012-03-19,2012,March,7,Monday,Spring,Clear,354,329,25
2012-03-19,2012,March,8,Monday,Spring,Clear,579,563,16
2012-03-19,2012,March,9,Monday,Spring,Clear,331,276,55
2012-03-19,2012,March,10,Monday,Spring,Clear,184,128,56
2012-03-19,2012,March,11,Monday,Spring,Clear,201,145,56
2012-03-19,2012,March,12,Monday,Spring,Clear,282,211,71
2012-03-19,2012,March,13,Monday,Spring,Clear,263,194,69
2012-03-19,2012,March,14,Monday,Spring,Cloudy,260,200,60
2012-03-19,2012,March,15,Monday,Spring,Clear,286,189,97
2012-03-19,2012,March,16,Monday,Spring,Clear,385,320,65
2012-03-19,2012,March,17,Monday,Spring,Clear,721,615,106
2012-03-19,2012,March,18,Monday,Spring,Clear,801,681,120
2012-03-19,2012,March,19,Monday,Spring,Clear,549,463,86
2012-03-19,2012,March,20,Monday,Spring,Clear,330,296,34
2012-03-19,2012,March,21,Monday,Spring,Clear,223,190,33
2012-03-19,2012,March,22,Monday,Spring,Cloudy,148,131,17
2012-03-19,2012,March,23,Monday,Spring,Cloudy,54,45,9
2012-03-20,2012,March,0,Tuesday,Spring,Cloudy,29,24,5
2012-03-20,2012,March,1,Tuesday,Spring,Clear,15,9,6
2012-03-20,2012,March,2,Tuesday,Spring,Clear,10,8,2
2012-03-20,2012,March,3,Tuesday,Spring,Cloudy,3,3,0
2012-03-20,2012,March,4,Tuesday,Spring,Cloudy,6,6,0
2012-03-20,2012,March,5,Tuesday,Spring,Cloudy,20,20,0
2012-03-20,2012,March,6,Tuesday,Spring,Cloudy,100,94,6
2012-03-20,2012,March,7,Tuesday,Spring,Light Snow/Rain,170,167,3
2012-03-20,2012,March,8,Tuesday,Spring,Cloudy,516,488,28
2012-03-20,2012,March,9,Tuesday,Spring,Cloudy,325,284,41
2012-03-20,2012,March,10,Tuesday,Spring,Clear,163,119,44
2012-03-20,2012,March,11,Tuesday,Spring,Clear,230,156,74
2012-03-20,2012,March,12,Tuesday,Spring,Clear,261,205,56
2012-03-20,2012,March,13,Tuesday,Spring,Clear,284,207,77
2012-03-20,2012,March,14,Tuesday,Spring,Cloudy,248,182,66
2012-03-20,2012,March,15,Tuesday,Spring,Cloudy,244,177,67
2012-03-20,2012,March,16,Tuesday,Spring,Clear,431,332,99
2012-03-20,2012,March,17,Tuesday,Spring,Clear,750,642,108
2012-03-20,2012,March,18,Tuesday,Spring,Clear,801,665,136
2012-03-20,2012,March,19,Tuesday,Spring,Clear,555,480,75
2012-03-20,2012,March,20,Tuesday,Spring,Clear,377,299,78
2012-03-20,2012,March,21,Tuesday,Spring,Clear,277,239,38
2012-03-20,2012,March,22,Tuesday,Spring,Clear,188,156,32
2012-03-20,2012,March,23,Tuesday,Spring,Clear,90,80,10
2012-03-21,2012,March,0,Wednesday,Summer,Clear,33,29,4
2012-03-21,2012,March,1,Wednesday,Summer,Clear,26,22,4
2012-03-21,2012,March,2,Wednesday,Summer,Clear,10,8,2
2012-03-21,2012,March,3,Wednesday,Summer,Cloudy,8,7,1
2012-03-21,2012,March,4,Wednesday,Summer,Cloudy,4,4,0
2012-03-21,2012,March,5,Wednesday,Summer,Cloudy,39,35,4
2012-03-21,2012,March,6,Wednesday,Summer,Cloudy,149,139,10
2012-03-21,2012,March,7,Wednesday,Summer,Light Snow/Rain,372,338,34
2012-03-21,2012,March,8,Wednesday,Summer,Light Snow/Rain,535,502,33
2012-03-21,2012,March,9,Wednesday,Summer,Cloudy,293,255,38
2012-03-21,2012,March,10,Wednesday,Summer,Cloudy,154,124,30
2012-03-21,2012,March,11,Wednesday,Summer,Cloudy,192,154,38
2012-03-21,2012,March,12,Wednesday,Summer,Cloudy,229,171,58
2012-03-21,2012,March,13,Wednesday,Summer,Cloudy,303,222,81
2012-03-21,2012,March,14,Wednesday,Summer,Cloudy,225,151,74
2012-03-21,2012,March,15,Wednesday,Summer,Cloudy,243,175,68
2012-03-21,2012,March,16,Wednesday,Summer,Clear,378,287,91
2012-03-21,2012,March,17,Wednesday,Summer,Clear,729,616,113
2012-03-21,2012,March,18,Wednesday,Summer,Clear,779,627,152
2012-03-21,2012,March,19,Wednesday,Summer,Clear,582,496,86
2012-03-21,2012,March,20,Wednesday,Summer,Clear,374,298,76
2012-03-21,2012,March,21,Wednesday,Summer,Clear,251,204,47
2012-03-21,2012,March,22,Wednesday,Summer,Clear,197,156,41
2012-03-21,2012,March,23,Wednesday,Summer,Clear,125,88,37
2012-03-22,2012,March,0,Thursday,Summer,Clear,41,32,9
2012-03-22,2012,March,1,Thursday,Summer,Clear,30,16,14
2012-03-22,2012,March,2,Thursday,Summer,Clear,6,5,1
2012-03-22,2012,March,3,Thursday,Summer,Clear,7,7,0
2012-03-22,2012,March,4,Thursday,Summer,Cloudy,6,6,0
2012-03-22,2012,March,5,Thursday,Summer,Cloudy,34,32,2
2012-03-22,2012,March,6,Thursday,Summer,Cloudy,136,126,10
2012-03-22,2012,March,7,Thursday,Summer,Cloudy,361,332,29
2012-03-22,2012,March,8,Thursday,Summer,Cloudy,649,598,51
2012-03-22,2012,March,9,Thursday,Summer,Cloudy,318,277,41
2012-03-22,2012,March,10,Thursday,Summer,Cloudy,142,110,32
2012-03-22,2012,March,11,Thursday,Summer,Cloudy,219,166,53
2012-03-22,2012,March,12,Thursday,Summer,Cloudy,272,224,48
2012-03-22,2012,March,13,Thursday,Summer,Clear,298,215,83
2012-03-22,2012,March,14,Thursday,Summer,Clear,257,161,96
2012-03-22,2012,March,15,Thursday,Summer,Clear,304,202,102
2012-03-22,2012,March,16,Thursday,Summer,Clear,425,300,125
2012-03-22,2012,March,17,Thursday,Summer,Clear,810,656,154
2012-03-22,2012,March,18,Thursday,Summer,Clear,801,654,147
2012-03-22,2012,March,19,Thursday,Summer,Clear,586,469,117
2012-03-22,2012,March,20,Thursday,Summer,Clear,424,360,64
2012-03-22,2012,March,21,Thursday,Summer,Clear,374,308,66
2012-03-22,2012,March,22,Thursday,Summer,Clear,220,164,56
2012-03-22,2012,March,23,Thursday,Summer,Clear,151,117,34
2012-03-23,2012,March,0,Friday,Summer,Clear,95,65,30
2012-03-23,2012,March,1,Friday,Summer,Clear,50,32,18
2012-03-23,2012,March,2,Friday,Summer,Clear,32,20,12
2012-03-23,2012,March,3,Friday,Summer,Clear,10,6,4
2012-03-23,2012,March,4,Friday,Summer,Cloudy,3,3,0
2012-03-23,2012,March,5,Friday,Summer,Cloudy,34,29,5
2012-03-23,2012,March,6,Friday,Summer,Cloudy,116,110,6
2012-03-23,2012,March,7,Friday,Summer,Cloudy,346,318,28
2012-03-23,2012,March,8,Friday,Summer,Cloudy,662,615,47
2012-03-23,2012,March,9,Friday,Summer,Cloudy,380,305,75
2012-03-23,2012,March,10,Friday,Summer,Cloudy,275,150,125
2012-03-23,2012,March,11,Friday,Summer,Cloudy,318,187,131
2012-03-23,2012,March,12,Friday,Summer,Cloudy,471,272,199
2012-03-23,2012,March,13,Friday,Summer,Cloudy,428,256,172
2012-03-23,2012,March,14,Friday,Summer,Cloudy,432,224,208
2012-03-23,2012,March,15,Friday,Summer,Cloudy,472,281,191
2012-03-23,2012,March,16,Friday,Summer,Cloudy,589,370,219
2012-03-23,2012,March,17,Friday,Summer,Cloudy,957,693,264
2012-03-23,2012,March,18,Friday,Summer,Clear,830,593,237
2012-03-23,2012,March,19,Friday,Summer,Clear,686,473,213
2012-03-23,2012,March,20,Friday,Summer,Clear,445,328,117
2012-03-23,2012,March,21,Friday,Summer,Clear,284,220,64
2012-03-23,2012,March,22,Friday,Summer,Clear,271,218,53
2012-03-23,2012,March,23,Friday,Summer,Clear,176,125,51
2012-03-24,2012,March,0,Saturday,Summer,Clear,156,111,45
2012-03-24,2012,March,1,Saturday,Summer,Clear,128,108,20
2012-03-24,2012,March,2,Saturday,Summer,Clear,69,55,14
2012-03-24,2012,March,3,Saturday,Summer,Clear,32,22,10
2012-03-24,2012,March,4,Saturday,Summer,Clear,7,6,1
2012-03-24,2012,March,5,Saturday,Summer,Cloudy,4,4,0
2012-03-24,2012,March,6,Saturday,Summer,Cloudy,28,24,4
2012-03-24,2012,March,7,Saturday,Summer,Cloudy,70,45,25
2012-03-24,2012,March,8,Saturday,Summer,Cloudy,154,113,41
2012-03-24,2012,March,9,Saturday,Summer,Cloudy,249,153,96
2012-03-24,2012,March,10,Saturday,Summer,Cloudy,345,197,148
2012-03-24,2012,March,11,Saturday,Summer,Cloudy,273,175,98
2012-03-24,2012,March,12,Saturday,Summer,Light Snow/Rain,183,122,61
2012-03-24,2012,March,13,Saturday,Summer,Light Snow/Rain,196,134,62
2012-03-24,2012,March,14,Saturday,Summer,Light Snow/Rain,223,160,63
2012-03-24,2012,March,15,Saturday,Summer,Light Snow/Rain,290,172,118
2012-03-24,2012,March,16,Saturday,Summer,Light Snow/Rain,177,128,49
2012-03-24,2012,March,17,Saturday,Summer,Light Snow/Rain,115,68,47
2012-03-24,2012,March,18,Saturday,Summer,Light Snow/Rain,137,110,27
2012-03-24,2012,March,19,Saturday,Summer,Light Snow/Rain,133,105,28
2012-03-24,2012,March,20,Saturday,Summer,Light Snow/Rain,111,80,31
2012-03-24,2012,March,21,Saturday,Summer,Light Snow/Rain,104,88,16
2012-03-24,2012,March,22,Saturday,Summer,Light Snow/Rain,83,71,12
2012-03-24,2012,March,23,Saturday,Summer,Cloudy,105,88,17
2012-03-25,2012,March,0,Sunday,Summer,Cloudy,80,62,18
2012-03-25,2012,March,1,Sunday,Summer,Cloudy,89,65,24
2012-03-25,2012,March,2,Sunday,Summer,Light Snow/Rain,35,29,6
2012-03-25,2012,March,3,Sunday,Summer,Light Snow/Rain,18,10,8
2012-03-25,2012,March,4,Sunday,Summer,Cloudy,8,7,1
2012-03-25,2012,March,5,Sunday,Summer,Cloudy,6,6,0
2012-03-25,2012,March,6,Sunday,Summer,Cloudy,18,13,5
2012-03-25,2012,March,7,Sunday,Summer,Cloudy,39,25,14
2012-03-25,2012,March,8,Sunday,Summer,Cloudy,89,68,21
2012-03-25,2012,March,9,Sunday,Summer,Cloudy,118,92,26
2012-03-25,2012,March,10,Sunday,Summer,Cloudy,250,172,78
2012-03-25,2012,March,11,Sunday,Summer,Cloudy,323,217,106
2012-03-25,2012,March,12,Sunday,Summer,Cloudy,360,238,122
2012-03-25,2012,March,13,Sunday,Summer,Cloudy,367,257,110
2012-03-25,2012,March,14,Sunday,Summer,Cloudy,414,291,123
2012-03-25,2012,March,15,Sunday,Summer,Cloudy,421,282,139
2012-03-25,2012,March,16,Sunday,Summer,Clear,492,339,153
2012-03-25,2012,March,17,Sunday,Summer,Clear,419,273,146
2012-03-25,2012,March,18,Sunday,Summer,Clear,491,289,202
2012-03-25,2012,March,19,Sunday,Summer,Clear,375,261,114
2012-03-25,2012,March,20,Sunday,Summer,Clear,259,196,63
2012-03-25,2012,March,21,Sunday,Summer,Clear,149,124,25
2012-03-25,2012,March,22,Sunday,Summer,Clear,111,92,19
2012-03-25,2012,March,23,Sunday,Summer,Clear,65,56,9
2012-03-26,2012,March,0,Monday,Summer,Cloudy,33,23,10
2012-03-26,2012,March,1,Monday,Summer,Clear,28,10,18
2012-03-26,2012,March,2,Monday,Summer,Clear,20,6,14
2012-03-26,2012,March,3,Monday,Summer,Clear,1,1,0
2012-03-26,2012,March,4,Monday,Summer,Clear,4,4,0
2012-03-26,2012,March,5,Monday,Summer,Clear,36,36,0
2012-03-26,2012,March,6,Monday,Summer,Clear,117,110,7
2012-03-26,2012,March,7,Monday,Summer,Clear,370,355,15
2012-03-26,2012,March,8,Monday,Summer,Clear,657,625,32
2012-03-26,2012,March,9,Monday,Summer,Clear,282,245,37
2012-03-26,2012,March,10,Monday,Summer,Clear,153,98,55
2012-03-26,2012,March,11,Monday,Summer,Clear,178,131,47
2012-03-26,2012,March,12,Monday,Summer,Clear,279,216,63
2012-03-26,2012,March,13,Monday,Summer,Clear,301,222,79
2012-03-26,2012,March,14,Monday,Summer,Clear,217,159,58
2012-03-26,2012,March,15,Monday,Summer,Clear,223,157,66
2012-03-26,2012,March,16,Monday,Summer,Clear,305,245,60
2012-03-26,2012,March,17,Monday,Summer,Clear,664,599,65
2012-03-26,2012,March,18,Monday,Summer,Clear,684,594,90
2012-03-26,2012,March,19,Monday,Summer,Clear,458,417,41
2012-03-26,2012,March,20,Monday,Summer,Clear,221,209,12
2012-03-26,2012,March,21,Monday,Summer,Clear,186,175,11
2012-03-26,2012,March,22,Monday,Summer,Clear,93,80,13
2012-03-26,2012,March,23,Monday,Summer,Clear,48,46,2
2012-03-27,2012,March,0,Tuesday,Summer,Clear,10,9,1
2012-03-27,2012,March,1,Tuesday,Summer,Clear,5,4,1
2012-03-27,2012,March,2,Tuesday,Summer,Clear,7,6,1
2012-03-27,2012,March,3,Tuesday,Summer,Clear,4,4,0
2012-03-27,2012,March,4,Tuesday,Summer,Clear,3,3,0
2012-03-27,2012,March,5,Tuesday,Summer,Clear,17,16,1
2012-03-27,2012,March,6,Tuesday,Summer,Clear,101,96,5
2012-03-27,2012,March,7,Tuesday,Summer,Clear,286,277,9
2012-03-27,2012,March,8,Tuesday,Summer,Clear,581,567,14
2012-03-27,2012,March,9,Tuesday,Summer,Clear,267,259,8
2012-03-27,2012,March,10,Tuesday,Summer,Clear,138,118,20
2012-03-27,2012,March,11,Tuesday,Summer,Clear,175,141,34
2012-03-27,2012,March,12,Tuesday,Summer,Clear,220,186,34
2012-03-27,2012,March,13,Tuesday,Summer,Clear,211,165,46
2012-03-27,2012,March,14,Tuesday,Summer,Clear,184,147,37
2012-03-27,2012,March,15,Tuesday,Summer,Clear,200,158,42
2012-03-27,2012,March,16,Tuesday,Summer,Clear,305,267,38
2012-03-27,2012,March,17,Tuesday,Summer,Clear,614,542,72
2012-03-27,2012,March,18,Tuesday,Summer,Clear,644,577,67
2012-03-27,2012,March,19,Tuesday,Summer,Clear,417,377,40
2012-03-27,2012,March,20,Tuesday,Summer,Clear,294,266,28
2012-03-27,2012,March,21,Tuesday,Summer,Clear,221,200,21
2012-03-27,2012,March,22,Tuesday,Summer,Clear,134,127,7
2012-03-27,2012,March,23,Tuesday,Summer,Clear,64,59,5
2012-03-28,2012,March,0,Wednesday,Summer,Clear,30,29,1
2012-03-28,2012,March,1,Wednesday,Summer,Clear,8,8,0
2012-03-28,2012,March,2,Wednesday,Summer,Clear,3,3,0
2012-03-28,2012,March,3,Wednesday,Summer,Clear,5,4,1
2012-03-28,2012,March,4,Wednesday,Summer,Clear,1,0,1
2012-03-28,2012,March,5,Wednesday,Summer,Clear,40,38,2
2012-03-28,2012,March,6,Wednesday,Summer,Clear,115,111,4
2012-03-28,2012,March,7,Wednesday,Summer,Clear,358,348,10
2012-03-28,2012,March,8,Wednesday,Summer,Clear,658,639,19
2012-03-28,2012,March,9,Wednesday,Summer,Clear,314,298,16
2012-03-28,2012,March,10,Wednesday,Summer,Clear,173,140,33
2012-03-28,2012,March,11,Wednesday,Summer,Clear,222,168,54
2012-03-28,2012,March,12,Wednesday,Summer,Cloudy,268,218,50
2012-03-28,2012,March,13,Wednesday,Summer,Clear,273,213,60
2012-03-28,2012,March,14,Wednesday,Summer,Clear,221,169,52
2012-03-28,2012,March,15,Wednesday,Summer,Cloudy,199,152,47
2012-03-28,2012,March,16,Wednesday,Summer,Light Snow/Rain,221,170,51
2012-03-28,2012,March,17,Wednesday,Summer,Clear,604,532,72
2012-03-28,2012,March,18,Wednesday,Summer,Clear,641,580,61
2012-03-28,2012,March,19,Wednesday,Summer,Clear,456,415,41
2012-03-28,2012,March,20,Wednesday,Summer,Clear,362,324,38
2012-03-28,2012,March,21,Wednesday,Summer,Clear,261,233,28
2012-03-28,2012,March,22,Wednesday,Summer,Clear,172,151,21
2012-03-28,2012,March,23,Wednesday,Summer,Clear,93,81,12
2012-03-29,2012,March,0,Thursday,Summer,Clear,48,38,10
2012-03-29,2012,March,1,Thursday,Summer,Clear,33,18,15
2012-03-29,2012,March,2,Thursday,Summer,Clear,6,6,0
2012-03-29,2012,March,3,Thursday,Summer,Clear,5,4,1
2012-03-29,2012,March,4,Thursday,Summer,Clear,9,8,1
2012-03-29,2012,March,5,Thursday,Summer,Clear,32,30,2
2012-03-29,2012,March,6,Thursday,Summer,Clear,117,114,3
2012-03-29,2012,March,7,Thursday,Summer,Clear,367,353,14
2012-03-29,2012,March,8,Thursday,Summer,Clear,654,628,26
2012-03-29,2012,March,9,Thursday,Summer,Clear,321,299,22
2012-03-29,2012,March,10,Thursday,Summer,Clear,166,124,42
2012-03-29,2012,March,11,Thursday,Summer,Clear,220,166,54
2012-03-29,2012,March,12,Thursday,Summer,Clear,292,228,64
2012-03-29,2012,March,13,Thursday,Summer,Clear,273,223,50
2012-03-29,2012,March,14,Thursday,Summer,Clear,238,175,63
2012-03-29,2012,March,15,Thursday,Summer,Clear,307,198,109
2012-03-29,2012,March,16,Thursday,Summer,Clear,388,321,67
2012-03-29,2012,March,17,Thursday,Summer,Clear,703,620,83
2012-03-29,2012,March,18,Thursday,Summer,Clear,681,598,83
2012-03-29,2012,March,19,Thursday,Summer,Clear,468,421,47
2012-03-29,2012,March,20,Thursday,Summer,Clear,335,301,34
2012-03-29,2012,March,21,Thursday,Summer,Clear,224,214,10
2012-03-29,2012,March,22,Thursday,Summer,Clear,152,135,17
2012-03-29,2012,March,23,Thursday,Summer,Clear,94,77,17
2012-03-30,2012,March,0,Friday,Summer,Clear,59,49,10
2012-03-30,2012,March,1,Friday,Summer,Clear,27,21,6
2012-03-30,2012,March,2,Friday,Summer,Clear,7,6,1
2012-03-30,2012,March,3,Friday,Summer,Clear,7,7,0
2012-03-30,2012,March,4,Friday,Summer,Clear,2,1,1
2012-03-30,2012,March,5,Friday,Summer,Clear,26,26,0
2012-03-30,2012,March,6,Friday,Summer,Clear,86,81,5
2012-03-30,2012,March,7,Friday,Summer,Clear,289,280,9
2012-03-30,2012,March,8,Friday,Summer,Clear,593,555,38
2012-03-30,2012,March,9,Friday,Summer,Clear,321,292,29
2012-03-30,2012,March,10,Friday,Summer,Cloudy,187,137,50
2012-03-30,2012,March,11,Friday,Summer,Cloudy,201,153,48
2012-03-30,2012,March,12,Friday,Summer,Cloudy,270,208,62
2012-03-30,2012,March,13,Friday,Summer,Light Snow/Rain,242,198,44
2012-03-30,2012,March,14,Friday,Summer,Light Snow/Rain,229,173,56
2012-03-30,2012,March,15,Friday,Summer,Light Snow/Rain,280,207,73
2012-03-30,2012,March,16,Friday,Summer,Light Snow/Rain,367,292,75
2012-03-30,2012,March,17,Friday,Summer,Cloudy,606,513,93
2012-03-30,2012,March,18,Friday,Summer,Clear,560,492,68
2012-03-30,2012,March,19,Friday,Summer,Clear,395,353,42
2012-03-30,2012,March,20,Friday,Summer,Clear,209,192,17
2012-03-30,2012,March,21,Friday,Summer,Clear,220,190,30
2012-03-30,2012,March,22,Friday,Summer,Clear,153,130,23
2012-03-30,2012,March,23,Friday,Summer,Clear,123,107,16
2012-03-31,2012,March,0,Saturday,Summer,Clear,92,80,12
2012-03-31,2012,March,1,Saturday,Summer,Cloudy,82,65,17
2012-03-31,2012,March,2,Saturday,Summer,Cloudy,69,55,14
2012-03-31,2012,March,3,Saturday,Summer,Clear,31,21,10
2012-03-31,2012,March,4,Saturday,Summer,Clear,8,4,4
2012-03-31,2012,March,5,Saturday,Summer,Clear,5,5,0
2012-03-31,2012,March,6,Saturday,Summer,Cloudy,23,16,7
2012-03-31,2012,March,7,Saturday,Summer,Cloudy,44,39,5
2012-03-31,2012,March,8,Saturday,Summer,Cloudy,145,126,19
2012-03-31,2012,March,9,Saturday,Summer,Cloudy,223,161,62
2012-03-31,2012,March,10,Saturday,Summer,Cloudy,313,205,108
2012-03-31,2012,March,11,Saturday,Summer,Clear,463,279,184
2012-03-31,2012,March,12,Saturday,Summer,Clear,621,358,263
2012-03-31,2012,March,13,Saturday,Summer,Clear,638,373,265
2012-03-31,2012,March,14,Saturday,Summer,Cloudy,551,311,240
2012-03-31,2012,March,15,Saturday,Summer,Cloudy,605,330,275
2012-03-31,2012,March,16,Saturday,Summer,Cloudy,535,292,243
2012-03-31,2012,March,17,Saturday,Summer,Clear,543,305,238
2012-03-31,2012,March,18,Saturday,Summer,Cloudy,341,239,102
2012-03-31,2012,March,19,Saturday,Summer,Clear,284,191,93
2012-03-31,2012,March,20,Saturday,Summer,Cloudy,208,156,52
2012-03-31,2012,March,21,Saturday,Summer,Cloudy,143,107,36
2012-03-31,2012,March,22,Saturday,Summer,Cloudy,156,116,40
2012-03-31,2012,March,23,Saturday,Summer,Cloudy,112,100,12
2012-04-01,2012,April,0,Sunday,Summer,Cloudy,67,59,8
2012-04-01,2012,April,1,Sunday,Summer,Cloudy,62,49,13
2012-04-01,2012,April,2,Sunday,Summer,Cloudy,81,61,20
2012-04-01,2012,April,3,Sunday,Summer,Cloudy,25,21,4
2012-04-01,2012,April,4,Sunday,Summer,Cloudy,12,9,3
2012-04-01,2012,April,5,Sunday,Summer,Cloudy,18,10,8
2012-04-01,2012,April,6,Sunday,Summer,Cloudy,97,88,9
2012-04-01,2012,April,7,Sunday,Summer,Cloudy,84,55,29
2012-04-01,2012,April,8,Sunday,Summer,Cloudy,125,88,37
2012-04-01,2012,April,9,Sunday,Summer,Cloudy,275,173,102
2012-04-01,2012,April,10,Sunday,Summer,Cloudy,360,228,132
2012-04-01,2012,April,11,Sunday,Summer,Cloudy,451,271,180
2012-04-01,2012,April,12,Sunday,Summer,Cloudy,445,258,187
2012-04-01,2012,April,13,Sunday,Summer,Cloudy,464,274,190
2012-04-01,2012,April,14,Sunday,Summer,Cloudy,561,278,283
2012-04-01,2012,April,15,Sunday,Summer,Clear,573,278,295
2012-04-01,2012,April,16,Sunday,Summer,Clear,511,275,236
2012-04-01,2012,April,17,Sunday,Summer,Clear,555,323,232
2012-04-01,2012,April,18,Sunday,Summer,Clear,432,279,153
2012-04-01,2012,April,19,Sunday,Summer,Clear,346,236,110
2012-04-01,2012,April,20,Sunday,Summer,Cloudy,232,166,66
2012-04-01,2012,April,21,Sunday,Summer,Cloudy,134,101,33
2012-04-01,2012,April,22,Sunday,Summer,Light Snow/Rain,68,61,7
2012-04-01,2012,April,23,Sunday,Summer,Light Snow/Rain,63,53,10
2012-04-02,2012,April,0,Monday,Summer,Light Snow/Rain,17,11,6
2012-04-02,2012,April,1,Monday,Summer,Light Snow/Rain,5,5,0
2012-04-02,2012,April,2,Monday,Summer,Light Snow/Rain,5,3,2
2012-04-02,2012,April,4,Monday,Summer,Clear,4,2,2
2012-04-02,2012,April,5,Monday,Summer,Clear,24,22,2
2012-04-02,2012,April,6,Monday,Summer,Clear,110,104,6
2012-04-02,2012,April,7,Monday,Summer,Clear,306,294,12
2012-04-02,2012,April,8,Monday,Summer,Clear,589,553,36
2012-04-02,2012,April,9,Monday,Summer,Clear,317,265,52
2012-04-02,2012,April,10,Monday,Summer,Clear,204,119,85
2012-04-02,2012,April,11,Monday,Summer,Clear,209,128,81
2012-04-02,2012,April,12,Monday,Summer,Clear,281,181,100
2012-04-02,2012,April,13,Monday,Summer,Clear,281,184,97
2012-04-02,2012,April,14,Monday,Summer,Clear,268,141,127
2012-04-02,2012,April,15,Monday,Summer,Clear,324,192,132
2012-04-02,2012,April,16,Monday,Summer,Clear,395,291,104
2012-04-02,2012,April,17,Monday,Summer,Clear,729,601,128
2012-04-02,2012,April,18,Monday,Summer,Clear,618,543,75
2012-04-02,2012,April,19,Monday,Summer,Clear,494,428,66
2012-04-02,2012,April,20,Monday,Summer,Clear,329,281,48
2012-04-02,2012,April,21,Monday,Summer,Clear,238,214,24
2012-04-02,2012,April,22,Monday,Summer,Clear,123,106,17
2012-04-02,2012,April,23,Monday,Summer,Clear,66,60,6
2012-04-03,2012,April,0,Tuesday,Summer,Clear,33,32,1
2012-04-03,2012,April,1,Tuesday,Summer,Clear,11,11,0
2012-04-03,2012,April,2,Tuesday,Summer,Clear,5,5,0
2012-04-03,2012,April,3,Tuesday,Summer,Clear,3,3,0
2012-04-03,2012,April,4,Tuesday,Summer,Clear,1,1,0
2012-04-03,2012,April,5,Tuesday,Summer,Clear,27,25,2
2012-04-03,2012,April,6,Tuesday,Summer,Clear,100,98,2
2012-04-03,2012,April,7,Tuesday,Summer,Clear,341,327,14
2012-04-03,2012,April,8,Tuesday,Summer,Clear,604,577,27
2012-04-03,2012,April,9,Tuesday,Summer,Clear,408,354,54
2012-04-03,2012,April,10,Tuesday,Summer,Clear,219,142,77
2012-04-03,2012,April,11,Tuesday,Summer,Clear,258,167,91
2012-04-03,2012,April,12,Tuesday,Summer,Clear,331,230,101
2012-04-03,2012,April,13,Tuesday,Summer,Clear,345,225,120
2012-04-03,2012,April,14,Tuesday,Summer,Clear,311,191,120
2012-04-03,2012,April,15,Tuesday,Summer,Clear,316,207,109
2012-04-03,2012,April,16,Tuesday,Summer,Clear,485,340,145
2012-04-03,2012,April,17,Tuesday,Summer,Clear,757,634,123
2012-04-03,2012,April,18,Tuesday,Summer,Clear,800,661,139
2012-04-03,2012,April,19,Tuesday,Summer,Clear,558,460,98
2012-04-03,2012,April,20,Tuesday,Summer,Clear,379,325,54
2012-04-03,2012,April,21,Tuesday,Summer,Clear,243,210,33
2012-04-03,2012,April,22,Tuesday,Summer,Clear,158,133,25
2012-04-03,2012,April,23,Tuesday,Summer,Clear,79,66,13
2012-04-04,2012,April,0,Wednesday,Summer,Clear,41,23,18
2012-04-04,2012,April,1,Wednesday,Summer,Clear,11,11,0
2012-04-04,2012,April,2,Wednesday,Summer,Clear,5,5,0
2012-04-04,2012,April,3,Wednesday,Summer,Clear,3,3,0
2012-04-04,2012,April,4,Wednesday,Summer,Clear,1,1,0
2012-04-04,2012,April,5,Wednesday,Summer,Clear,27,27,0
2012-04-04,2012,April,6,Wednesday,Summer,Cloudy,126,120,6
2012-04-04,2012,April,7,Wednesday,Summer,Cloudy,366,354,12
2012-04-04,2012,April,8,Wednesday,Summer,Cloudy,684,653,31
2012-04-04,2012,April,9,Wednesday,Summer,Cloudy,363,316,47
2012-04-04,2012,April,10,Wednesday,Summer,Cloudy,167,99,68
2012-04-04,2012,April,11,Wednesday,Summer,Cloudy,213,152,61
2012-04-04,2012,April,12,Wednesday,Summer,Cloudy,283,210,73
2012-04-04,2012,April,13,Wednesday,Summer,Cloudy,251,181,70
2012-04-04,2012,April,14,Wednesday,Summer,Cloudy,258,176,82
2012-04-04,2012,April,15,Wednesday,Summer,Cloudy,268,182,86
2012-04-04,2012,April,16,Wednesday,Summer,Cloudy,390,304,86
2012-04-04,2012,April,17,Wednesday,Summer,Clear,744,645,99
2012-04-04,2012,April,18,Wednesday,Summer,Clear,759,646,113
2012-04-04,2012,April,19,Wednesday,Summer,Clear,494,419,75
2012-04-04,2012,April,20,Wednesday,Summer,Clear,372,333,39
2012-04-04,2012,April,21,Wednesday,Summer,Clear,298,255,43
2012-04-04,2012,April,22,Wednesday,Summer,Clear,181,151,30
2012-04-04,2012,April,23,Wednesday,Summer,Clear,131,112,19
2012-04-05,2012,April,0,Thursday,Summer,Clear,45,33,12
2012-04-05,2012,April,1,Thursday,Summer,Clear,13,9,4
2012-04-05,2012,April,2,Thursday,Summer,Clear,18,11,7
2012-04-05,2012,April,3,Thursday,Summer,Clear,5,5,0
2012-04-05,2012,April,4,Thursday,Summer,Clear,1,1,0
2012-04-05,2012,April,5,Thursday,Summer,Clear,29,28,1
2012-04-05,2012,April,6,Thursday,Summer,Clear,126,118,8
2012-04-05,2012,April,7,Thursday,Summer,Clear,354,339,15
2012-04-05,2012,April,8,Thursday,Summer,Clear,638,610,28
2012-04-05,2012,April,9,Thursday,Summer,Clear,351,290,61
2012-04-05,2012,April,10,Thursday,Summer,Clear,246,158,88
2012-04-05,2012,April,11,Thursday,Summer,Cloudy,268,159,109
2012-04-05,2012,April,12,Thursday,Summer,Clear,276,210,66
2012-04-05,2012,April,13,Thursday,Summer,Clear,291,202,89
2012-04-05,2012,April,14,Thursday,Summer,Clear,287,144,143
2012-04-05,2012,April,15,Thursday,Summer,Clear,269,171,98
2012-04-05,2012,April,16,Thursday,Summer,Clear,402,318,84
2012-04-05,2012,April,17,Thursday,Summer,Clear,822,677,145
2012-04-05,2012,April,18,Thursday,Summer,Clear,698,618,80
2012-04-05,2012,April,19,Thursday,Summer,Clear,487,423,64
2012-04-05,2012,April,20,Thursday,Summer,Clear,312,279,33
2012-04-05,2012,April,21,Thursday,Summer,Clear,234,209,25
2012-04-05,2012,April,22,Thursday,Summer,Clear,149,129,20
2012-04-05,2012,April,23,Thursday,Summer,Clear,136,124,12
2012-04-06,2012,April,0,Friday,Summer,Clear,61,49,12
2012-04-06,2012,April,1,Friday,Summer,Clear,38,28,10
2012-04-06,2012,April,2,Friday,Summer,Clear,11,5,6
2012-04-06,2012,April,3,Friday,Summer,Clear,8,5,3
2012-04-06,2012,April,4,Friday,Summer,Clear,5,3,2
2012-04-06,2012,April,5,Friday,Summer,Clear,23,23,0
2012-04-06,2012,April,6,Friday,Summer,Clear,80,80,0
2012-04-06,2012,April,7,Friday,Summer,Clear,246,231,15
2012-04-06,2012,April,8,Friday,Summer,Clear,508,489,19
2012-04-06,2012,April,9,Friday,Summer,Clear,376,318,58
2012-04-06,2012,April,10,Friday,Summer,Clear,238,157,81
2012-04-06,2012,April,11,Friday,Summer,Clear,291,179,112
2012-04-06,2012,April,12,Friday,Summer,Clear,337,224,113
2012-04-06,2012,April,13,Friday,Summer,Clear,411,238,173
2012-04-06,2012,April,14,Friday,Summer,Clear,490,250,240
2012-04-06,2012,April,15,Friday,Summer,Clear,537,319,218
2012-04-06,2012,April,16,Friday,Summer,Clear,536,352,184
2012-04-06,2012,April,17,Friday,Summer,Clear,655,483,172
2012-04-06,2012,April,18,Friday,Summer,Clear,484,380,104
2012-04-06,2012,April,19,Friday,Summer,Clear,412,297,115
2012-04-06,2012,April,20,Friday,Summer,Clear,252,191,61
2012-04-06,2012,April,21,Friday,Summer,Clear,190,136,54
2012-04-06,2012,April,22,Friday,Summer,Clear,158,124,34
2012-04-06,2012,April,23,Friday,Summer,Clear,113,92,21
2012-04-07,2012,April,0,Saturday,Summer,Clear,94,85,9
2012-04-07,2012,April,1,Saturday,Summer,Clear,69,60,9
2012-04-07,2012,April,2,Saturday,Summer,Clear,36,25,11
2012-04-07,2012,April,3,Saturday,Summer,Clear,28,21,7
2012-04-07,2012,April,4,Saturday,Summer,Clear,7,4,3
2012-04-07,2012,April,5,Saturday,Summer,Clear,2,2,0
2012-04-07,2012,April,6,Saturday,Summer,Clear,19,18,1
2012-04-07,2012,April,7,Saturday,Summer,Clear,54,40,14
2012-04-07,2012,April,8,Saturday,Summer,Clear,123,94,29
2012-04-07,2012,April,9,Saturday,Summer,Clear,276,173,103
2012-04-07,2012,April,10,Saturday,Summer,Clear,363,176,187
2012-04-07,2012,April,11,Saturday,Summer,Clear,495,244,251
2012-04-07,2012,April,12,Saturday,Summer,Clear,590,270,320
2012-04-07,2012,April,13,Saturday,Summer,Clear,643,288,355
2012-04-07,2012,April,14,Saturday,Summer,Clear,578,252,326
2012-04-07,2012,April,15,Saturday,Summer,Clear,626,305,321
2012-04-07,2012,April,16,Saturday,Summer,Clear,615,261,354
2012-04-07,2012,April,17,Saturday,Summer,Clear,567,268,299
2012-04-07,2012,April,18,Saturday,Summer,Clear,517,290,227
2012-04-07,2012,April,19,Saturday,Summer,Clear,413,243,170
2012-04-07,2012,April,20,Saturday,Summer,Clear,208,135,73
2012-04-07,2012,April,21,Saturday,Summer,Clear,234,159,75
2012-04-07,2012,April,22,Saturday,Summer,Clear,182,106,76
2012-04-07,2012,April,23,Saturday,Summer,Clear,118,86,32
2012-04-08,2012,April,0,Sunday,Summer,Clear,85,64,21
2012-04-08,2012,April,1,Sunday,Summer,Clear,64,50,14
2012-04-08,2012,April,2,Sunday,Summer,Clear,32,25,7
2012-04-08,2012,April,3,Sunday,Summer,Clear,26,18,8
2012-04-08,2012,April,4,Sunday,Summer,Clear,7,7,0
2012-04-08,2012,April,5,Sunday,Summer,Clear,12,8,4
2012-04-08,2012,April,6,Sunday,Summer,Clear,28,21,7
2012-04-08,2012,April,7,Sunday,Summer,Clear,37,25,12
2012-04-08,2012,April,8,Sunday,Summer,Clear,84,65,19
2012-04-08,2012,April,9,Sunday,Summer,Clear,179,108,71
2012-04-08,2012,April,10,Sunday,Summer,Clear,299,186,113
2012-04-08,2012,April,11,Sunday,Summer,Clear,404,209,195
2012-04-08,2012,April,12,Sunday,Summer,Clear,457,259,198
2012-04-08,2012,April,13,Sunday,Summer,Clear,483,254,229
2012-04-08,2012,April,14,Sunday,Summer,Clear,503,249,254
2012-04-08,2012,April,15,Sunday,Summer,Clear,486,226,260
2012-04-08,2012,April,16,Sunday,Summer,Clear,476,244,232
2012-04-08,2012,April,17,Sunday,Summer,Clear,411,226,185
2012-04-08,2012,April,18,Sunday,Summer,Clear,310,159,151
2012-04-08,2012,April,19,Sunday,Summer,Clear,276,187,89
2012-04-08,2012,April,20,Sunday,Summer,Clear,211,146,65
2012-04-08,2012,April,21,Sunday,Summer,Clear,130,77,53
2012-04-08,2012,April,22,Sunday,Summer,Clear,118,85,33
2012-04-08,2012,April,23,Sunday,Summer,Clear,51,41,10
2012-04-09,2012,April,0,Monday,Summer,Clear,37,29,8
2012-04-09,2012,April,1,Monday,Summer,Clear,16,12,4
2012-04-09,2012,April,2,Monday,Summer,Clear,6,4,2
2012-04-09,2012,April,3,Monday,Summer,Clear,3,3,0
2012-04-09,2012,April,4,Monday,Summer,Clear,5,3,2
2012-04-09,2012,April,5,Monday,Summer,Clear,32,30,2
2012-04-09,2012,April,6,Monday,Summer,Clear,111,108,3
2012-04-09,2012,April,7,Monday,Summer,Clear,331,320,11
2012-04-09,2012,April,8,Monday,Summer,Clear,617,595,22
2012-04-09,2012,April,9,Monday,Summer,Clear,286,236,50
2012-04-09,2012,April,10,Monday,Summer,Clear,178,113,65
2012-04-09,2012,April,11,Monday,Summer,Clear,223,127,96
2012-04-09,2012,April,12,Monday,Summer,Clear,280,186,94
2012-04-09,2012,April,13,Monday,Summer,Clear,281,173,108
2012-04-09,2012,April,14,Monday,Summer,Clear,218,152,66
2012-04-09,2012,April,15,Monday,Summer,Clear,255,173,82
2012-04-09,2012,April,16,Monday,Summer,Clear,391,310,81
2012-04-09,2012,April,17,Monday,Summer,Clear,632,565,67
2012-04-09,2012,April,18,Monday,Summer,Clear,646,586,60
2012-04-09,2012,April,19,Monday,Summer,Clear,421,386,35
2012-04-09,2012,April,20,Monday,Summer,Clear,276,255,21
2012-04-09,2012,April,21,Monday,Summer,Light Snow/Rain,165,151,14
2012-04-09,2012,April,22,Monday,Summer,Cloudy,108,102,6
2012-04-09,2012,April,23,Monday,Summer,Clear,67,61,6
2012-04-10,2012,April,0,Tuesday,Summer,Cloudy,26,23,3
2012-04-10,2012,April,1,Tuesday,Summer,Clear,9,9,0
2012-04-10,2012,April,2,Tuesday,Summer,Clear,2,2,0
2012-04-10,2012,April,3,Tuesday,Summer,Clear,2,2,0
2012-04-10,2012,April,4,Tuesday,Summer,Clear,2,2,0
2012-04-10,2012,April,5,Tuesday,Summer,Clear,24,24,0
2012-04-10,2012,April,6,Tuesday,Summer,Clear,103,100,3
2012-04-10,2012,April,7,Tuesday,Summer,Clear,384,368,16
2012-04-10,2012,April,8,Tuesday,Summer,Clear,692,670,22
2012-04-10,2012,April,9,Tuesday,Summer,Clear,319,303,16
2012-04-10,2012,April,10,Tuesday,Summer,Clear,181,132,49
2012-04-10,2012,April,11,Tuesday,Summer,Clear,239,161,78
2012-04-10,2012,April,12,Tuesday,Summer,Clear,259,184,75
2012-04-10,2012,April,13,Tuesday,Summer,Clear,283,202,81
2012-04-10,2012,April,14,Tuesday,Summer,Clear,224,149,75
2012-04-10,2012,April,15,Tuesday,Summer,Clear,203,157,46
2012-04-10,2012,April,16,Tuesday,Summer,Clear,362,296,66
2012-04-10,2012,April,17,Tuesday,Summer,Clear,744,656,88
2012-04-10,2012,April,18,Tuesday,Summer,Clear,704,626,78
2012-04-10,2012,April,19,Tuesday,Summer,Clear,479,428,51
2012-04-10,2012,April,20,Tuesday,Summer,Clear,282,248,34
2012-04-10,2012,April,21,Tuesday,Summer,Clear,206,191,15
2012-04-10,2012,April,22,Tuesday,Summer,Clear,127,118,9
2012-04-10,2012,April,23,Tuesday,Summer,Clear,62,48,14
2012-04-11,2012,April,0,Wednesday,Summer,Clear,30,22,8
2012-04-11,2012,April,1,Wednesday,Summer,Clear,12,9,3
2012-04-11,2012,April,2,Wednesday,Summer,Clear,2,2,0
2012-04-11,2012,April,3,Wednesday,Summer,Clear,2,2,0
2012-04-11,2012,April,5,Wednesday,Summer,Clear,27,26,1
2012-04-11,2012,April,6,Wednesday,Summer,Clear,106,103,3
2012-04-11,2012,April,7,Wednesday,Summer,Clear,321,303,18
2012-04-11,2012,April,8,Wednesday,Summer,Clear,595,581,14
2012-04-11,2012,April,9,Wednesday,Summer,Cloudy,302,282,20
2012-04-11,2012,April,10,Wednesday,Summer,Cloudy,153,127,26
2012-04-11,2012,April,11,Wednesday,Summer,Cloudy,180,142,38
2012-04-11,2012,April,12,Wednesday,Summer,Cloudy,182,147,35
2012-04-11,2012,April,13,Wednesday,Summer,Cloudy,163,147,16
2012-04-11,2012,April,14,Wednesday,Summer,Clear,135,101,34
2012-04-11,2012,April,15,Wednesday,Summer,Light Snow/Rain,202,152,50
2012-04-11,2012,April,16,Wednesday,Summer,Clear,307,256,51
2012-04-11,2012,April,17,Wednesday,Summer,Clear,579,527,52
2012-04-11,2012,April,18,Wednesday,Summer,Light Snow/Rain,585,546,39
2012-04-11,2012,April,19,Wednesday,Summer,Clear,384,356,28
2012-04-11,2012,April,20,Wednesday,Summer,Clear,235,213,22
2012-04-11,2012,April,21,Wednesday,Summer,Clear,165,154,11
2012-04-11,2012,April,22,Wednesday,Summer,Clear,134,130,4
2012-04-11,2012,April,23,Wednesday,Summer,Clear,61,52,9
2012-04-12,2012,April,0,Thursday,Summer,Clear,23,22,1
2012-04-12,2012,April,1,Thursday,Summer,Clear,9,7,2
2012-04-12,2012,April,2,Thursday,Summer,Clear,4,4,0
2012-04-12,2012,April,3,Thursday,Summer,Clear,5,3,2
2012-04-12,2012,April,4,Thursday,Summer,Clear,1,1,0
2012-04-12,2012,April,5,Thursday,Summer,Clear,21,21,0
2012-04-12,2012,April,6,Thursday,Summer,Clear,96,94,2
2012-04-12,2012,April,7,Thursday,Summer,Clear,306,294,12
2012-04-12,2012,April,8,Thursday,Summer,Clear,624,604,20
2012-04-12,2012,April,9,Thursday,Summer,Clear,287,271,16
2012-04-12,2012,April,10,Thursday,Summer,Clear,141,103,38
2012-04-12,2012,April,11,Thursday,Summer,Clear,224,174,50
2012-04-12,2012,April,12,Thursday,Summer,Clear,259,199,60
2012-04-12,2012,April,13,Thursday,Summer,Clear,203,148,55
2012-04-12,2012,April,14,Thursday,Summer,Clear,224,150,74
2012-04-12,2012,April,15,Thursday,Summer,Clear,211,169,42
2012-04-12,2012,April,16,Thursday,Summer,Clear,353,299,54
2012-04-12,2012,April,17,Thursday,Summer,Clear,656,596,60
2012-04-12,2012,April,18,Thursday,Summer,Clear,610,547,63
2012-04-12,2012,April,19,Thursday,Summer,Clear,433,383,50
2012-04-12,2012,April,20,Thursday,Summer,Clear,280,254,26
2012-04-12,2012,April,21,Thursday,Summer,Clear,187,174,13
2012-04-12,2012,April,22,Thursday,Summer,Clear,158,143,15
2012-04-12,2012,April,23,Thursday,Summer,Clear,94,86,8
2012-04-13,2012,April,0,Friday,Summer,Clear,55,41,14
2012-04-13,2012,April,1,Friday,Summer,Clear,30,28,2
2012-04-13,2012,April,2,Friday,Summer,Clear,11,5,6
2012-04-13,2012,April,3,Friday,Summer,Clear,11,8,3
2012-04-13,2012,April,4,Friday,Summer,Cloudy,5,4,1
2012-04-13,2012,April,5,Friday,Summer,Cloudy,21,19,2
2012-04-13,2012,April,6,Friday,Summer,Clear,84,84,0
2012-04-13,2012,April,7,Friday,Summer,Clear,296,283,13
2012-04-13,2012,April,8,Friday,Summer,Clear,563,539,24
2012-04-13,2012,April,9,Friday,Summer,Clear,330,294,36
2012-04-13,2012,April,10,Friday,Summer,Clear,192,133,59
2012-04-13,2012,April,11,Friday,Summer,Clear,233,158,75
2012-04-13,2012,April,12,Friday,Summer,Clear,322,218,104
2012-04-13,2012,April,13,Friday,Summer,Clear,358,246,112
2012-04-13,2012,April,14,Friday,Summer,Clear,348,223,125
2012-04-13,2012,April,15,Friday,Summer,Clear,352,237,115
2012-04-13,2012,April,16,Friday,Summer,Clear,463,350,113
2012-04-13,2012,April,17,Friday,Summer,Clear,738,621,117
2012-04-13,2012,April,18,Friday,Summer,Clear,671,564,107
2012-04-13,2012,April,19,Friday,Summer,Clear,427,352,75
2012-04-13,2012,April,20,Friday,Summer,Clear,286,242,44
2012-04-13,2012,April,21,Friday,Summer,Clear,189,153,36
2012-04-13,2012,April,22,Friday,Summer,Clear,215,181,34
2012-04-13,2012,April,23,Friday,Summer,Clear,198,163,35
2012-04-14,2012,April,0,Saturday,Summer,Clear,96,85,11
2012-04-14,2012,April,1,Saturday,Summer,Clear,70,60,10
2012-04-14,2012,April,2,Saturday,Summer,Clear,56,53,3
2012-04-14,2012,April,3,Saturday,Summer,Clear,32,26,6
2012-04-14,2012,April,4,Saturday,Summer,Clear,14,9,5
2012-04-14,2012,April,5,Saturday,Summer,Clear,7,5,2
2012-04-14,2012,April,6,Saturday,Summer,Clear,21,19,2
2012-04-14,2012,April,7,Saturday,Summer,Clear,64,56,8
2012-04-14,2012,April,8,Saturday,Summer,Clear,160,136,24
2012-04-14,2012,April,9,Saturday,Summer,Clear,265,206,59
2012-04-14,2012,April,10,Saturday,Summer,Clear,406,267,139
2012-04-14,2012,April,11,Saturday,Summer,Clear,564,357,207
2012-04-14,2012,April,12,Saturday,Summer,Clear,678,404,274
2012-04-14,2012,April,13,Saturday,Summer,Clear,678,370,308
2012-04-14,2012,April,14,Saturday,Summer,Cloudy,660,372,288
2012-04-14,2012,April,15,Saturday,Summer,Cloudy,658,347,311
2012-04-14,2012,April,16,Saturday,Summer,Cloudy,582,329,253
2012-04-14,2012,April,17,Saturday,Summer,Cloudy,560,309,251
2012-04-14,2012,April,18,Saturday,Summer,Cloudy,481,284,197
2012-04-14,2012,April,19,Saturday,Summer,Cloudy,459,296,163
2012-04-14,2012,April,20,Saturday,Summer,Cloudy,321,209,112
2012-04-14,2012,April,21,Saturday,Summer,Cloudy,220,167,53
2012-04-14,2012,April,22,Saturday,Summer,Cloudy,212,148,64
2012-04-14,2012,April,23,Saturday,Summer,Cloudy,196,151,45
2012-04-15,2012,April,0,Sunday,Summer,Cloudy,124,94,30
2012-04-15,2012,April,1,Sunday,Summer,Cloudy,106,89,17
2012-04-15,2012,April,2,Sunday,Summer,Cloudy,74,54,20
2012-04-15,2012,April,3,Sunday,Summer,Cloudy,45,27,18
2012-04-15,2012,April,4,Sunday,Summer,Cloudy,12,10,2
2012-04-15,2012,April,5,Sunday,Summer,Clear,10,6,4
2012-04-15,2012,April,6,Sunday,Summer,Clear,16,11,5
2012-04-15,2012,April,7,Sunday,Summer,Clear,46,30,16
2012-04-15,2012,April,8,Sunday,Summer,Clear,97,64,33
2012-04-15,2012,April,9,Sunday,Summer,Clear,251,154,97
2012-04-15,2012,April,10,Sunday,Summer,Clear,421,235,186
2012-04-15,2012,April,11,Sunday,Summer,Clear,528,301,227
2012-04-15,2012,April,12,Sunday,Summer,Clear,635,360,275
2012-04-15,2012,April,13,Sunday,Summer,Clear,681,383,298
2012-04-15,2012,April,14,Sunday,Summer,Clear,628,346,282
2012-04-15,2012,April,15,Sunday,Summer,Clear,617,351,266
2012-04-15,2012,April,16,Sunday,Summer,Clear,616,330,286
2012-04-15,2012,April,17,Sunday,Summer,Clear,623,361,262
2012-04-15,2012,April,18,Sunday,Summer,Clear,479,295,184
2012-04-15,2012,April,19,Sunday,Summer,Clear,379,265,114
2012-04-15,2012,April,20,Sunday,Summer,Clear,291,205,86
2012-04-15,2012,April,21,Sunday,Summer,Clear,229,153,76
2012-04-15,2012,April,22,Sunday,Summer,Clear,134,97,37
2012-04-15,2012,April,23,Sunday,Summer,Clear,90,65,25
2012-04-16,2012,April,0,Monday,Summer,Clear,41,26,15
2012-04-16,2012,April,1,Monday,Summer,Clear,28,21,7
2012-04-16,2012,April,2,Monday,Summer,Clear,14,9,5
2012-04-16,2012,April,3,Monday,Summer,Clear,8,5,3
2012-04-16,2012,April,4,Monday,Summer,Clear,6,6,0
2012-04-16,2012,April,5,Monday,Summer,Clear,38,34,4
2012-04-16,2012,April,6,Monday,Summer,Clear,133,123,10
2012-04-16,2012,April,7,Monday,Summer,Clear,387,367,20
2012-04-16,2012,April,8,Monday,Summer,Cloudy,597,549,48
2012-04-16,2012,April,9,Monday,Summer,Clear,297,238,59
2012-04-16,2012,April,10,Monday,Summer,Clear,224,149,75
2012-04-16,2012,April,11,Monday,Summer,Clear,251,136,115
2012-04-16,2012,April,12,Monday,Summer,Clear,271,196,75
2012-04-16,2012,April,13,Monday,Summer,Clear,263,184,79
2012-04-16,2012,April,14,Monday,Summer,Clear,288,183,105
2012-04-16,2012,April,15,Monday,Summer,Clear,275,194,81
2012-04-16,2012,April,16,Monday,Summer,Clear,358,266,92
2012-04-16,2012,April,17,Monday,Summer,Clear,712,601,111
2012-04-16,2012,April,18,Monday,Summer,Clear,676,589,87
2012-04-16,2012,April,19,Monday,Summer,Clear,522,461,61
2012-04-16,2012,April,20,Monday,Summer,Clear,375,327,48
2012-04-16,2012,April,21,Monday,Summer,Clear,271,232,39
2012-04-16,2012,April,22,Monday,Summer,Clear,214,179,35
2012-04-16,2012,April,23,Monday,Summer,Clear,121,97,24
2012-04-17,2012,April,0,Tuesday,Summer,Clear,43,33,10
2012-04-17,2012,April,1,Tuesday,Summer,Clear,11,5,6
2012-04-17,2012,April,2,Tuesday,Summer,Clear,4,3,1
2012-04-17,2012,April,3,Tuesday,Summer,Clear,6,6,0
2012-04-17,2012,April,4,Tuesday,Summer,Clear,9,6,3
2012-04-17,2012,April,5,Tuesday,Summer,Clear,30,29,1
2012-04-17,2012,April,6,Tuesday,Summer,Clear,144,136,8
2012-04-17,2012,April,7,Tuesday,Summer,Clear,461,443,18
2012-04-17,2012,April,8,Tuesday,Summer,Clear,673,631,42
2012-04-17,2012,April,9,Tuesday,Summer,Clear,400,329,71
2012-04-17,2012,April,10,Tuesday,Summer,Clear,217,165,52
2012-04-17,2012,April,11,Tuesday,Summer,Clear,239,174,65
2012-04-17,2012,April,12,Tuesday,Summer,Clear,244,179,65
2012-04-17,2012,April,13,Tuesday,Summer,Clear,239,187,52
2012-04-17,2012,April,14,Tuesday,Summer,Clear,257,198,59
2012-04-17,2012,April,15,Tuesday,Summer,Clear,308,217,91
2012-04-17,2012,April,16,Tuesday,Summer,Clear,370,320,50
2012-04-17,2012,April,17,Tuesday,Summer,Clear,781,673,108
2012-04-17,2012,April,18,Tuesday,Summer,Clear,775,670,105
2012-04-17,2012,April,19,Tuesday,Summer,Clear,537,464,73
2012-04-17,2012,April,20,Tuesday,Summer,Clear,402,358,44
2012-04-17,2012,April,21,Tuesday,Summer,Clear,297,260,37
2012-04-17,2012,April,22,Tuesday,Summer,Clear,162,144,18
2012-04-17,2012,April,23,Tuesday,Summer,Clear,82,72,10
2012-04-18,2012,April,0,Wednesday,Summer,Clear,38,35,3
2012-04-18,2012,April,1,Wednesday,Summer,Clear,14,13,1
2012-04-18,2012,April,2,Wednesday,Summer,Cloudy,9,8,1
2012-04-18,2012,April,3,Wednesday,Summer,Cloudy,6,6,0
2012-04-18,2012,April,4,Wednesday,Summer,Cloudy,7,7,0
2012-04-18,2012,April,5,Wednesday,Summer,Cloudy,34,34,0
2012-04-18,2012,April,6,Wednesday,Summer,Cloudy,134,128,6
2012-04-18,2012,April,7,Wednesday,Summer,Cloudy,418,408,10
2012-04-18,2012,April,8,Wednesday,Summer,Light Snow/Rain,576,551,25
2012-04-18,2012,April,9,Wednesday,Summer,Light Snow/Rain,265,245,20
2012-04-18,2012,April,10,Wednesday,Summer,Light Snow/Rain,147,116,31
2012-04-18,2012,April,11,Wednesday,Summer,Light Snow/Rain,119,105,14
2012-04-18,2012,April,12,Wednesday,Summer,Light Snow/Rain,110,95,15
2012-04-18,2012,April,13,Wednesday,Summer,Light Snow/Rain,64,51,13
2012-04-18,2012,April,14,Wednesday,Summer,Light Snow/Rain,51,43,8
2012-04-18,2012,April,15,Wednesday,Summer,Light Snow/Rain,98,88,10
2012-04-18,2012,April,16,Wednesday,Summer,Cloudy,235,199,36
2012-04-18,2012,April,17,Wednesday,Summer,Cloudy,488,442,46
2012-04-18,2012,April,18,Wednesday,Summer,Cloudy,505,478,27
2012-04-18,2012,April,19,Wednesday,Summer,Cloudy,368,342,26
2012-04-18,2012,April,20,Wednesday,Summer,Cloudy,260,252,8
2012-04-18,2012,April,21,Wednesday,Summer,Cloudy,189,165,24
2012-04-18,2012,April,22,Wednesday,Summer,Cloudy,162,153,9
2012-04-18,2012,April,23,Wednesday,Summer,Cloudy,70,56,14
2012-04-19,2012,April,0,Thursday,Summer,Light Snow/Rain,25,20,5
2012-04-19,2012,April,1,Thursday,Summer,Light Snow/Rain,13,11,2
2012-04-19,2012,April,2,Thursday,Summer,Cloudy,6,4,2
2012-04-19,2012,April,3,Thursday,Summer,Cloudy,4,3,1
2012-04-19,2012,April,4,Thursday,Summer,Cloudy,4,4,0
2012-04-19,2012,April,5,Thursday,Summer,Clear,30,30,0
2012-04-19,2012,April,6,Thursday,Summer,Cloudy,120,116,4
2012-04-19,2012,April,7,Thursday,Summer,Cloudy,406,391,15
2012-04-19,2012,April,8,Thursday,Summer,Cloudy,677,651,26
2012-04-19,2012,April,9,Thursday,Summer,Cloudy,301,270,31
2012-04-19,2012,April,10,Thursday,Summer,Clear,189,143,46
2012-04-19,2012,April,11,Thursday,Summer,Clear,229,183,46
2012-04-19,2012,April,12,Thursday,Summer,Clear,264,213,51
2012-04-19,2012,April,13,Thursday,Summer,Clear,238,186,52
2012-04-19,2012,April,14,Thursday,Summer,Clear,237,183,54
2012-04-19,2012,April,15,Thursday,Summer,Clear,262,196,66
2012-04-19,2012,April,16,Thursday,Summer,Clear,387,324,63
2012-04-19,2012,April,17,Thursday,Summer,Clear,748,663,85
2012-04-19,2012,April,18,Thursday,Summer,Clear,776,677,99
2012-04-19,2012,April,19,Thursday,Summer,Clear,586,516,70
2012-04-19,2012,April,20,Thursday,Summer,Clear,404,352,52
2012-04-19,2012,April,21,Thursday,Summer,Clear,267,240,27
2012-04-19,2012,April,22,Thursday,Summer,Clear,248,219,29
2012-04-19,2012,April,23,Thursday,Summer,Clear,144,124,20
2012-04-20,2012,April,0,Friday,Summer,Clear,64,59,5
2012-04-20,2012,April,1,Friday,Summer,Clear,25,22,3
2012-04-20,2012,April,2,Friday,Summer,Clear,21,18,3
2012-04-20,2012,April,3,Friday,Summer,Clear,10,9,1
2012-04-20,2012,April,4,Friday,Summer,Clear,3,3,0
2012-04-20,2012,April,5,Friday,Summer,Clear,25,24,1
2012-04-20,2012,April,6,Friday,Summer,Clear,113,105,8
2012-04-20,2012,April,7,Friday,Summer,Clear,359,350,9
2012-04-20,2012,April,8,Friday,Summer,Clear,700,668,32
2012-04-20,2012,April,9,Friday,Summer,Clear,359,329,30
2012-04-20,2012,April,10,Friday,Summer,Clear,237,170,67
2012-04-20,2012,April,11,Friday,Summer,Clear,254,190,64
2012-04-20,2012,April,12,Friday,Summer,Clear,362,260,102
2012-04-20,2012,April,13,Friday,Summer,Clear,381,276,105
2012-04-20,2012,April,14,Friday,Summer,Clear,394,238,156
2012-04-20,2012,April,15,Friday,Summer,Clear,407,262,145
2012-04-20,2012,April,16,Friday,Summer,Clear,580,429,151
2012-04-20,2012,April,17,Friday,Summer,Clear,819,697,122
2012-04-20,2012,April,18,Friday,Summer,Clear,668,558,110
2012-04-20,2012,April,19,Friday,Summer,Clear,492,410,82
2012-04-20,2012,April,20,Friday,Summer,Clear,341,289,52
2012-04-20,2012,April,21,Friday,Summer,Clear,287,252,35
2012-04-20,2012,April,22,Friday,Summer,Clear,202,176,26
2012-04-20,2012,April,23,Friday,Summer,Clear,187,156,31
2012-04-21,2012,April,0,Saturday,Summer,Clear,142,111,31
2012-04-21,2012,April,1,Saturday,Summer,Clear,88,64,24
2012-04-21,2012,April,2,Saturday,Summer,Clear,81,69,12
2012-04-21,2012,April,3,Saturday,Summer,Clear,29,25,4
2012-04-21,2012,April,4,Saturday,Summer,Clear,9,9,0
2012-04-21,2012,April,5,Saturday,Summer,Clear,1,1,0
2012-04-21,2012,April,6,Saturday,Summer,Clear,31,21,10
2012-04-21,2012,April,7,Saturday,Summer,Clear,76,55,21
2012-04-21,2012,April,8,Saturday,Summer,Clear,201,149,52
2012-04-21,2012,April,9,Saturday,Summer,Clear,331,216,115
2012-04-21,2012,April,10,Saturday,Summer,Clear,482,299,183
2012-04-21,2012,April,11,Saturday,Summer,Clear,608,348,260
2012-04-21,2012,April,12,Saturday,Summer,Clear,640,378,262
2012-04-21,2012,April,13,Saturday,Summer,Clear,649,358,291
2012-04-21,2012,April,14,Saturday,Summer,Clear,609,331,278
2012-04-21,2012,April,15,Saturday,Summer,Clear,628,361,267
2012-04-21,2012,April,16,Saturday,Summer,Clear,639,372,267
2012-04-21,2012,April,17,Saturday,Summer,Cloudy,568,309,259
2012-04-21,2012,April,18,Saturday,Summer,Cloudy,416,283,133
2012-04-21,2012,April,19,Saturday,Summer,Light Snow/Rain,54,45,9
2012-04-21,2012,April,20,Saturday,Summer,Light Snow/Rain,39,34,5
2012-04-21,2012,April,21,Saturday,Summer,Light Snow/Rain,102,82,20
2012-04-21,2012,April,22,Saturday,Summer,Clear,110,90,20
2012-04-21,2012,April,23,Saturday,Summer,Cloudy,91,73,18
2012-04-22,2012,April,0,Sunday,Summer,Cloudy,117,85,32
2012-04-22,2012,April,1,Sunday,Summer,Cloudy,73,63,10
2012-04-22,2012,April,2,Sunday,Summer,Clear,56,49,7
2012-04-22,2012,April,3,Sunday,Summer,Cloudy,40,33,7
2012-04-22,2012,April,4,Sunday,Summer,Cloudy,7,7,0
2012-04-22,2012,April,5,Sunday,Summer,Cloudy,6,6,0
2012-04-22,2012,April,6,Sunday,Summer,Cloudy,12,6,6
2012-04-22,2012,April,7,Sunday,Summer,Light Snow/Rain,24,22,2
2012-04-22,2012,April,8,Sunday,Summer,Light Snow/Rain,51,43,8
2012-04-22,2012,April,9,Sunday,Summer,Light Snow/Rain,79,71,8
2012-04-22,2012,April,10,Sunday,Summer,Light Snow/Rain,68,57,11
2012-04-22,2012,April,11,Sunday,Summer,Light Snow/Rain,77,70,7
2012-04-22,2012,April,12,Sunday,Summer,Light Snow/Rain,61,56,5
2012-04-22,2012,April,13,Sunday,Summer,Light Snow/Rain,52,47,5
2012-04-22,2012,April,14,Sunday,Summer,Light Snow/Rain,53,50,3
2012-04-22,2012,April,15,Sunday,Summer,Light Snow/Rain,38,38,0
2012-04-22,2012,April,16,Sunday,Summer,Light Snow/Rain,36,32,4
2012-04-22,2012,April,17,Sunday,Summer,Light Snow/Rain,27,25,2
2012-04-22,2012,April,18,Sunday,Summer,Light Snow/Rain,39,38,1
2012-04-22,2012,April,19,Sunday,Summer,Light Snow/Rain,35,34,1
2012-04-22,2012,April,20,Sunday,Summer,Light Snow/Rain,35,34,1
2012-04-22,2012,April,21,Sunday,Summer,Light Snow/Rain,11,11,0
2012-04-22,2012,April,22,Sunday,Summer,Light Snow/Rain,13,13,0
2012-04-22,2012,April,23,Sunday,Summer,Light Snow/Rain,17,17,0
2012-04-23,2012,April,0,Monday,Summer,Light Snow/Rain,6,6,0
2012-04-23,2012,April,1,Monday,Summer,Light Snow/Rain,2,1,1
2012-04-23,2012,April,2,Monday,Summer,Cloudy,4,3,1
2012-04-23,2012,April,3,Monday,Summer,Cloudy,1,1,0
2012-04-23,2012,April,4,Monday,Summer,Light Snow/Rain,3,3,0
2012-04-23,2012,April,5,Monday,Summer,Light Snow/Rain,14,14,0
2012-04-23,2012,April,6,Monday,Summer,Cloudy,45,43,2
2012-04-23,2012,April,7,Monday,Summer,Light Snow/Rain,207,206,1
2012-04-23,2012,April,8,Monday,Summer,Cloudy,482,471,11
2012-04-23,2012,April,9,Monday,Summer,Cloudy,272,255,17
2012-04-23,2012,April,10,Monday,Summer,Cloudy,100,88,12
2012-04-23,2012,April,11,Monday,Summer,Cloudy,101,91,10
2012-04-23,2012,April,12,Monday,Summer,Light Snow/Rain,129,117,12
2012-04-23,2012,April,13,Monday,Summer,Light Snow/Rain,107,98,9
2012-04-23,2012,April,14,Monday,Summer,Light Snow/Rain,114,102,12
2012-04-23,2012,April,15,Monday,Summer,Cloudy,112,101,11
2012-04-23,2012,April,16,Monday,Summer,Light Snow/Rain,103,93,10
2012-04-23,2012,April,17,Monday,Summer,Light Snow/Rain,232,219,13
2012-04-23,2012,April,18,Monday,Summer,Light Snow/Rain,379,369,10
2012-04-23,2012,April,19,Monday,Summer,Cloudy,298,287,11
2012-04-23,2012,April,20,Monday,Summer,Cloudy,203,186,17
2012-04-23,2012,April,21,Monday,Summer,Cloudy,152,145,7
2012-04-23,2012,April,22,Monday,Summer,Clear,89,71,18
2012-04-23,2012,April,23,Monday,Summer,Clear,59,49,10
2012-04-24,2012,April,0,Tuesday,Summer,Cloudy,13,13,0
2012-04-24,2012,April,1,Tuesday,Summer,Cloudy,7,6,1
2012-04-24,2012,April,2,Tuesday,Summer,Clear,3,3,0
2012-04-24,2012,April,3,Tuesday,Summer,Clear,2,2,0
2012-04-24,2012,April,4,Tuesday,Summer,Clear,3,3,0
2012-04-24,2012,April,5,Tuesday,Summer,Clear,22,22,0
2012-04-24,2012,April,6,Tuesday,Summer,Clear,120,117,3
2012-04-24,2012,April,7,Tuesday,Summer,Clear,390,387,3
2012-04-24,2012,April,8,Tuesday,Summer,Clear,611,599,12
2012-04-24,2012,April,9,Tuesday,Summer,Clear,308,302,6
2012-04-24,2012,April,10,Tuesday,Summer,Clear,162,129,33
2012-04-24,2012,April,11,Tuesday,Summer,Clear,184,157,27
2012-04-24,2012,April,12,Tuesday,Summer,Clear,224,188,36
2012-04-24,2012,April,13,Tuesday,Summer,Clear,224,189,35
2012-04-24,2012,April,14,Tuesday,Summer,Clear,216,166,50
2012-04-24,2012,April,15,Tuesday,Summer,Clear,236,176,60
2012-04-24,2012,April,16,Tuesday,Summer,Clear,362,308,54
2012-04-24,2012,April,17,Tuesday,Summer,Clear,691,619,72
2012-04-24,2012,April,18,Tuesday,Summer,Clear,632,580,52
2012-04-24,2012,April,19,Tuesday,Summer,Clear,482,449,33
2012-04-24,2012,April,20,Tuesday,Summer,Clear,285,269,16
2012-04-24,2012,April,21,Tuesday,Summer,Cloudy,226,213,13
2012-04-24,2012,April,22,Tuesday,Summer,Clear,157,149,8
2012-04-24,2012,April,23,Tuesday,Summer,Clear,73,69,4
2012-04-25,2012,April,0,Wednesday,Summer,Clear,36,23,13
2012-04-25,2012,April,1,Wednesday,Summer,Clear,25,17,8
2012-04-25,2012,April,2,Wednesday,Summer,Clear,7,6,1
2012-04-25,2012,April,3,Wednesday,Summer,Clear,3,3,0
2012-04-25,2012,April,4,Wednesday,Summer,Clear,6,6,0
2012-04-25,2012,April,5,Wednesday,Summer,Clear,24,24,0
2012-04-25,2012,April,6,Wednesday,Summer,Clear,106,103,3
2012-04-25,2012,April,7,Wednesday,Summer,Clear,389,376,13
2012-04-25,2012,April,8,Wednesday,Summer,Clear,654,634,20
2012-04-25,2012,April,9,Wednesday,Summer,Clear,321,288,33
2012-04-25,2012,April,10,Wednesday,Summer,Clear,182,138,44
2012-04-25,2012,April,11,Wednesday,Summer,Clear,219,177,42
2012-04-25,2012,April,12,Wednesday,Summer,Clear,269,220,49
2012-04-25,2012,April,13,Wednesday,Summer,Clear,228,193,35
2012-04-25,2012,April,14,Wednesday,Summer,Clear,223,176,47
2012-04-25,2012,April,15,Wednesday,Summer,Clear,229,182,47
2012-04-25,2012,April,16,Wednesday,Summer,Clear,376,327,49
2012-04-25,2012,April,17,Wednesday,Summer,Clear,732,664,68
2012-04-25,2012,April,18,Wednesday,Summer,Clear,709,649,60
2012-04-25,2012,April,19,Wednesday,Summer,Clear,543,501,42
2012-04-25,2012,April,20,Wednesday,Summer,Clear,380,358,22
2012-04-25,2012,April,21,Wednesday,Summer,Clear,239,212,27
2012-04-25,2012,April,22,Wednesday,Summer,Clear,192,170,22
2012-04-25,2012,April,23,Wednesday,Summer,Cloudy,104,94,10
2012-04-26,2012,April,0,Thursday,Summer,Cloudy,43,42,1
2012-04-26,2012,April,1,Thursday,Summer,Cloudy,23,22,1
2012-04-26,2012,April,2,Thursday,Summer,Cloudy,13,10,3
2012-04-26,2012,April,3,Thursday,Summer,Cloudy,6,5,1
2012-04-26,2012,April,4,Thursday,Summer,Cloudy,3,2,1
2012-04-26,2012,April,5,Thursday,Summer,Cloudy,17,17,0
2012-04-26,2012,April,6,Thursday,Summer,Cloudy,127,122,5
2012-04-26,2012,April,7,Thursday,Summer,Light Snow/Rain,225,222,3
2012-04-26,2012,April,8,Thursday,Summer,Light Snow/Rain,362,358,4
2012-04-26,2012,April,9,Thursday,Summer,Light Snow/Rain,201,189,12
2012-04-26,2012,April,10,Thursday,Summer,Cloudy,139,125,14
2012-04-26,2012,April,11,Thursday,Summer,Cloudy,151,135,16
2012-04-26,2012,April,12,Thursday,Summer,Cloudy,204,180,24
2012-04-26,2012,April,13,Thursday,Summer,Cloudy,197,178,19
2012-04-26,2012,April,14,Thursday,Summer,Cloudy,169,132,37
2012-04-26,2012,April,15,Thursday,Summer,Cloudy,204,165,39
2012-04-26,2012,April,16,Thursday,Summer,Cloudy,318,281,37
2012-04-26,2012,April,17,Thursday,Summer,Clear,614,565,49
2012-04-26,2012,April,18,Thursday,Summer,Cloudy,664,589,75
2012-04-26,2012,April,19,Thursday,Summer,Cloudy,464,407,57
2012-04-26,2012,April,20,Thursday,Summer,Clear,337,314,23
2012-04-26,2012,April,21,Thursday,Summer,Clear,250,222,28
2012-04-26,2012,April,22,Thursday,Summer,Clear,183,163,20
2012-04-26,2012,April,23,Thursday,Summer,Clear,112,106,6
2012-04-27,2012,April,0,Friday,Summer,Clear,73,61,12
2012-04-27,2012,April,1,Friday,Summer,Clear,35,32,3
2012-04-27,2012,April,2,Friday,Summer,Clear,22,18,4
2012-04-27,2012,April,3,Friday,Summer,Clear,3,2,1
2012-04-27,2012,April,4,Friday,Summer,Clear,6,6,0
2012-04-27,2012,April,5,Friday,Summer,Clear,19,19,0
2012-04-27,2012,April,6,Friday,Summer,Clear,120,115,5
2012-04-27,2012,April,7,Friday,Summer,Clear,315,305,10
2012-04-27,2012,April,8,Friday,Summer,Clear,592,575,17
2012-04-27,2012,April,9,Friday,Summer,Clear,334,292,42
2012-04-27,2012,April,10,Friday,Summer,Clear,236,172,64
2012-04-27,2012,April,11,Friday,Summer,Clear,233,186,47
2012-04-27,2012,April,12,Friday,Summer,Clear,307,244,63
2012-04-27,2012,April,13,Friday,Summer,Clear,306,212,94
2012-04-27,2012,April,14,Friday,Summer,Clear,300,206,94
2012-04-27,2012,April,15,Friday,Summer,Clear,324,223,101
2012-04-27,2012,April,16,Friday,Summer,Clear,440,335,105
2012-04-27,2012,April,17,Friday,Summer,Clear,702,613,89
2012-04-27,2012,April,18,Friday,Summer,Clear,654,560,94
2012-04-27,2012,April,19,Friday,Summer,Clear,441,379,62
2012-04-27,2012,April,20,Friday,Summer,Clear,289,240,49
2012-04-27,2012,April,21,Friday,Summer,Clear,208,185,23
2012-04-27,2012,April,22,Friday,Summer,Clear,158,134,24
2012-04-27,2012,April,23,Friday,Summer,Clear,116,105,11
2012-04-28,2012,April,0,Saturday,Summer,Clear,103,99,4
2012-04-28,2012,April,1,Saturday,Summer,Clear,67,60,7
2012-04-28,2012,April,2,Saturday,Summer,Clear,57,49,8
2012-04-28,2012,April,3,Saturday,Summer,Clear,26,23,3
2012-04-28,2012,April,4,Saturday,Summer,Clear,2,2,0
2012-04-28,2012,April,5,Saturday,Summer,Clear,5,3,2
2012-04-28,2012,April,6,Saturday,Summer,Clear,28,18,10
2012-04-28,2012,April,7,Saturday,Summer,Clear,55,45,10
2012-04-28,2012,April,8,Saturday,Summer,Clear,158,134,24
2012-04-28,2012,April,9,Saturday,Summer,Cloudy,214,169,45
2012-04-28,2012,April,10,Saturday,Summer,Cloudy,291,231,60
2012-04-28,2012,April,11,Saturday,Summer,Cloudy,358,262,96
2012-04-28,2012,April,12,Saturday,Summer,Cloudy,381,276,105
2012-04-28,2012,April,13,Saturday,Summer,Cloudy,389,269,120
2012-04-28,2012,April,14,Saturday,Summer,Clear,440,293,147
2012-04-28,2012,April,15,Saturday,Summer,Clear,408,260,148
2012-04-28,2012,April,16,Saturday,Summer,Cloudy,376,244,132
2012-04-28,2012,April,17,Saturday,Summer,Cloudy,322,224,98
2012-04-28,2012,April,18,Saturday,Summer,Light Snow/Rain,90,73,17
2012-04-28,2012,April,19,Saturday,Summer,Light Snow/Rain,139,110,29
2012-04-28,2012,April,20,Saturday,Summer,Cloudy,102,81,21
2012-04-28,2012,April,21,Saturday,Summer,Light Snow/Rain,84,72,12
2012-04-28,2012,April,22,Saturday,Summer,Cloudy,83,66,17
2012-04-28,2012,April,23,Saturday,Summer,Cloudy,42,37,5
2012-04-29,2012,April,0,Sunday,Summer,Light Snow/Rain,36,36,0
2012-04-29,2012,April,1,Sunday,Summer,Cloudy,42,37,5
2012-04-29,2012,April,2,Sunday,Summer,Cloudy,40,36,4
2012-04-29,2012,April,3,Sunday,Summer,Cloudy,16,14,2
2012-04-29,2012,April,4,Sunday,Summer,Cloudy,4,4,0
2012-04-29,2012,April,5,Sunday,Summer,Clear,6,6,0
2012-04-29,2012,April,6,Sunday,Summer,Clear,7,6,1
2012-04-29,2012,April,7,Sunday,Summer,Cloudy,27,20,7
2012-04-29,2012,April,8,Sunday,Summer,Clear,107,81,26
2012-04-29,2012,April,9,Sunday,Summer,Clear,185,133,52
2012-04-29,2012,April,10,Sunday,Summer,Clear,380,253,127
2012-04-29,2012,April,11,Sunday,Summer,Clear,411,283,128
2012-04-29,2012,April,12,Sunday,Summer,Clear,584,361,223
2012-04-29,2012,April,13,Sunday,Summer,Clear,595,369,226
2012-04-29,2012,April,14,Sunday,Summer,Clear,653,372,281
2012-04-29,2012,April,15,Sunday,Summer,Clear,603,324,279
2012-04-29,2012,April,16,Sunday,Summer,Clear,587,347,240
2012-04-29,2012,April,17,Sunday,Summer,Clear,522,334,188
2012-04-29,2012,April,18,Sunday,Summer,Clear,487,323,164
2012-04-29,2012,April,19,Sunday,Summer,Clear,375,247,128
2012-04-29,2012,April,20,Sunday,Summer,Clear,243,198,45
2012-04-29,2012,April,21,Sunday,Summer,Clear,204,139,65
2012-04-29,2012,April,22,Sunday,Summer,Clear,108,85,23
2012-04-29,2012,April,23,Sunday,Summer,Clear,82,67,15
2012-04-30,2012,April,0,Monday,Summer,Clear,48,36,12
2012-04-30,2012,April,1,Monday,Summer,Clear,24,15,9
2012-04-30,2012,April,2,Monday,Summer,Clear,8,5,3
2012-04-30,2012,April,3,Monday,Summer,Clear,4,4,0
2012-04-30,2012,April,4,Monday,Summer,Clear,2,2,0
2012-04-30,2012,April,5,Monday,Summer,Clear,20,19,1
2012-04-30,2012,April,6,Monday,Summer,Clear,123,121,2
2012-04-30,2012,April,7,Monday,Summer,Clear,349,343,6
2012-04-30,2012,April,8,Monday,Summer,Clear,596,579,17
2012-04-30,2012,April,9,Monday,Summer,Cloudy,268,239,29
2012-04-30,2012,April,10,Monday,Summer,Cloudy,157,116,41
2012-04-30,2012,April,11,Monday,Summer,Cloudy,163,111,52
2012-04-30,2012,April,12,Monday,Summer,Cloudy,225,180,45
2012-04-30,2012,April,13,Monday,Summer,Cloudy,247,199,48
2012-04-30,2012,April,14,Monday,Summer,Cloudy,218,162,56
2012-04-30,2012,April,15,Monday,Summer,Cloudy,231,176,55
2012-04-30,2012,April,16,Monday,Summer,Clear,347,303,44
2012-04-30,2012,April,17,Monday,Summer,Clear,683,617,66
2012-04-30,2012,April,18,Monday,Summer,Cloudy,664,611,53
2012-04-30,2012,April,19,Monday,Summer,Cloudy,471,420,51
2012-04-30,2012,April,20,Monday,Summer,Cloudy,309,281,28
2012-04-30,2012,April,21,Monday,Summer,Cloudy,221,195,26
2012-04-30,2012,April,22,Monday,Summer,Cloudy,134,123,11
2012-04-30,2012,April,23,Monday,Summer,Cloudy,60,50,10
2012-05-01,2012,May,0,Tuesday,Summer,Cloudy,35,28,7
2012-05-01,2012,May,1,Tuesday,Summer,Cloudy,21,21,0
2012-05-01,2012,May,2,Tuesday,Summer,Cloudy,8,7,1
2012-05-01,2012,May,3,Tuesday,Summer,Cloudy,3,2,1
2012-05-01,2012,May,4,Tuesday,Summer,Cloudy,8,7,1
2012-05-01,2012,May,5,Tuesday,Summer,Cloudy,17,17,0
2012-05-01,2012,May,6,Tuesday,Summer,Light Snow/Rain,26,24,2
2012-05-01,2012,May,7,Tuesday,Summer,Cloudy,169,161,8
2012-05-01,2012,May,8,Tuesday,Summer,Cloudy,557,538,19
2012-05-01,2012,May,9,Tuesday,Summer,Cloudy,349,331,18
2012-05-01,2012,May,10,Tuesday,Summer,Clear,174,144,30
2012-05-01,2012,May,11,Tuesday,Summer,Cloudy,229,179,50
2012-05-01,2012,May,12,Tuesday,Summer,Cloudy,269,228,41
2012-05-01,2012,May,13,Tuesday,Summer,Cloudy,249,208,41
2012-05-01,2012,May,14,Tuesday,Summer,Cloudy,204,167,37
2012-05-01,2012,May,15,Tuesday,Summer,Cloudy,234,186,48
2012-05-01,2012,May,16,Tuesday,Summer,Clear,354,313,41
2012-05-01,2012,May,17,Tuesday,Summer,Clear,681,616,65
2012-05-01,2012,May,18,Tuesday,Summer,Clear,743,662,81
2012-05-01,2012,May,19,Tuesday,Summer,Clear,487,429,58
2012-05-01,2012,May,20,Tuesday,Summer,Clear,335,299,36
2012-05-01,2012,May,21,Tuesday,Summer,Clear,282,251,31
2012-05-01,2012,May,22,Tuesday,Summer,Clear,211,190,21
2012-05-01,2012,May,23,Tuesday,Summer,Clear,95,79,16
2012-05-02,2012,May,0,Wednesday,Summer,Clear,47,43,4
2012-05-02,2012,May,1,Wednesday,Summer,Clear,15,7,8
2012-05-02,2012,May,2,Wednesday,Summer,Clear,16,9,7
2012-05-02,2012,May,3,Wednesday,Summer,Clear,6,6,0
2012-05-02,2012,May,4,Wednesday,Summer,Clear,4,2,2
2012-05-02,2012,May,5,Wednesday,Summer,Clear,33,31,2
2012-05-02,2012,May,6,Wednesday,Summer,Light Snow/Rain,120,117,3
2012-05-02,2012,May,7,Wednesday,Summer,Cloudy,358,344,14
2012-05-02,2012,May,8,Wednesday,Summer,Cloudy,666,640,26
2012-05-02,2012,May,9,Wednesday,Summer,Cloudy,315,289,26
2012-05-02,2012,May,10,Wednesday,Summer,Cloudy,175,147,28
2012-05-02,2012,May,11,Wednesday,Summer,Cloudy,184,145,39
2012-05-02,2012,May,12,Wednesday,Summer,Cloudy,245,210,35
2012-05-02,2012,May,13,Wednesday,Summer,Cloudy,228,179,49
2012-05-02,2012,May,14,Wednesday,Summer,Clear,240,189,51
2012-05-02,2012,May,15,Wednesday,Summer,Clear,256,204,52
2012-05-02,2012,May,16,Wednesday,Summer,Clear,367,313,54
2012-05-02,2012,May,17,Wednesday,Summer,Clear,729,659,70
2012-05-02,2012,May,18,Wednesday,Summer,Clear,813,770,43
2012-05-02,2012,May,19,Wednesday,Summer,Clear,504,461,43
2012-05-02,2012,May,20,Wednesday,Summer,Clear,338,296,42
2012-05-02,2012,May,21,Wednesday,Summer,Clear,239,218,21
2012-05-02,2012,May,22,Wednesday,Summer,Clear,173,146,27
2012-05-02,2012,May,23,Wednesday,Summer,Cloudy,98,77,21
2012-05-03,2012,May,0,Thursday,Summer,Cloudy,90,75,15
2012-05-03,2012,May,1,Thursday,Summer,Cloudy,24,15,9
2012-05-03,2012,May,2,Thursday,Summer,Cloudy,17,13,4
2012-05-03,2012,May,3,Thursday,Summer,Cloudy,6,4,2
2012-05-03,2012,May,4,Thursday,Summer,Cloudy,2,2,0
2012-05-03,2012,May,5,Thursday,Summer,Cloudy,21,20,1
2012-05-03,2012,May,6,Thursday,Summer,Cloudy,136,128,8
2012-05-03,2012,May,7,Thursday,Summer,Light Snow/Rain,384,376,8
2012-05-03,2012,May,8,Thursday,Summer,Light Snow/Rain,627,608,19
2012-05-03,2012,May,9,Thursday,Summer,Cloudy,304,279,25
2012-05-03,2012,May,10,Thursday,Summer,Cloudy,168,132,36
2012-05-03,2012,May,11,Thursday,Summer,Clear,201,167,34
2012-05-03,2012,May,12,Thursday,Summer,Clear,301,237,64
2012-05-03,2012,May,13,Thursday,Summer,Clear,265,217,48
2012-05-03,2012,May,14,Thursday,Summer,Clear,204,171,33
2012-05-03,2012,May,15,Thursday,Summer,Clear,283,220,63
2012-05-03,2012,May,16,Thursday,Summer,Clear,370,325,45
2012-05-03,2012,May,17,Thursday,Summer,Clear,704,617,87
2012-05-03,2012,May,18,Thursday,Summer,Clear,706,642,64
2012-05-03,2012,May,19,Thursday,Summer,Clear,522,467,55
2012-05-03,2012,May,20,Thursday,Summer,Clear,420,368,52
2012-05-03,2012,May,21,Thursday,Summer,Clear,299,257,42
2012-05-03,2012,May,22,Thursday,Summer,Clear,246,217,29
2012-05-03,2012,May,23,Thursday,Summer,Clear,121,100,21
2012-05-04,2012,May,0,Friday,Summer,Clear,89,70,19
2012-05-04,2012,May,1,Friday,Summer,Clear,48,33,15
2012-05-04,2012,May,2,Friday,Summer,Clear,11,11,0
2012-05-04,2012,May,3,Friday,Summer,Clear,14,14,0
2012-05-04,2012,May,4,Friday,Summer,Clear,4,4,0
2012-05-04,2012,May,5,Friday,Summer,Clear,24,24,0
2012-05-04,2012,May,6,Friday,Summer,Clear,135,127,8
2012-05-04,2012,May,7,Friday,Summer,Clear,356,347,9
2012-05-04,2012,May,8,Friday,Summer,Clear,618,584,34
2012-05-04,2012,May,9,Friday,Summer,Clear,294,262,32
2012-05-04,2012,May,10,Friday,Summer,Cloudy,199,154,45
2012-05-04,2012,May,11,Friday,Summer,Cloudy,258,181,77
2012-05-04,2012,May,12,Friday,Summer,Light Snow/Rain,171,125,46
2012-05-04,2012,May,13,Friday,Summer,Cloudy,278,207,71
2012-05-04,2012,May,14,Friday,Summer,Cloudy,242,159,83
2012-05-04,2012,May,15,Friday,Summer,Cloudy,343,240,103
2012-05-04,2012,May,16,Friday,Summer,Clear,440,358,82
2012-05-04,2012,May,17,Friday,Summer,Clear,643,547,96
2012-05-04,2012,May,18,Friday,Summer,Clear,641,564,77
2012-05-04,2012,May,19,Friday,Summer,Clear,452,388,64
2012-05-04,2012,May,20,Friday,Summer,Clear,313,255,58
2012-05-04,2012,May,21,Friday,Summer,Clear,235,186,49
2012-05-04,2012,May,22,Friday,Summer,Clear,232,182,50
2012-05-04,2012,May,23,Friday,Summer,Clear,256,205,51
2012-05-05,2012,May,0,Saturday,Summer,Clear,153,111,42
2012-05-05,2012,May,1,Saturday,Summer,Clear,107,79,28
2012-05-05,2012,May,2,Saturday,Summer,Clear,75,51,24
2012-05-05,2012,May,3,Saturday,Summer,Clear,32,21,11
2012-05-05,2012,May,4,Saturday,Summer,Clear,9,9,0
2012-05-05,2012,May,5,Saturday,Summer,Clear,22,14,8
2012-05-05,2012,May,6,Saturday,Summer,Cloudy,42,33,9
2012-05-05,2012,May,7,Saturday,Summer,Clear,87,79,8
2012-05-05,2012,May,8,Saturday,Summer,Clear,197,155,42
2012-05-05,2012,May,9,Saturday,Summer,Clear,284,223,61
2012-05-05,2012,May,10,Saturday,Summer,Clear,432,284,148
2012-05-05,2012,May,11,Saturday,Summer,Clear,575,354,221
2012-05-05,2012,May,12,Saturday,Summer,Clear,550,330,220
2012-05-05,2012,May,13,Saturday,Summer,Clear,524,307,217
2012-05-05,2012,May,14,Saturday,Summer,Light Snow/Rain,428,241,187
2012-05-05,2012,May,15,Saturday,Summer,Light Snow/Rain,541,300,241
2012-05-05,2012,May,16,Saturday,Summer,Cloudy,540,310,230
2012-05-05,2012,May,17,Saturday,Summer,Cloudy,502,298,204
2012-05-05,2012,May,18,Saturday,Summer,Cloudy,434,278,156
2012-05-05,2012,May,19,Saturday,Summer,Cloudy,405,254,151
2012-05-05,2012,May,20,Saturday,Summer,Clear,309,209,100
2012-05-05,2012,May,21,Saturday,Summer,Cloudy,269,183,86
2012-05-05,2012,May,22,Saturday,Summer,Cloudy,217,150,67
2012-05-05,2012,May,23,Saturday,Summer,Cloudy,149,114,35
2012-05-06,2012,May,0,Sunday,Summer,Cloudy,134,111,23
2012-05-06,2012,May,1,Sunday,Summer,Cloudy,121,84,37
2012-05-06,2012,May,2,Sunday,Summer,Cloudy,93,64,29
2012-05-06,2012,May,3,Sunday,Summer,Cloudy,28,19,9
2012-05-06,2012,May,4,Sunday,Summer,Light Snow/Rain,16,7,9
2012-05-06,2012,May,5,Sunday,Summer,Light Snow/Rain,11,10,1
2012-05-06,2012,May,6,Sunday,Summer,Light Snow/Rain,17,14,3
2012-05-06,2012,May,7,Sunday,Summer,Light Snow/Rain,36,31,5
2012-05-06,2012,May,8,Sunday,Summer,Cloudy,114,91,23
2012-05-06,2012,May,9,Sunday,Summer,Cloudy,191,128,63
2012-05-06,2012,May,10,Sunday,Summer,Cloudy,333,221,112
2012-05-06,2012,May,11,Sunday,Summer,Clear,414,270,144
2012-05-06,2012,May,12,Sunday,Summer,Cloudy,558,351,207
2012-05-06,2012,May,13,Sunday,Summer,Cloudy,565,368,197
2012-05-06,2012,May,14,Sunday,Summer,Cloudy,518,292,226
2012-05-06,2012,May,15,Sunday,Summer,Cloudy,571,342,229
2012-05-06,2012,May,16,Sunday,Summer,Cloudy,544,363,181
2012-05-06,2012,May,17,Sunday,Summer,Cloudy,511,316,195
2012-05-06,2012,May,18,Sunday,Summer,Cloudy,463,332,131
2012-05-06,2012,May,19,Sunday,Summer,Cloudy,383,266,117
2012-05-06,2012,May,20,Sunday,Summer,Clear,276,203,73
2012-05-06,2012,May,21,Sunday,Summer,Clear,203,148,55
2012-05-06,2012,May,22,Sunday,Summer,Clear,157,113,44
2012-05-06,2012,May,23,Sunday,Summer,Clear,102,80,22
2012-05-07,2012,May,0,Monday,Summer,Cloudy,34,21,13
2012-05-07,2012,May,1,Monday,Summer,Cloudy,9,8,1
2012-05-07,2012,May,2,Monday,Summer,Clear,6,5,1
2012-05-07,2012,May,3,Monday,Summer,Clear,5,3,2
2012-05-07,2012,May,4,Monday,Summer,Cloudy,2,2,0
2012-05-07,2012,May,5,Monday,Summer,Clear,23,21,2
2012-05-07,2012,May,6,Monday,Summer,Clear,142,134,8
2012-05-07,2012,May,7,Monday,Summer,Cloudy,385,367,18
2012-05-07,2012,May,8,Monday,Summer,Cloudy,639,608,31
2012-05-07,2012,May,9,Monday,Summer,Cloudy,350,289,61
2012-05-07,2012,May,10,Monday,Summer,Cloudy,190,128,62
2012-05-07,2012,May,11,Monday,Summer,Cloudy,213,149,64
2012-05-07,2012,May,12,Monday,Summer,Cloudy,263,189,74
2012-05-07,2012,May,13,Monday,Summer,Cloudy,272,197,75
2012-05-07,2012,May,14,Monday,Summer,Cloudy,239,180,59
2012-05-07,2012,May,15,Monday,Summer,Cloudy,262,186,76
2012-05-07,2012,May,16,Monday,Summer,Cloudy,388,320,68
2012-05-07,2012,May,17,Monday,Summer,Cloudy,769,667,102
2012-05-07,2012,May,18,Monday,Summer,Cloudy,680,602,78
2012-05-07,2012,May,19,Monday,Summer,Clear,546,463,83
2012-05-07,2012,May,20,Monday,Summer,Clear,323,277,46
2012-05-07,2012,May,21,Monday,Summer,Cloudy,247,210,37
2012-05-07,2012,May,22,Monday,Summer,Cloudy,173,147,26
2012-05-07,2012,May,23,Monday,Summer,Cloudy,113,92,21
2012-05-08,2012,May,0,Tuesday,Summer,Cloudy,38,28,10
2012-05-08,2012,May,1,Tuesday,Summer,Cloudy,9,3,6
2012-05-08,2012,May,2,Tuesday,Summer,Cloudy,16,7,9
2012-05-08,2012,May,3,Tuesday,Summer,Cloudy,6,4,2
2012-05-08,2012,May,4,Tuesday,Summer,Cloudy,5,5,0
2012-05-08,2012,May,5,Tuesday,Summer,Cloudy,20,20,0
2012-05-08,2012,May,6,Tuesday,Summer,Clear,165,158,7
2012-05-08,2012,May,7,Tuesday,Summer,Clear,463,442,21
2012-05-08,2012,May,8,Tuesday,Summer,Cloudy,641,605,36
2012-05-08,2012,May,9,Tuesday,Summer,Cloudy,295,258,37
2012-05-08,2012,May,10,Tuesday,Summer,Cloudy,157,111,46
2012-05-08,2012,May,11,Tuesday,Summer,Cloudy,217,157,60
2012-05-08,2012,May,12,Tuesday,Summer,Cloudy,263,203,60
2012-05-08,2012,May,13,Tuesday,Summer,Light Snow/Rain,219,166,53
2012-05-08,2012,May,14,Tuesday,Summer,Light Snow/Rain,71,63,8
2012-05-08,2012,May,15,Tuesday,Summer,Light Snow/Rain,134,94,40
2012-05-08,2012,May,16,Tuesday,Summer,Light Snow/Rain,389,335,54
2012-05-08,2012,May,17,Tuesday,Summer,Cloudy,717,640,77
2012-05-08,2012,May,18,Tuesday,Summer,Cloudy,710,641,69
2012-05-08,2012,May,19,Tuesday,Summer,Cloudy,458,399,59
2012-05-08,2012,May,20,Tuesday,Summer,Cloudy,302,262,40
2012-05-08,2012,May,21,Tuesday,Summer,Cloudy,223,202,21
2012-05-08,2012,May,22,Tuesday,Summer,Light Snow/Rain,147,134,13
2012-05-08,2012,May,23,Tuesday,Summer,Light Snow/Rain,63,53,10
2012-05-09,2012,May,0,Wednesday,Summer,Cloudy,35,27,8
2012-05-09,2012,May,1,Wednesday,Summer,Cloudy,14,11,3
2012-05-09,2012,May,2,Wednesday,Summer,Light Snow/Rain,1,1,0
2012-05-09,2012,May,3,Wednesday,Summer,Light Snow/Rain,2,2,0
2012-05-09,2012,May,4,Wednesday,Summer,Light Snow/Rain,5,5,0
2012-05-09,2012,May,5,Wednesday,Summer,Cloudy,28,27,1
2012-05-09,2012,May,6,Wednesday,Summer,Cloudy,126,121,5
2012-05-09,2012,May,7,Wednesday,Summer,Cloudy,418,401,17
2012-05-09,2012,May,8,Wednesday,Summer,Cloudy,622,594,28
2012-05-09,2012,May,9,Wednesday,Summer,Cloudy,325,285,40
2012-05-09,2012,May,10,Wednesday,Summer,Cloudy,153,113,40
2012-05-09,2012,May,11,Wednesday,Summer,Cloudy,201,156,45
2012-05-09,2012,May,12,Wednesday,Summer,Cloudy,280,222,58
2012-05-09,2012,May,13,Wednesday,Summer,Cloudy,266,216,50
2012-05-09,2012,May,14,Wednesday,Summer,Cloudy,243,175,68
2012-05-09,2012,May,15,Wednesday,Summer,Cloudy,259,191,68
2012-05-09,2012,May,16,Wednesday,Summer,Cloudy,357,289,68
2012-05-09,2012,May,17,Wednesday,Summer,Cloudy,705,629,76
2012-05-09,2012,May,18,Wednesday,Summer,Light Snow/Rain,372,349,23
2012-05-09,2012,May,19,Wednesday,Summer,Light Snow/Rain,98,96,2
2012-05-09,2012,May,20,Wednesday,Summer,Light Snow/Rain,51,48,3
2012-05-09,2012,May,21,Wednesday,Summer,Light Snow/Rain,34,30,4
2012-05-09,2012,May,22,Wednesday,Summer,Light Snow/Rain,67,62,5
2012-05-09,2012,May,23,Wednesday,Summer,Light Snow/Rain,55,47,8
2012-05-10,2012,May,0,Thursday,Summer,Light Snow/Rain,33,31,2
2012-05-10,2012,May,1,Thursday,Summer,Cloudy,11,9,2
2012-05-10,2012,May,2,Thursday,Summer,Cloudy,3,3,0
2012-05-10,2012,May,3,Thursday,Summer,Clear,3,3,0
2012-05-10,2012,May,4,Thursday,Summer,Clear,2,2,0
2012-05-10,2012,May,5,Thursday,Summer,Clear,24,23,1
2012-05-10,2012,May,6,Thursday,Summer,Clear,139,130,9
2012-05-10,2012,May,7,Thursday,Summer,Clear,401,393,8
2012-05-10,2012,May,8,Thursday,Summer,Clear,630,603,27
2012-05-10,2012,May,9,Thursday,Summer,Clear,361,299,62
2012-05-10,2012,May,10,Thursday,Summer,Clear,154,112,42
2012-05-10,2012,May,11,Thursday,Summer,Clear,256,179,77
2012-05-10,2012,May,12,Thursday,Summer,Clear,272,207,65
2012-05-10,2012,May,13,Thursday,Summer,Clear,318,228,90
2012-05-10,2012,May,14,Thursday,Summer,Clear,247,186,61
2012-05-10,2012,May,15,Thursday,Summer,Clear,271,192,79
2012-05-10,2012,May,16,Thursday,Summer,Clear,421,334,87
2012-05-10,2012,May,17,Thursday,Summer,Clear,732,648,84
2012-05-10,2012,May,18,Thursday,Summer,Clear,770,661,109
2012-05-10,2012,May,19,Thursday,Summer,Clear,553,469,84
2012-05-10,2012,May,20,Thursday,Summer,Clear,374,315,59
2012-05-10,2012,May,21,Thursday,Summer,Clear,230,211,19
2012-05-10,2012,May,22,Thursday,Summer,Clear,232,196,36
2012-05-10,2012,May,23,Thursday,Summer,Clear,135,112,23
2012-05-11,2012,May,0,Friday,Summer,Clear,64,47,17
2012-05-11,2012,May,1,Friday,Summer,Clear,46,32,14
2012-05-11,2012,May,2,Friday,Summer,Clear,31,16,15
2012-05-11,2012,May,3,Friday,Summer,Clear,13,8,5
2012-05-11,2012,May,4,Friday,Summer,Clear,9,6,3
2012-05-11,2012,May,5,Friday,Summer,Clear,26,23,3
2012-05-11,2012,May,6,Friday,Summer,Clear,135,128,7
2012-05-11,2012,May,7,Friday,Summer,Clear,351,345,6
2012-05-11,2012,May,8,Friday,Summer,Clear,620,579,41
2012-05-11,2012,May,9,Friday,Summer,Clear,322,288,34
2012-05-11,2012,May,10,Friday,Summer,Clear,210,141,69
2012-05-11,2012,May,11,Friday,Summer,Clear,291,203,88
2012-05-11,2012,May,12,Friday,Summer,Clear,348,259,89
2012-05-11,2012,May,13,Friday,Summer,Clear,363,263,100
2012-05-11,2012,May,14,Friday,Summer,Clear,334,218,116
2012-05-11,2012,May,15,Friday,Summer,Clear,439,299,140
2012-05-11,2012,May,16,Friday,Summer,Clear,525,397,128
2012-05-11,2012,May,17,Friday,Summer,Clear,779,677,102
2012-05-11,2012,May,18,Friday,Summer,Clear,596,518,78
2012-05-11,2012,May,19,Friday,Summer,Clear,503,430,73
2012-05-11,2012,May,20,Friday,Summer,Clear,341,277,64
2012-05-11,2012,May,21,Friday,Summer,Clear,270,225,45
2012-05-11,2012,May,22,Friday,Summer,Clear,234,190,44
2012-05-11,2012,May,23,Friday,Summer,Clear,180,142,38
2012-05-12,2012,May,0,Saturday,Summer,Clear,136,111,25
2012-05-12,2012,May,1,Saturday,Summer,Clear,93,79,14
2012-05-12,2012,May,2,Saturday,Summer,Clear,56,46,10
2012-05-12,2012,May,3,Saturday,Summer,Clear,34,20,14
2012-05-12,2012,May,4,Saturday,Summer,Clear,9,6,3
2012-05-12,2012,May,5,Saturday,Summer,Clear,13,8,5
2012-05-12,2012,May,6,Saturday,Summer,Clear,33,23,10
2012-05-12,2012,May,7,Saturday,Summer,Clear,67,57,10
2012-05-12,2012,May,8,Saturday,Summer,Clear,178,156,22
2012-05-12,2012,May,9,Saturday,Summer,Clear,335,248,87
2012-05-12,2012,May,10,Saturday,Summer,Clear,411,279,132
2012-05-12,2012,May,11,Saturday,Summer,Clear,522,365,157
2012-05-12,2012,May,12,Saturday,Summer,Clear,559,353,206
2012-05-12,2012,May,13,Saturday,Summer,Clear,659,366,293
2012-05-12,2012,May,14,Saturday,Summer,Clear,615,358,257
2012-05-12,2012,May,15,Saturday,Summer,Clear,590,321,269
2012-05-12,2012,May,16,Saturday,Summer,Cloudy,591,337,254
2012-05-12,2012,May,17,Saturday,Summer,Cloudy,576,343,233
2012-05-12,2012,May,18,Saturday,Summer,Cloudy,546,382,164
2012-05-12,2012,May,19,Saturday,Summer,Cloudy,439,273,166
2012-05-12,2012,May,20,Saturday,Summer,Clear,287,174,113
2012-05-12,2012,May,21,Saturday,Summer,Cloudy,230,156,74
2012-05-12,2012,May,22,Saturday,Summer,Clear,274,212,62
2012-05-12,2012,May,23,Saturday,Summer,Clear,176,134,42
2012-05-13,2012,May,0,Sunday,Summer,Clear,98,79,19
2012-05-13,2012,May,1,Sunday,Summer,Cloudy,94,72,22
2012-05-13,2012,May,2,Sunday,Summer,Cloudy,82,60,22
2012-05-13,2012,May,3,Sunday,Summer,Cloudy,28,26,2
2012-05-13,2012,May,4,Sunday,Summer,Cloudy,9,7,2
2012-05-13,2012,May,5,Sunday,Summer,Clear,12,8,4
2012-05-13,2012,May,6,Sunday,Summer,Clear,21,15,6
2012-05-13,2012,May,7,Sunday,Summer,Clear,60,42,18
2012-05-13,2012,May,8,Sunday,Summer,Clear,156,124,32
2012-05-13,2012,May,9,Sunday,Summer,Clear,222,143,79
2012-05-13,2012,May,10,Sunday,Summer,Clear,350,222,128
2012-05-13,2012,May,11,Sunday,Summer,Clear,428,278,150
2012-05-13,2012,May,12,Sunday,Summer,Clear,531,342,189
2012-05-13,2012,May,13,Sunday,Summer,Clear,602,347,255
2012-05-13,2012,May,14,Sunday,Summer,Clear,552,324,228
2012-05-13,2012,May,15,Sunday,Summer,Clear,499,309,190
2012-05-13,2012,May,16,Sunday,Summer,Clear,564,339,225
2012-05-13,2012,May,17,Sunday,Summer,Clear,478,287,191
2012-05-13,2012,May,18,Sunday,Summer,Cloudy,389,260,129
2012-05-13,2012,May,19,Sunday,Summer,Cloudy,339,232,107
2012-05-13,2012,May,20,Sunday,Summer,Cloudy,230,163,67
2012-05-13,2012,May,21,Sunday,Summer,Cloudy,169,121,48
2012-05-13,2012,May,22,Sunday,Summer,Cloudy,131,89,42
2012-05-13,2012,May,23,Sunday,Summer,Cloudy,74,57,17
2012-05-14,2012,May,0,Monday,Summer,Cloudy,35,14,21
2012-05-14,2012,May,1,Monday,Summer,Cloudy,11,6,5
2012-05-14,2012,May,2,Monday,Summer,Clear,2,1,1
2012-05-14,2012,May,3,Monday,Summer,Cloudy,2,2,0
2012-05-14,2012,May,4,Monday,Summer,Cloudy,6,3,3
2012-05-14,2012,May,5,Monday,Summer,Cloudy,26,25,1
2012-05-14,2012,May,6,Monday,Summer,Light Snow/Rain,65,62,3
2012-05-14,2012,May,7,Monday,Summer,Light Snow/Rain,75,72,3
2012-05-14,2012,May,8,Monday,Summer,Light Snow/Rain,156,155,1
2012-05-14,2012,May,9,Monday,Summer,Light Snow/Rain,110,105,5
2012-05-14,2012,May,10,Monday,Summer,Light Snow/Rain,59,53,6
2012-05-14,2012,May,11,Monday,Summer,Cloudy,79,67,12
2012-05-14,2012,May,12,Monday,Summer,Cloudy,185,132,53
2012-05-14,2012,May,13,Monday,Summer,Cloudy,176,143,33
2012-05-14,2012,May,14,Monday,Summer,Cloudy,171,128,43
2012-05-14,2012,May,15,Monday,Summer,Cloudy,196,156,40
2012-05-14,2012,May,16,Monday,Summer,Light Snow/Rain,111,91,20
2012-05-14,2012,May,17,Monday,Summer,Light Snow/Rain,229,204,25
2012-05-14,2012,May,18,Monday,Summer,Cloudy,300,283,17
2012-05-14,2012,May,19,Monday,Summer,Light Snow/Rain,304,294,10
2012-05-14,2012,May,20,Monday,Summer,Cloudy,189,178,11
2012-05-14,2012,May,21,Monday,Summer,Cloudy,152,145,7
2012-05-14,2012,May,22,Monday,Summer,Cloudy,129,118,11
2012-05-14,2012,May,23,Monday,Summer,Cloudy,75,64,11
2012-05-15,2012,May,0,Tuesday,Summer,Cloudy,32,25,7
2012-05-15,2012,May,1,Tuesday,Summer,Light Snow/Rain,19,14,5
2012-05-15,2012,May,2,Tuesday,Summer,Cloudy,4,3,1
2012-05-15,2012,May,3,Tuesday,Summer,Light Snow/Rain,6,5,1
2012-05-15,2012,May,4,Tuesday,Summer,Light Snow/Rain,5,4,1
2012-05-15,2012,May,5,Tuesday,Summer,Light Snow/Rain,8,8,0
2012-05-15,2012,May,6,Tuesday,Summer,Light Snow/Rain,24,22,2
2012-05-15,2012,May,7,Tuesday,Summer,Light Snow/Rain,92,91,1
2012-05-15,2012,May,8,Tuesday,Summer,Cloudy,409,401,8
2012-05-15,2012,May,9,Tuesday,Summer,Cloudy,355,327,28
2012-05-15,2012,May,10,Tuesday,Summer,Clear,171,144,27
2012-05-15,2012,May,11,Tuesday,Summer,Clear,224,186,38
2012-05-15,2012,May,12,Tuesday,Summer,Clear,264,220,44
2012-05-15,2012,May,13,Tuesday,Summer,Light Snow/Rain,239,204,35
2012-05-15,2012,May,14,Tuesday,Summer,Cloudy,184,145,39
2012-05-15,2012,May,15,Tuesday,Summer,Cloudy,256,205,51
2012-05-15,2012,May,16,Tuesday,Summer,Clear,374,300,74
2012-05-15,2012,May,17,Tuesday,Summer,Clear,678,603,75
2012-05-15,2012,May,18,Tuesday,Summer,Clear,733,665,68
2012-05-15,2012,May,19,Tuesday,Summer,Clear,512,455,57
2012-05-15,2012,May,20,Tuesday,Summer,Light Snow/Rain,263,233,30
2012-05-15,2012,May,21,Tuesday,Summer,Light Snow/Rain,109,98,11
2012-05-15,2012,May,22,Tuesday,Summer,Clear,83,74,9
2012-05-15,2012,May,23,Tuesday,Summer,Light Snow/Rain,71,58,13
2012-05-16,2012,May,0,Wednesday,Summer,Cloudy,39,27,12
2012-05-16,2012,May,1,Wednesday,Summer,Cloudy,21,14,7
2012-05-16,2012,May,2,Wednesday,Summer,Clear,19,14,5
2012-05-16,2012,May,3,Wednesday,Summer,Clear,6,5,1
2012-05-16,2012,May,4,Wednesday,Summer,Clear,4,3,1
2012-05-16,2012,May,5,Wednesday,Summer,Clear,38,34,4
2012-05-16,2012,May,6,Wednesday,Summer,Clear,158,150,8
2012-05-16,2012,May,7,Wednesday,Summer,Clear,440,426,14
2012-05-16,2012,May,8,Wednesday,Summer,Clear,650,617,33
2012-05-16,2012,May,9,Wednesday,Summer,Cloudy,347,314,33
2012-05-16,2012,May,10,Wednesday,Summer,Clear,192,149,43
2012-05-16,2012,May,11,Wednesday,Summer,Clear,267,212,55
2012-05-16,2012,May,12,Wednesday,Summer,Clear,330,271,59
2012-05-16,2012,May,13,Wednesday,Summer,Clear,350,273,77
2012-05-16,2012,May,14,Wednesday,Summer,Clear,263,221,42
2012-05-16,2012,May,15,Wednesday,Summer,Cloudy,274,222,52
2012-05-16,2012,May,16,Wednesday,Summer,Clear,446,376,70
2012-05-16,2012,May,17,Wednesday,Summer,Clear,873,769,104
2012-05-16,2012,May,18,Wednesday,Summer,Clear,846,749,97
2012-05-16,2012,May,19,Wednesday,Summer,Clear,590,499,91
2012-05-16,2012,May,20,Wednesday,Summer,Clear,459,398,61
2012-05-16,2012,May,21,Wednesday,Summer,Clear,393,330,63
2012-05-16,2012,May,22,Wednesday,Summer,Clear,286,253,33
2012-05-16,2012,May,23,Wednesday,Summer,Clear,133,107,26
2012-05-17,2012,May,0,Thursday,Summer,Clear,79,49,30
2012-05-17,2012,May,1,Thursday,Summer,Clear,28,16,12
2012-05-17,2012,May,2,Thursday,Summer,Clear,16,8,8
2012-05-17,2012,May,3,Thursday,Summer,Clear,3,3,0
2012-05-17,2012,May,4,Thursday,Summer,Clear,16,13,3
2012-05-17,2012,May,5,Thursday,Summer,Clear,35,34,1
2012-05-17,2012,May,6,Thursday,Summer,Clear,159,149,10
2012-05-17,2012,May,7,Thursday,Summer,Clear,474,449,25
2012-05-17,2012,May,8,Thursday,Summer,Clear,634,605,29
2012-05-17,2012,May,9,Thursday,Summer,Clear,346,289,57
2012-05-17,2012,May,10,Thursday,Summer,Clear,205,162,43
2012-05-17,2012,May,11,Thursday,Summer,Clear,279,202,77
2012-05-17,2012,May,12,Thursday,Summer,Clear,348,276,72
2012-05-17,2012,May,13,Thursday,Summer,Clear,327,241,86
2012-05-17,2012,May,14,Thursday,Summer,Clear,270,202,68
2012-05-17,2012,May,15,Thursday,Summer,Clear,316,233,83
2012-05-17,2012,May,16,Thursday,Summer,Clear,430,344,86
2012-05-17,2012,May,17,Thursday,Summer,Clear,852,719,133
2012-05-17,2012,May,18,Thursday,Summer,Clear,868,734,134
2012-05-17,2012,May,19,Thursday,Summer,Clear,537,451,86
2012-05-17,2012,May,20,Thursday,Summer,Clear,446,363,83
2012-05-17,2012,May,21,Thursday,Summer,Clear,299,254,45
2012-05-17,2012,May,22,Thursday,Summer,Clear,251,209,42
2012-05-17,2012,May,23,Thursday,Summer,Clear,166,137,29
2012-05-18,2012,May,0,Friday,Summer,Clear,70,57,13
2012-05-18,2012,May,1,Friday,Summer,Clear,49,33,16
2012-05-18,2012,May,2,Friday,Summer,Clear,21,9,12
2012-05-18,2012,May,3,Friday,Summer,Clear,14,8,6
2012-05-18,2012,May,4,Friday,Summer,Clear,11,11,0
2012-05-18,2012,May,5,Friday,Summer,Clear,34,33,1
2012-05-18,2012,May,6,Friday,Summer,Clear,182,168,14
2012-05-18,2012,May,7,Friday,Summer,Clear,515,475,40
2012-05-18,2012,May,8,Friday,Summer,Clear,745,696,49
2012-05-18,2012,May,9,Friday,Summer,Clear,361,304,57
2012-05-18,2012,May,10,Friday,Summer,Clear,255,181,74
2012-05-18,2012,May,11,Friday,Summer,Clear,334,225,109
2012-05-18,2012,May,12,Friday,Summer,Clear,360,252,108
2012-05-18,2012,May,13,Friday,Summer,Clear,395,297,98
2012-05-18,2012,May,14,Friday,Summer,Clear,350,242,108
2012-05-18,2012,May,15,Friday,Summer,Clear,391,260,131
2012-05-18,2012,May,16,Friday,Summer,Clear,568,417,151
2012-05-18,2012,May,17,Friday,Summer,Clear,812,688,124
2012-05-18,2012,May,18,Friday,Summer,Clear,669,570,99
2012-05-18,2012,May,19,Friday,Summer,Clear,483,392,91
2012-05-18,2012,May,20,Friday,Summer,Clear,337,264,73
2012-05-18,2012,May,21,Friday,Summer,Clear,258,209,49
2012-05-18,2012,May,22,Friday,Summer,Clear,251,194,57
2012-05-18,2012,May,23,Friday,Summer,Clear,174,133,41
2012-05-19,2012,May,0,Saturday,Summer,Clear,148,118,30
2012-05-19,2012,May,1,Saturday,Summer,Clear,104,84,20
2012-05-19,2012,May,2,Saturday,Summer,Clear,69,56,13
2012-05-19,2012,May,3,Saturday,Summer,Clear,33,23,10
2012-05-19,2012,May,4,Saturday,Summer,Clear,14,8,6
2012-05-19,2012,May,5,Saturday,Summer,Clear,12,11,1
2012-05-19,2012,May,6,Saturday,Summer,Clear,50,38,12
2012-05-19,2012,May,7,Saturday,Summer,Clear,95,67,28
2012-05-19,2012,May,8,Saturday,Summer,Clear,195,162,33
2012-05-19,2012,May,9,Saturday,Summer,Clear,292,213,79
2012-05-19,2012,May,10,Saturday,Summer,Clear,452,275,177
2012-05-19,2012,May,11,Saturday,Summer,Clear,586,351,235
2012-05-19,2012,May,12,Saturday,Summer,Clear,642,366,276
2012-05-19,2012,May,13,Saturday,Summer,Clear,704,372,332
2012-05-19,2012,May,14,Saturday,Summer,Clear,730,369,361
2012-05-19,2012,May,15,Saturday,Summer,Clear,672,316,356
2012-05-19,2012,May,16,Saturday,Summer,Clear,642,311,331
2012-05-19,2012,May,17,Saturday,Summer,Clear,626,347,279
2012-05-19,2012,May,18,Saturday,Summer,Clear,645,391,254
2012-05-19,2012,May,19,Saturday,Summer,Clear,432,229,203
2012-05-19,2012,May,20,Saturday,Summer,Clear,315,197,118
2012-05-19,2012,May,21,Saturday,Summer,Clear,259,178,81
2012-05-19,2012,May,22,Saturday,Summer,Clear,338,234,104
2012-05-19,2012,May,23,Saturday,Summer,Clear,239,168,71
2012-05-20,2012,May,0,Sunday,Summer,Clear,170,128,42
2012-05-20,2012,May,1,Sunday,Summer,Clear,130,102,28
2012-05-20,2012,May,2,Sunday,Summer,Clear,98,62,36
2012-05-20,2012,May,3,Sunday,Summer,Clear,66,40,26
2012-05-20,2012,May,4,Sunday,Summer,Clear,16,14,2
2012-05-20,2012,May,5,Sunday,Summer,Clear,8,7,1
2012-05-20,2012,May,6,Sunday,Summer,Clear,25,21,4
2012-05-20,2012,May,7,Sunday,Summer,Clear,90,55,35
2012-05-20,2012,May,8,Sunday,Summer,Clear,171,120,51
2012-05-20,2012,May,9,Sunday,Summer,Clear,313,184,129
2012-05-20,2012,May,10,Sunday,Summer,Clear,432,258,174
2012-05-20,2012,May,11,Sunday,Summer,Clear,581,323,258
2012-05-20,2012,May,12,Sunday,Summer,Clear,637,390,247
2012-05-20,2012,May,13,Sunday,Summer,Clear,607,363,244
2012-05-20,2012,May,14,Sunday,Summer,Clear,543,307,236
2012-05-20,2012,May,15,Sunday,Summer,Cloudy,502,256,246
2012-05-20,2012,May,16,Sunday,Summer,Clear,577,339,238
2012-05-20,2012,May,17,Sunday,Summer,Clear,549,340,209
2012-05-20,2012,May,18,Sunday,Summer,Clear,474,328,146
2012-05-20,2012,May,19,Sunday,Summer,Clear,402,260,142
2012-05-20,2012,May,20,Sunday,Summer,Clear,274,191,83
2012-05-20,2012,May,21,Sunday,Summer,Clear,233,182,51
2012-05-20,2012,May,22,Sunday,Summer,Clear,145,101,44
2012-05-20,2012,May,23,Sunday,Summer,Light Snow/Rain,86,54,32
2012-05-21,2012,May,0,Monday,Summer,Light Snow/Rain,40,28,12
2012-05-21,2012,May,1,Monday,Summer,Light Snow/Rain,15,11,4
2012-05-21,2012,May,2,Monday,Summer,Light Snow/Rain,11,9,2
2012-05-21,2012,May,3,Monday,Summer,Cloudy,2,2,0
2012-05-21,2012,May,4,Monday,Summer,Light Snow/Rain,7,5,2
2012-05-21,2012,May,5,Monday,Summer,Light Snow/Rain,15,14,1
2012-05-21,2012,May,6,Monday,Summer,Light Snow/Rain,79,76,3
2012-05-21,2012,May,7,Monday,Summer,Light Snow/Rain,153,146,7
2012-05-21,2012,May,8,Monday,Summer,Light Snow/Rain,270,258,12
2012-05-21,2012,May,9,Monday,Summer,Light Snow/Rain,186,172,14
2012-05-21,2012,May,10,Monday,Summer,Light Snow/Rain,99,71,28
2012-05-21,2012,May,11,Monday,Summer,Cloudy,106,82,24
2012-05-21,2012,May,12,Monday,Summer,Cloudy,170,124,46
2012-05-21,2012,May,13,Monday,Summer,Light Snow/Rain,184,135,49
2012-05-21,2012,May,14,Monday,Summer,Light Snow/Rain,180,135,45
2012-05-21,2012,May,15,Monday,Summer,Cloudy,225,158,67
2012-05-21,2012,May,16,Monday,Summer,Cloudy,315,269,46
2012-05-21,2012,May,17,Monday,Summer,Cloudy,508,468,40
2012-05-21,2012,May,18,Monday,Summer,Clear,530,478,52
2012-05-21,2012,May,19,Monday,Summer,Clear,448,391,57
2012-05-21,2012,May,20,Monday,Summer,Clear,336,292,44
2012-05-21,2012,May,21,Monday,Summer,Clear,241,210,31
2012-05-21,2012,May,22,Monday,Summer,Cloudy,142,116,26
2012-05-21,2012,May,23,Monday,Summer,Clear,97,79,18
2012-05-22,2012,May,0,Tuesday,Summer,Clear,36,26,10
2012-05-22,2012,May,1,Tuesday,Summer,Cloudy,27,16,11
2012-05-22,2012,May,2,Tuesday,Summer,Cloudy,11,10,1
2012-05-22,2012,May,3,Tuesday,Summer,Cloudy,5,5,0
2012-05-22,2012,May,4,Tuesday,Summer,Cloudy,7,7,0
2012-05-22,2012,May,5,Tuesday,Summer,Light Snow/Rain,17,17,0
2012-05-22,2012,May,6,Tuesday,Summer,Light Snow/Rain,137,129,8
2012-05-22,2012,May,7,Tuesday,Summer,Light Snow/Rain,324,315,9
2012-05-22,2012,May,8,Tuesday,Summer,Cloudy,590,570,20
2012-05-22,2012,May,9,Tuesday,Summer,Cloudy,333,287,46
2012-05-22,2012,May,10,Tuesday,Summer,Cloudy,200,148,52
2012-05-22,2012,May,11,Tuesday,Summer,Cloudy,189,150,39
2012-05-22,2012,May,12,Tuesday,Summer,Cloudy,254,178,76
2012-05-22,2012,May,13,Tuesday,Summer,Cloudy,243,195,48
2012-05-22,2012,May,14,Tuesday,Summer,Cloudy,222,149,73
2012-05-22,2012,May,15,Tuesday,Summer,Clear,245,191,54
2012-05-22,2012,May,16,Tuesday,Summer,Clear,386,316,70
2012-05-22,2012,May,17,Tuesday,Summer,Clear,785,716,69
2012-05-22,2012,May,18,Tuesday,Summer,Clear,785,709,76
2012-05-22,2012,May,19,Tuesday,Summer,Clear,364,320,44
2012-05-22,2012,May,20,Tuesday,Summer,Clear,373,319,54
2012-05-22,2012,May,21,Tuesday,Summer,Clear,261,233,28
2012-05-22,2012,May,22,Tuesday,Summer,Clear,174,157,17
2012-05-22,2012,May,23,Tuesday,Summer,Clear,105,91,14
2012-05-23,2012,May,0,Wednesday,Summer,Clear,47,28,19
2012-05-23,2012,May,1,Wednesday,Summer,Clear,32,9,23
2012-05-23,2012,May,2,Wednesday,Summer,Cloudy,12,10,2
2012-05-23,2012,May,3,Wednesday,Summer,Clear,5,5,0
2012-05-23,2012,May,4,Wednesday,Summer,Light Snow/Rain,3,3,0
2012-05-23,2012,May,5,Wednesday,Summer,Light Snow/Rain,35,29,6
2012-05-23,2012,May,6,Wednesday,Summer,Clear,160,154,6
2012-05-23,2012,May,7,Wednesday,Summer,Clear,468,452,16
2012-05-23,2012,May,8,Wednesday,Summer,Clear,719,681,38
2012-05-23,2012,May,9,Wednesday,Summer,Cloudy,297,258,39
2012-05-23,2012,May,10,Wednesday,Summer,Clear,191,139,52
2012-05-23,2012,May,11,Wednesday,Summer,Clear,197,151,46
2012-05-23,2012,May,12,Wednesday,Summer,Cloudy,248,206,42
2012-05-23,2012,May,13,Wednesday,Summer,Cloudy,270,201,69
2012-05-23,2012,May,14,Wednesday,Summer,Clear,248,181,67
2012-05-23,2012,May,15,Wednesday,Summer,Cloudy,257,192,65
2012-05-23,2012,May,16,Wednesday,Summer,Light Snow/Rain,278,216,62
2012-05-23,2012,May,17,Wednesday,Summer,Light Snow/Rain,285,240,45
2012-05-23,2012,May,18,Wednesday,Summer,Light Snow/Rain,327,296,31
2012-05-23,2012,May,19,Wednesday,Summer,Cloudy,376,336,40
2012-05-23,2012,May,20,Wednesday,Summer,Cloudy,295,267,28
2012-05-23,2012,May,21,Wednesday,Summer,Cloudy,245,221,24
2012-05-23,2012,May,22,Wednesday,Summer,Cloudy,159,136,23
2012-05-23,2012,May,23,Wednesday,Summer,Clear,106,83,23
2012-05-24,2012,May,0,Thursday,Summer,Clear,56,49,7
2012-05-24,2012,May,1,Thursday,Summer,Clear,30,21,9
2012-05-24,2012,May,2,Thursday,Summer,Clear,16,15,1
2012-05-24,2012,May,3,Thursday,Summer,Cloudy,4,3,1
2012-05-24,2012,May,4,Thursday,Summer,Cloudy,5,5,0
2012-05-24,2012,May,5,Thursday,Summer,Cloudy,30,29,1
2012-05-24,2012,May,6,Thursday,Summer,Cloudy,156,146,10
2012-05-24,2012,May,7,Thursday,Summer,Clear,415,393,22
2012-05-24,2012,May,8,Thursday,Summer,Clear,692,659,33
2012-05-24,2012,May,9,Thursday,Summer,Clear,301,267,34
2012-05-24,2012,May,10,Thursday,Summer,Clear,185,138,47
2012-05-24,2012,May,11,Thursday,Summer,Clear,221,160,61
2012-05-24,2012,May,12,Thursday,Summer,Clear,289,213,76
2012-05-24,2012,May,13,Thursday,Summer,Clear,302,233,69
2012-05-24,2012,May,14,Thursday,Summer,Clear,252,180,72
2012-05-24,2012,May,15,Thursday,Summer,Clear,291,222,69
2012-05-24,2012,May,16,Thursday,Summer,Clear,390,329,61
2012-05-24,2012,May,17,Thursday,Summer,Clear,798,678,120
2012-05-24,2012,May,18,Thursday,Summer,Clear,752,634,118
2012-05-24,2012,May,19,Thursday,Summer,Clear,492,416,76
2012-05-24,2012,May,20,Thursday,Summer,Cloudy,398,343,55
2012-05-24,2012,May,21,Thursday,Summer,Light Snow/Rain,285,237,48
2012-05-24,2012,May,22,Thursday,Summer,Cloudy,243,210,33
2012-05-24,2012,May,23,Thursday,Summer,Cloudy,167,131,36
2012-05-25,2012,May,0,Friday,Summer,Clear,73,63,10
2012-05-25,2012,May,1,Friday,Summer,Clear,42,34,8
2012-05-25,2012,May,2,Friday,Summer,Cloudy,23,16,7
2012-05-25,2012,May,3,Friday,Summer,Cloudy,14,6,8
2012-05-25,2012,May,4,Friday,Summer,Cloudy,9,6,3
2012-05-25,2012,May,5,Friday,Summer,Cloudy,30,28,2
2012-05-25,2012,May,6,Friday,Summer,Cloudy,113,108,5
2012-05-25,2012,May,7,Friday,Summer,Cloudy,359,352,7
2012-05-25,2012,May,8,Friday,Summer,Cloudy,583,551,32
2012-05-25,2012,May,9,Friday,Summer,Cloudy,340,288,52
2012-05-25,2012,May,10,Friday,Summer,Clear,232,163,69
2012-05-25,2012,May,11,Friday,Summer,Clear,283,193,90
2012-05-25,2012,May,12,Friday,Summer,Clear,321,237,84
2012-05-25,2012,May,13,Friday,Summer,Clear,333,247,86
2012-05-25,2012,May,14,Friday,Summer,Clear,367,263,104
2012-05-25,2012,May,15,Friday,Summer,Clear,466,360,106
2012-05-25,2012,May,16,Friday,Summer,Clear,584,447,137
2012-05-25,2012,May,17,Friday,Summer,Clear,653,529,124
2012-05-25,2012,May,18,Friday,Summer,Clear,522,391,131
2012-05-25,2012,May,19,Friday,Summer,Clear,404,293,111
2012-05-25,2012,May,20,Friday,Summer,Clear,350,270,80
2012-05-25,2012,May,21,Friday,Summer,Clear,255,193,62
2012-05-25,2012,May,22,Friday,Summer,Clear,212,147,65
2012-05-25,2012,May,23,Friday,Summer,Clear,166,132,34
2012-05-26,2012,May,0,Saturday,Summer,Clear,116,98,18
2012-05-26,2012,May,1,Saturday,Summer,Clear,82,64,18
2012-05-26,2012,May,2,Saturday,Summer,Clear,64,55,9
2012-05-26,2012,May,3,Saturday,Summer,Clear,31,22,9
2012-05-26,2012,May,4,Saturday,Summer,Clear,2,2,0
2012-05-26,2012,May,5,Saturday,Summer,Clear,10,10,0
2012-05-26,2012,May,6,Saturday,Summer,Clear,31,25,6
2012-05-26,2012,May,7,Saturday,Summer,Cloudy,54,44,10
2012-05-26,2012,May,8,Saturday,Summer,Clear,141,103,38
2012-05-26,2012,May,9,Saturday,Summer,Clear,289,192,97
2012-05-26,2012,May,10,Saturday,Summer,Clear,437,256,181
2012-05-26,2012,May,11,Saturday,Summer,Clear,520,312,208
2012-05-26,2012,May,12,Saturday,Summer,Clear,529,293,236
2012-05-26,2012,May,13,Saturday,Summer,Clear,539,274,265
2012-05-26,2012,May,14,Saturday,Summer,Clear,564,257,307
2012-05-26,2012,May,15,Saturday,Summer,Clear,513,239,274
2012-05-26,2012,May,16,Saturday,Summer,Clear,504,243,261
2012-05-26,2012,May,17,Saturday,Summer,Cloudy,462,227,235
2012-05-26,2012,May,18,Saturday,Summer,Cloudy,415,216,199
2012-05-26,2012,May,19,Saturday,Summer,Cloudy,373,214,159
2012-05-26,2012,May,20,Saturday,Summer,Cloudy,255,152,103
2012-05-26,2012,May,21,Saturday,Summer,Cloudy,251,151,100
2012-05-26,2012,May,22,Saturday,Summer,Clear,204,118,86
2012-05-26,2012,May,23,Saturday,Summer,Clear,150,114,36
2012-05-27,2012,May,0,Sunday,Summer,Cloudy,137,89,48
2012-05-27,2012,May,1,Sunday,Summer,Clear,78,61,17
2012-05-27,2012,May,2,Sunday,Summer,Clear,61,45,16
2012-05-27,2012,May,3,Sunday,Summer,Clear,36,25,11
2012-05-27,2012,May,4,Sunday,Summer,Clear,11,7,4
2012-05-27,2012,May,5,Sunday,Summer,Clear,7,5,2
2012-05-27,2012,May,6,Sunday,Summer,Clear,22,14,8
2012-05-27,2012,May,7,Sunday,Summer,Clear,52,30,22
2012-05-27,2012,May,8,Sunday,Summer,Clear,151,82,69
2012-05-27,2012,May,9,Sunday,Summer,Clear,270,140,130
2012-05-27,2012,May,10,Sunday,Summer,Clear,424,215,209
2012-05-27,2012,May,11,Sunday,Summer,Clear,519,251,268
2012-05-27,2012,May,12,Sunday,Summer,Clear,570,269,301
2012-05-27,2012,May,13,Sunday,Summer,Clear,498,228,270
2012-05-27,2012,May,14,Sunday,Summer,Clear,547,230,317
2012-05-27,2012,May,15,Sunday,Summer,Clear,535,245,290
2012-05-27,2012,May,16,Sunday,Summer,Clear,501,243,258
2012-05-27,2012,May,17,Sunday,Summer,Clear,522,247,275
2012-05-27,2012,May,18,Sunday,Summer,Clear,518,252,266
2012-05-27,2012,May,19,Sunday,Summer,Clear,442,212,230
2012-05-27,2012,May,20,Sunday,Summer,Clear,392,224,168
2012-05-27,2012,May,21,Sunday,Summer,Light Snow/Rain,143,79,64
2012-05-27,2012,May,22,Sunday,Summer,Light Snow/Rain,59,50,9
2012-05-27,2012,May,23,Sunday,Summer,Light Snow/Rain,96,65,31
2012-05-28,2012,May,0,Monday,Summer,Clear,65,44,21
2012-05-28,2012,May,1,Monday,Summer,Cloudy,59,45,14
2012-05-28,2012,May,2,Monday,Summer,Clear,48,28,20
2012-05-28,2012,May,3,Monday,Summer,Clear,18,12,6
2012-05-28,2012,May,4,Monday,Summer,Clear,6,4,2
2012-05-28,2012,May,5,Monday,Summer,Clear,9,5,4
2012-05-28,2012,May,6,Monday,Summer,Clear,20,14,6
2012-05-28,2012,May,7,Monday,Summer,Clear,67,43,24
2012-05-28,2012,May,8,Monday,Summer,Clear,155,93,62
2012-05-28,2012,May,9,Monday,Summer,Clear,263,142,121
2012-05-28,2012,May,10,Monday,Summer,Clear,364,175,189
2012-05-28,2012,May,11,Monday,Summer,Clear,476,222,254
2012-05-28,2012,May,12,Monday,Summer,Clear,525,292,233
2012-05-28,2012,May,13,Monday,Summer,Clear,556,284,272
2012-05-28,2012,May,14,Monday,Summer,Clear,465,227,238
2012-05-28,2012,May,15,Monday,Summer,Clear,460,279,181
2012-05-28,2012,May,16,Monday,Summer,Clear,501,278,223
2012-05-28,2012,May,17,Monday,Summer,Clear,405,247,158
2012-05-28,2012,May,18,Monday,Summer,Clear,383,251,132
2012-05-28,2012,May,19,Monday,Summer,Clear,395,247,148
2012-05-28,2012,May,20,Monday,Summer,Clear,317,203,114
2012-05-28,2012,May,21,Monday,Summer,Clear,247,181,66
2012-05-28,2012,May,22,Monday,Summer,Clear,157,110,47
2012-05-28,2012,May,23,Monday,Summer,Clear,82,60,22
2012-05-29,2012,May,0,Tuesday,Summer,Clear,45,33,12
2012-05-29,2012,May,1,Tuesday,Summer,Clear,14,13,1
2012-05-29,2012,May,2,Tuesday,Summer,Clear,8,8,0
2012-05-29,2012,May,3,Tuesday,Summer,Clear,3,2,1
2012-05-29,2012,May,4,Tuesday,Summer,Clear,5,5,0
2012-05-29,2012,May,5,Tuesday,Summer,Clear,33,32,1
2012-05-29,2012,May,6,Tuesday,Summer,Clear,154,145,9
2012-05-29,2012,May,7,Tuesday,Summer,Clear,450,431,19
2012-05-29,2012,May,8,Tuesday,Summer,Clear,634,588,46
2012-05-29,2012,May,9,Tuesday,Summer,Clear,257,231,26
2012-05-29,2012,May,10,Tuesday,Summer,Clear,183,116,67
2012-05-29,2012,May,11,Tuesday,Summer,Clear,197,147,50
2012-05-29,2012,May,12,Tuesday,Summer,Clear,237,181,56
2012-05-29,2012,May,13,Tuesday,Summer,Clear,239,176,63
2012-05-29,2012,May,14,Tuesday,Summer,Clear,238,158,80
2012-05-29,2012,May,15,Tuesday,Summer,Clear,256,185,71
2012-05-29,2012,May,16,Tuesday,Summer,Clear,393,320,73
2012-05-29,2012,May,17,Tuesday,Summer,Clear,781,674,107
2012-05-29,2012,May,18,Tuesday,Summer,Clear,710,632,78
2012-05-29,2012,May,19,Tuesday,Summer,Clear,526,457,69
2012-05-29,2012,May,20,Tuesday,Summer,Light Snow/Rain,204,168,36
2012-05-29,2012,May,21,Tuesday,Summer,Light Snow/Rain,71,68,3
2012-05-29,2012,May,22,Tuesday,Summer,Cloudy,55,53,2
2012-05-29,2012,May,23,Tuesday,Summer,Light Snow/Rain,50,40,10
2012-05-30,2012,May,0,Wednesday,Summer,Light Snow/Rain,36,32,4
2012-05-30,2012,May,1,Wednesday,Summer,Light Snow/Rain,4,4,0
2012-05-30,2012,May,2,Wednesday,Summer,Light Snow/Rain,5,4,1
2012-05-30,2012,May,3,Wednesday,Summer,Light Snow/Rain,5,5,0
2012-05-30,2012,May,4,Wednesday,Summer,Cloudy,6,6,0
2012-05-30,2012,May,5,Wednesday,Summer,Cloudy,41,40,1
2012-05-30,2012,May,6,Wednesday,Summer,Cloudy,144,139,5
2012-05-30,2012,May,7,Wednesday,Summer,Light Snow/Rain,483,469,14
2012-05-30,2012,May,8,Wednesday,Summer,Cloudy,671,642,29
2012-05-30,2012,May,9,Wednesday,Summer,Cloudy,305,282,23
2012-05-30,2012,May,10,Wednesday,Summer,Cloudy,177,138,39
2012-05-30,2012,May,11,Wednesday,Summer,Cloudy,208,155,53
2012-05-30,2012,May,12,Wednesday,Summer,Clear,253,220,33
2012-05-30,2012,May,13,Wednesday,Summer,Clear,289,236,53
2012-05-30,2012,May,14,Wednesday,Summer,Clear,252,208,44
2012-05-30,2012,May,15,Wednesday,Summer,Clear,275,221,54
2012-05-30,2012,May,16,Wednesday,Summer,Clear,398,352,46
2012-05-30,2012,May,17,Wednesday,Summer,Clear,839,756,83
2012-05-30,2012,May,18,Wednesday,Summer,Clear,796,746,50
2012-05-30,2012,May,19,Wednesday,Summer,Clear,556,506,50
2012-05-30,2012,May,20,Wednesday,Summer,Cloudy,431,374,57
2012-05-30,2012,May,21,Wednesday,Summer,Clear,304,263,41
2012-05-30,2012,May,22,Wednesday,Summer,Clear,217,191,26
2012-05-30,2012,May,23,Wednesday,Summer,Clear,160,121,39
2012-05-31,2012,May,0,Thursday,Summer,Clear,61,48,13
2012-05-31,2012,May,1,Thursday,Summer,Clear,26,22,4
2012-05-31,2012,May,2,Thursday,Summer,Clear,14,8,6
2012-05-31,2012,May,3,Thursday,Summer,Clear,8,8,0
2012-05-31,2012,May,4,Thursday,Summer,Clear,8,8,0
2012-05-31,2012,May,5,Thursday,Summer,Clear,33,32,1
2012-05-31,2012,May,6,Thursday,Summer,Clear,178,171,7
2012-05-31,2012,May,7,Thursday,Summer,Clear,507,489,18
2012-05-31,2012,May,8,Thursday,Summer,Clear,693,675,18
2012-05-31,2012,May,9,Thursday,Summer,Clear,311,264,47
2012-05-31,2012,May,10,Thursday,Summer,Clear,220,155,65
2012-05-31,2012,May,11,Thursday,Summer,Clear,218,153,65
2012-05-31,2012,May,12,Thursday,Summer,Clear,292,230,62
2012-05-31,2012,May,13,Thursday,Summer,Clear,293,216,77
2012-05-31,2012,May,14,Thursday,Summer,Clear,254,193,61
2012-05-31,2012,May,15,Thursday,Summer,Clear,290,209,81
2012-05-31,2012,May,16,Thursday,Summer,Clear,487,384,103
2012-05-31,2012,May,17,Thursday,Summer,Clear,827,742,85
2012-05-31,2012,May,18,Thursday,Summer,Clear,785,700,85
2012-05-31,2012,May,19,Thursday,Summer,Clear,591,487,104
2012-05-31,2012,May,20,Thursday,Summer,Clear,479,391,88
2012-05-31,2012,May,21,Thursday,Summer,Clear,359,318,41
2012-05-31,2012,May,22,Thursday,Summer,Clear,264,221,43
2012-05-31,2012,May,23,Thursday,Summer,Clear,140,114,26
2012-06-01,2012,June,0,Friday,Summer,Clear,86,76,10
2012-06-01,2012,June,1,Friday,Summer,Clear,34,34,0
2012-06-01,2012,June,2,Friday,Summer,Clear,16,13,3
2012-06-01,2012,June,3,Friday,Summer,Cloudy,4,4,0
2012-06-01,2012,June,4,Friday,Summer,Cloudy,6,5,1
2012-06-01,2012,June,5,Friday,Summer,Cloudy,45,41,4
2012-06-01,2012,June,6,Friday,Summer,Light Snow/Rain,141,136,5
2012-06-01,2012,June,7,Friday,Summer,Cloudy,402,369,33
2012-06-01,2012,June,8,Friday,Summer,Cloudy,694,675,19
2012-06-01,2012,June,9,Friday,Summer,Cloudy,298,274,24
2012-06-01,2012,June,10,Friday,Summer,Cloudy,204,155,49
2012-06-01,2012,June,11,Friday,Summer,Cloudy,235,193,42
2012-06-01,2012,June,12,Friday,Summer,Cloudy,310,238,72
2012-06-01,2012,June,13,Friday,Summer,Clear,316,240,76
2012-06-01,2012,June,14,Friday,Summer,Light Snow/Rain,254,199,55
2012-06-01,2012,June,15,Friday,Summer,Light Snow/Rain,258,213,45
2012-06-01,2012,June,16,Friday,Summer,Light Snow/Rain,222,186,36
2012-06-01,2012,June,17,Friday,Summer,Light Snow/Rain,227,202,25
2012-06-01,2012,June,18,Friday,Summer,Light Snow/Rain,110,100,10
2012-06-01,2012,June,19,Friday,Summer,Light Snow/Rain,45,41,4
2012-06-01,2012,June,20,Friday,Summer,Light Snow/Rain,39,38,1
2012-06-01,2012,June,21,Friday,Summer,Light Snow/Rain,85,73,12
2012-06-01,2012,June,22,Friday,Summer,Light Snow/Rain,23,22,1
2012-06-01,2012,June,23,Friday,Summer,Light Snow/Rain,73,67,6
2012-06-02,2012,June,0,Saturday,Summer,Cloudy,86,81,5
2012-06-02,2012,June,1,Saturday,Summer,Cloudy,76,61,15
2012-06-02,2012,June,2,Saturday,Summer,Cloudy,41,38,3
2012-06-02,2012,June,3,Saturday,Summer,Clear,26,18,8
2012-06-02,2012,June,4,Saturday,Summer,Clear,13,11,2
2012-06-02,2012,June,5,Saturday,Summer,Clear,12,11,1
2012-06-02,2012,June,6,Saturday,Summer,Cloudy,36,31,5
2012-06-02,2012,June,7,Saturday,Summer,Clear,86,77,9
2012-06-02,2012,June,8,Saturday,Summer,Clear,210,180,30
2012-06-02,2012,June,9,Saturday,Summer,Clear,332,243,89
2012-06-02,2012,June,10,Saturday,Summer,Clear,493,348,145
2012-06-02,2012,June,11,Saturday,Summer,Clear,536,357,179
2012-06-02,2012,June,12,Saturday,Summer,Clear,668,418,250
2012-06-02,2012,June,13,Saturday,Summer,Clear,679,400,279
2012-06-02,2012,June,14,Saturday,Summer,Clear,647,388,259
2012-06-02,2012,June,15,Saturday,Summer,Clear,702,405,297
2012-06-02,2012,June,16,Saturday,Summer,Clear,644,369,275
2012-06-02,2012,June,17,Saturday,Summer,Clear,586,338,248
2012-06-02,2012,June,18,Saturday,Summer,Clear,512,341,171
2012-06-02,2012,June,19,Saturday,Summer,Clear,554,369,185
2012-06-02,2012,June,20,Saturday,Summer,Clear,399,260,139
2012-06-02,2012,June,21,Saturday,Summer,Clear,316,220,96
2012-06-02,2012,June,22,Saturday,Summer,Clear,228,176,52
2012-06-02,2012,June,23,Saturday,Summer,Clear,238,185,53
2012-06-03,2012,June,0,Sunday,Summer,Clear,169,142,27
2012-06-03,2012,June,1,Sunday,Summer,Clear,121,100,21
2012-06-03,2012,June,2,Sunday,Summer,Clear,89,67,22
2012-06-03,2012,June,3,Sunday,Summer,Clear,50,34,16
2012-06-03,2012,June,4,Sunday,Summer,Clear,13,12,1
2012-06-03,2012,June,5,Sunday,Summer,Clear,12,11,1
2012-06-03,2012,June,6,Sunday,Summer,Clear,22,16,6
2012-06-03,2012,June,7,Sunday,Summer,Clear,35,29,6
2012-06-03,2012,June,8,Sunday,Summer,Clear,140,110,30
2012-06-03,2012,June,9,Sunday,Summer,Clear,300,230,70
2012-06-03,2012,June,10,Sunday,Summer,Clear,404,277,127
2012-06-03,2012,June,11,Sunday,Summer,Clear,511,312,199
2012-06-03,2012,June,12,Sunday,Summer,Clear,684,408,276
2012-06-03,2012,June,13,Sunday,Summer,Clear,686,421,265
2012-06-03,2012,June,14,Sunday,Summer,Clear,678,411,267
2012-06-03,2012,June,15,Sunday,Summer,Clear,644,408,236
2012-06-03,2012,June,16,Sunday,Summer,Clear,662,436,226
2012-06-03,2012,June,17,Sunday,Summer,Clear,578,386,192
2012-06-03,2012,June,18,Sunday,Summer,Clear,496,343,153
2012-06-03,2012,June,19,Sunday,Summer,Clear,453,337,116
2012-06-03,2012,June,20,Sunday,Summer,Clear,314,230,84
2012-06-03,2012,June,21,Sunday,Summer,Clear,246,180,66
2012-06-03,2012,June,22,Sunday,Summer,Clear,226,165,61
2012-06-03,2012,June,23,Sunday,Summer,Clear,108,82,26
2012-06-04,2012,June,0,Monday,Summer,Clear,49,38,11
2012-06-04,2012,June,1,Monday,Summer,Light Snow/Rain,14,10,4
2012-06-04,2012,June,2,Monday,Summer,Clear,11,10,1
2012-06-04,2012,June,3,Monday,Summer,Cloudy,5,5,0
2012-06-04,2012,June,4,Monday,Summer,Clear,8,6,2
2012-06-04,2012,June,5,Monday,Summer,Clear,35,33,2
2012-06-04,2012,June,6,Monday,Summer,Clear,139,135,4
2012-06-04,2012,June,7,Monday,Summer,Clear,517,504,13
2012-06-04,2012,June,8,Monday,Summer,Clear,665,643,22
2012-06-04,2012,June,9,Monday,Summer,Clear,282,244,38
2012-06-04,2012,June,10,Monday,Summer,Clear,187,120,67
2012-06-04,2012,June,11,Monday,Summer,Clear,239,168,71
2012-06-04,2012,June,12,Monday,Summer,Clear,282,220,62
2012-06-04,2012,June,13,Monday,Summer,Clear,274,189,85
2012-06-04,2012,June,14,Monday,Summer,Clear,270,186,84
2012-06-04,2012,June,15,Monday,Summer,Clear,292,215,77
2012-06-04,2012,June,16,Monday,Summer,Clear,448,375,73
2012-06-04,2012,June,17,Monday,Summer,Clear,834,733,101
2012-06-04,2012,June,18,Monday,Summer,Clear,822,719,103
2012-06-04,2012,June,19,Monday,Summer,Clear,645,554,91
2012-06-04,2012,June,20,Monday,Summer,Clear,461,390,71
2012-06-04,2012,June,21,Monday,Summer,Clear,265,225,40
2012-06-04,2012,June,22,Monday,Summer,Clear,168,127,41
2012-06-04,2012,June,23,Monday,Summer,Clear,86,78,8
2012-06-05,2012,June,0,Tuesday,Summer,Clear,34,28,6
2012-06-05,2012,June,1,Tuesday,Summer,Cloudy,20,18,2
2012-06-05,2012,June,2,Tuesday,Summer,Light Snow/Rain,8,8,0
2012-06-05,2012,June,3,Tuesday,Summer,Light Snow/Rain,5,5,0
2012-06-05,2012,June,4,Tuesday,Summer,Light Snow/Rain,5,4,1
2012-06-05,2012,June,5,Tuesday,Summer,Light Snow/Rain,36,35,1
2012-06-05,2012,June,6,Tuesday,Summer,Clear,184,177,7
2012-06-05,2012,June,7,Tuesday,Summer,Clear,569,540,29
2012-06-05,2012,June,8,Tuesday,Summer,Cloudy,710,680,30
2012-06-05,2012,June,9,Tuesday,Summer,Cloudy,335,285,50
2012-06-05,2012,June,10,Tuesday,Summer,Cloudy,176,118,58
2012-06-05,2012,June,11,Tuesday,Summer,Cloudy,227,162,65
2012-06-05,2012,June,12,Tuesday,Summer,Cloudy,247,202,45
2012-06-05,2012,June,13,Tuesday,Summer,Cloudy,267,201,66
2012-06-05,2012,June,14,Tuesday,Summer,Cloudy,276,194,82
2012-06-05,2012,June,15,Tuesday,Summer,Cloudy,272,218,54
2012-06-05,2012,June,16,Tuesday,Summer,Clear,473,382,91
2012-06-05,2012,June,17,Tuesday,Summer,Clear,850,764,86
2012-06-05,2012,June,18,Tuesday,Summer,Clear,790,679,111
2012-06-05,2012,June,19,Tuesday,Summer,Clear,513,445,68
2012-06-05,2012,June,20,Tuesday,Summer,Clear,415,371,44
2012-06-05,2012,June,21,Tuesday,Summer,Clear,283,253,30
2012-06-05,2012,June,22,Tuesday,Summer,Clear,193,171,22
2012-06-05,2012,June,23,Tuesday,Summer,Clear,113,93,20
2012-06-06,2012,June,0,Wednesday,Summer,Clear,49,46,3
2012-06-06,2012,June,1,Wednesday,Summer,Clear,27,21,6
2012-06-06,2012,June,2,Wednesday,Summer,Clear,11,7,4
2012-06-06,2012,June,3,Wednesday,Summer,Clear,8,8,0
2012-06-06,2012,June,4,Wednesday,Summer,Clear,10,7,3
2012-06-06,2012,June,5,Wednesday,Summer,Clear,38,37,1
2012-06-06,2012,June,6,Wednesday,Summer,Clear,172,165,7
2012-06-06,2012,June,7,Wednesday,Summer,Clear,547,531,16
2012-06-06,2012,June,8,Wednesday,Summer,Clear,668,637,31
2012-06-06,2012,June,9,Wednesday,Summer,Clear,303,268,35
2012-06-06,2012,June,10,Wednesday,Summer,Clear,203,148,55
2012-06-06,2012,June,11,Wednesday,Summer,Clear,226,161,65
2012-06-06,2012,June,12,Wednesday,Summer,Clear,315,235,80
2012-06-06,2012,June,13,Wednesday,Summer,Clear,303,230,73
2012-06-06,2012,June,14,Wednesday,Summer,Clear,302,191,111
2012-06-06,2012,June,15,Wednesday,Summer,Clear,300,225,75
2012-06-06,2012,June,16,Wednesday,Summer,Clear,452,345,107
2012-06-06,2012,June,17,Wednesday,Summer,Clear,724,652,72
2012-06-06,2012,June,18,Wednesday,Summer,Light Snow/Rain,782,688,94
2012-06-06,2012,June,19,Wednesday,Summer,Clear,538,486,52
2012-06-06,2012,June,20,Wednesday,Summer,Clear,408,349,59
2012-06-06,2012,June,21,Wednesday,Summer,Clear,298,260,38
2012-06-06,2012,June,22,Wednesday,Summer,Clear,248,221,27
2012-06-06,2012,June,23,Wednesday,Summer,Clear,123,110,13
2012-06-07,2012,June,0,Thursday,Summer,Clear,59,50,9
2012-06-07,2012,June,1,Thursday,Summer,Clear,22,17,5
2012-06-07,2012,June,2,Thursday,Summer,Clear,12,12,0
2012-06-07,2012,June,3,Thursday,Summer,Clear,5,5,0
2012-06-07,2012,June,4,Thursday,Summer,Clear,6,6,0
2012-06-07,2012,June,5,Thursday,Summer,Clear,34,34,0
2012-06-07,2012,June,6,Thursday,Summer,Clear,170,165,5
2012-06-07,2012,June,7,Thursday,Summer,Clear,526,506,20
2012-06-07,2012,June,8,Thursday,Summer,Clear,681,661,20
2012-06-07,2012,June,9,Thursday,Summer,Clear,337,300,37
2012-06-07,2012,June,10,Thursday,Summer,Clear,210,154,56
2012-06-07,2012,June,11,Thursday,Summer,Clear,237,170,67
2012-06-07,2012,June,12,Thursday,Summer,Clear,336,274,62
2012-06-07,2012,June,13,Thursday,Summer,Clear,315,250,65
2012-06-07,2012,June,14,Thursday,Summer,Clear,265,198,67
2012-06-07,2012,June,15,Thursday,Summer,Clear,333,234,99
2012-06-07,2012,June,16,Thursday,Summer,Clear,466,389,77
2012-06-07,2012,June,17,Thursday,Summer,Clear,869,778,91
2012-06-07,2012,June,18,Thursday,Summer,Clear,813,703,110
2012-06-07,2012,June,19,Thursday,Summer,Clear,602,537,65
2012-06-07,2012,June,20,Thursday,Summer,Clear,478,402,76
2012-06-07,2012,June,21,Thursday,Summer,Clear,313,283,30
2012-06-07,2012,June,22,Thursday,Summer,Clear,228,193,35
2012-06-07,2012,June,23,Thursday,Summer,Clear,177,135,42
2012-06-08,2012,June,0,Friday,Summer,Clear,77,59,18
2012-06-08,2012,June,1,Friday,Summer,Clear,29,25,4
2012-06-08,2012,June,2,Friday,Summer,Clear,19,17,2
2012-06-08,2012,June,3,Friday,Summer,Clear,8,8,0
2012-06-08,2012,June,4,Friday,Summer,Clear,10,9,1
2012-06-08,2012,June,5,Friday,Summer,Clear,29,28,1
2012-06-08,2012,June,6,Friday,Summer,Clear,139,131,8
2012-06-08,2012,June,7,Friday,Summer,Clear,428,409,19
2012-06-08,2012,June,8,Friday,Summer,Clear,700,663,37
2012-06-08,2012,June,9,Friday,Summer,Clear,382,335,47
2012-06-08,2012,June,10,Friday,Summer,Clear,249,187,62
2012-06-08,2012,June,11,Friday,Summer,Clear,264,199,65
2012-06-08,2012,June,12,Friday,Summer,Clear,369,280,89
2012-06-08,2012,June,13,Friday,Summer,Clear,416,287,129
2012-06-08,2012,June,14,Friday,Summer,Clear,373,245,128
2012-06-08,2012,June,15,Friday,Summer,Clear,397,299,98
2012-06-08,2012,June,16,Friday,Summer,Clear,523,412,111
2012-06-08,2012,June,17,Friday,Summer,Clear,793,679,114
2012-06-08,2012,June,18,Friday,Summer,Clear,723,576,147
2012-06-08,2012,June,19,Friday,Summer,Clear,555,460,95
2012-06-08,2012,June,20,Friday,Summer,Clear,408,291,117
2012-06-08,2012,June,21,Friday,Summer,Clear,339,256,83
2012-06-08,2012,June,22,Friday,Summer,Clear,291,230,61
2012-06-08,2012,June,23,Friday,Summer,Clear,215,163,52
2012-06-09,2012,June,0,Saturday,Summer,Clear,206,152,54
2012-06-09,2012,June,1,Saturday,Summer,Clear,123,89,34
2012-06-09,2012,June,2,Saturday,Summer,Clear,89,68,21
2012-06-09,2012,June,3,Saturday,Summer,Clear,40,28,12
2012-06-09,2012,June,4,Saturday,Summer,Clear,8,6,2
2012-06-09,2012,June,5,Saturday,Summer,Clear,19,15,4
2012-06-09,2012,June,6,Saturday,Summer,Clear,80,63,17
2012-06-09,2012,June,7,Saturday,Summer,Clear,87,61,26
2012-06-09,2012,June,8,Saturday,Summer,Clear,244,202,42
2012-06-09,2012,June,9,Saturday,Summer,Clear,340,241,99
2012-06-09,2012,June,10,Saturday,Summer,Clear,466,298,168
2012-06-09,2012,June,11,Saturday,Summer,Clear,569,351,218
2012-06-09,2012,June,12,Saturday,Summer,Clear,531,335,196
2012-06-09,2012,June,13,Saturday,Summer,Clear,585,349,236
2012-06-09,2012,June,14,Saturday,Summer,Clear,593,354,239
2012-06-09,2012,June,15,Saturday,Summer,Clear,555,337,218
2012-06-09,2012,June,16,Saturday,Summer,Clear,534,315,219
2012-06-09,2012,June,17,Saturday,Summer,Clear,495,257,238
2012-06-09,2012,June,18,Saturday,Summer,Clear,451,276,175
2012-06-09,2012,June,19,Saturday,Summer,Clear,360,232,128
2012-06-09,2012,June,20,Saturday,Summer,Clear,363,238,125
2012-06-09,2012,June,21,Saturday,Summer,Clear,316,211,105
2012-06-09,2012,June,22,Saturday,Summer,Clear,214,151,63
2012-06-09,2012,June,23,Saturday,Summer,Clear,230,161,69
2012-06-10,2012,June,0,Sunday,Summer,Clear,158,125,33
2012-06-10,2012,June,1,Sunday,Summer,Clear,116,84,32
2012-06-10,2012,June,2,Sunday,Summer,Clear,73,56,17
2012-06-10,2012,June,3,Sunday,Summer,Clear,29,23,6
2012-06-10,2012,June,4,Sunday,Summer,Clear,10,9,1
2012-06-10,2012,June,5,Sunday,Summer,Clear,13,10,3
2012-06-10,2012,June,6,Sunday,Summer,Clear,30,27,3
2012-06-10,2012,June,7,Sunday,Summer,Clear,62,41,21
2012-06-10,2012,June,8,Sunday,Summer,Clear,181,122,59
2012-06-10,2012,June,9,Sunday,Summer,Clear,266,175,91
2012-06-10,2012,June,10,Sunday,Summer,Clear,413,265,148
2012-06-10,2012,June,11,Sunday,Summer,Clear,499,315,184
2012-06-10,2012,June,12,Sunday,Summer,Clear,502,329,173
2012-06-10,2012,June,13,Sunday,Summer,Clear,492,288,204
2012-06-10,2012,June,14,Sunday,Summer,Clear,500,314,186
2012-06-10,2012,June,15,Sunday,Summer,Clear,475,316,159
2012-06-10,2012,June,16,Sunday,Summer,Clear,508,335,173
2012-06-10,2012,June,17,Sunday,Summer,Clear,521,337,184
2012-06-10,2012,June,18,Sunday,Summer,Clear,490,326,164
2012-06-10,2012,June,19,Sunday,Summer,Clear,375,260,115
2012-06-10,2012,June,20,Sunday,Summer,Clear,363,250,113
2012-06-10,2012,June,21,Sunday,Summer,Clear,253,170,83
2012-06-10,2012,June,22,Sunday,Summer,Clear,159,117,42
2012-06-10,2012,June,23,Sunday,Summer,Clear,110,80,30
2012-06-11,2012,June,0,Monday,Summer,Clear,41,33,8
2012-06-11,2012,June,1,Monday,Summer,Clear,24,15,9
2012-06-11,2012,June,2,Monday,Summer,Clear,17,12,5
2012-06-11,2012,June,3,Monday,Summer,Clear,6,4,2
2012-06-11,2012,June,4,Monday,Summer,Clear,7,7,0
2012-06-11,2012,June,5,Monday,Summer,Clear,37,36,1
2012-06-11,2012,June,6,Monday,Summer,Clear,144,136,8
2012-06-11,2012,June,7,Monday,Summer,Clear,503,478,25
2012-06-11,2012,June,8,Monday,Summer,Clear,651,613,38
2012-06-11,2012,June,9,Monday,Summer,Clear,316,259,57
2012-06-11,2012,June,10,Monday,Summer,Clear,147,95,52
2012-06-11,2012,June,11,Monday,Summer,Cloudy,202,143,59
2012-06-11,2012,June,12,Monday,Summer,Cloudy,261,198,63
2012-06-11,2012,June,13,Monday,Summer,Cloudy,248,185,63
2012-06-11,2012,June,14,Monday,Summer,Cloudy,259,193,66
2012-06-11,2012,June,15,Monday,Summer,Clear,259,187,72
2012-06-11,2012,June,16,Monday,Summer,Cloudy,427,340,87
2012-06-11,2012,June,17,Monday,Summer,Cloudy,800,715,85
2012-06-11,2012,June,18,Monday,Summer,Cloudy,831,726,105
2012-06-11,2012,June,19,Monday,Summer,Cloudy,596,507,89
2012-06-11,2012,June,20,Monday,Summer,Cloudy,394,333,61
2012-06-11,2012,June,21,Monday,Summer,Cloudy,250,218,32
2012-06-11,2012,June,22,Monday,Summer,Cloudy,164,142,22
2012-06-11,2012,June,23,Monday,Summer,Cloudy,80,72,8
2012-06-12,2012,June,0,Tuesday,Summer,Cloudy,28,26,2
2012-06-12,2012,June,1,Tuesday,Summer,Cloudy,16,11,5
2012-06-12,2012,June,2,Tuesday,Summer,Cloudy,6,6,0
2012-06-12,2012,June,3,Tuesday,Summer,Cloudy,12,9,3
2012-06-12,2012,June,4,Tuesday,Summer,Light Snow/Rain,4,4,0
2012-06-12,2012,June,5,Tuesday,Summer,Light Snow/Rain,29,28,1
2012-06-12,2012,June,6,Tuesday,Summer,Cloudy,136,130,6
2012-06-12,2012,June,7,Tuesday,Summer,Light Snow/Rain,303,287,16
2012-06-12,2012,June,8,Tuesday,Summer,Cloudy,613,598,15
2012-06-12,2012,June,9,Tuesday,Summer,Cloudy,285,254,31
2012-06-12,2012,June,10,Tuesday,Summer,Light Snow/Rain,125,96,29
2012-06-12,2012,June,11,Tuesday,Summer,Light Snow/Rain,65,57,8
2012-06-12,2012,June,12,Tuesday,Summer,Light Snow/Rain,95,76,19
2012-06-12,2012,June,13,Tuesday,Summer,Light Snow/Rain,59,48,11
2012-06-12,2012,June,14,Tuesday,Summer,Light Snow/Rain,60,48,12
2012-06-12,2012,June,15,Tuesday,Summer,Light Snow/Rain,116,94,22
2012-06-12,2012,June,16,Tuesday,Summer,Cloudy,239,209,30
2012-06-12,2012,June,17,Tuesday,Summer,Cloudy,681,625,56
2012-06-12,2012,June,18,Tuesday,Summer,Clear,653,596,57
2012-06-12,2012,June,19,Tuesday,Summer,Clear,491,444,47
2012-06-12,2012,June,20,Tuesday,Summer,Clear,386,350,36
2012-06-12,2012,June,21,Tuesday,Summer,Clear,274,233,41
2012-06-12,2012,June,22,Tuesday,Summer,Clear,207,188,19
2012-06-12,2012,June,23,Tuesday,Summer,Light Snow/Rain,89,78,11
2012-06-13,2012,June,0,Wednesday,Summer,Cloudy,34,27,7
2012-06-13,2012,June,1,Wednesday,Summer,Clear,28,21,7
2012-06-13,2012,June,2,Wednesday,Summer,Clear,4,4,0
2012-06-13,2012,June,3,Wednesday,Summer,Clear,8,7,1
2012-06-13,2012,June,4,Wednesday,Summer,Clear,10,9,1
2012-06-13,2012,June,5,Wednesday,Summer,Clear,40,38,2
2012-06-13,2012,June,6,Wednesday,Summer,Clear,194,188,6
2012-06-13,2012,June,7,Wednesday,Summer,Clear,505,480,25
2012-06-13,2012,June,8,Wednesday,Summer,Cloudy,713,672,41
2012-06-13,2012,June,9,Wednesday,Summer,Cloudy,352,298,54
2012-06-13,2012,June,10,Wednesday,Summer,Cloudy,198,134,64
2012-06-13,2012,June,11,Wednesday,Summer,Cloudy,246,182,64
2012-06-13,2012,June,12,Wednesday,Summer,Cloudy,334,241,93
2012-06-13,2012,June,13,Wednesday,Summer,Cloudy,255,203,52
2012-06-13,2012,June,14,Wednesday,Summer,Cloudy,320,222,98
2012-06-13,2012,June,15,Wednesday,Summer,Clear,281,216,65
2012-06-13,2012,June,16,Wednesday,Summer,Clear,392,320,72
2012-06-13,2012,June,17,Wednesday,Summer,Clear,857,782,75
2012-06-13,2012,June,18,Wednesday,Summer,Clear,744,640,104
2012-06-13,2012,June,19,Wednesday,Summer,Clear,671,548,123
2012-06-13,2012,June,20,Wednesday,Summer,Clear,448,362,86
2012-06-13,2012,June,21,Wednesday,Summer,Clear,396,317,79
2012-06-13,2012,June,22,Wednesday,Summer,Clear,238,209,29
2012-06-13,2012,June,23,Wednesday,Summer,Clear,153,128,25
2012-06-14,2012,June,0,Thursday,Summer,Clear,48,45,3
2012-06-14,2012,June,1,Thursday,Summer,Clear,21,17,4
2012-06-14,2012,June,2,Thursday,Summer,Cloudy,9,8,1
2012-06-14,2012,June,3,Thursday,Summer,Cloudy,5,4,1
2012-06-14,2012,June,4,Thursday,Summer,Cloudy,6,6,0
2012-06-14,2012,June,5,Thursday,Summer,Cloudy,40,40,0
2012-06-14,2012,June,6,Thursday,Summer,Clear,181,169,12
2012-06-14,2012,June,7,Thursday,Summer,Clear,506,480,26
2012-06-14,2012,June,8,Thursday,Summer,Clear,719,682,37
2012-06-14,2012,June,9,Thursday,Summer,Clear,357,312,45
2012-06-14,2012,June,10,Thursday,Summer,Clear,179,132,47
2012-06-14,2012,June,11,Thursday,Summer,Clear,228,168,60
2012-06-14,2012,June,12,Thursday,Summer,Cloudy,265,210,55
2012-06-14,2012,June,13,Thursday,Summer,Clear,284,213,71
2012-06-14,2012,June,14,Thursday,Summer,Clear,298,214,84
2012-06-14,2012,June,15,Thursday,Summer,Clear,324,213,111
2012-06-14,2012,June,16,Thursday,Summer,Clear,438,368,70
2012-06-14,2012,June,17,Thursday,Summer,Clear,867,750,117
2012-06-14,2012,June,18,Thursday,Summer,Clear,823,716,107
2012-06-14,2012,June,19,Thursday,Summer,Clear,579,483,96
2012-06-14,2012,June,20,Thursday,Summer,Clear,435,351,84
2012-06-14,2012,June,21,Thursday,Summer,Clear,337,270,67
2012-06-14,2012,June,22,Thursday,Summer,Cloudy,242,196,46
2012-06-14,2012,June,23,Thursday,Summer,Cloudy,172,136,36
2012-06-15,2012,June,0,Friday,Summer,Clear,94,68,26
2012-06-15,2012,June,1,Friday,Summer,Clear,51,42,9
2012-06-15,2012,June,2,Friday,Summer,Clear,15,15,0
2012-06-15,2012,June,3,Friday,Summer,Clear,5,3,2
2012-06-15,2012,June,4,Friday,Summer,Clear,14,13,1
2012-06-15,2012,June,5,Friday,Summer,Clear,33,31,2
2012-06-15,2012,June,6,Friday,Summer,Clear,151,142,9
2012-06-15,2012,June,7,Friday,Summer,Clear,430,413,17
2012-06-15,2012,June,8,Friday,Summer,Clear,653,609,44
2012-06-15,2012,June,9,Friday,Summer,Clear,366,308,58
2012-06-15,2012,June,10,Friday,Summer,Clear,216,160,56
2012-06-15,2012,June,11,Friday,Summer,Clear,286,180,106
2012-06-15,2012,June,12,Friday,Summer,Clear,403,292,111
2012-06-15,2012,June,13,Friday,Summer,Clear,393,272,121
2012-06-15,2012,June,14,Friday,Summer,Clear,376,255,121
2012-06-15,2012,June,15,Friday,Summer,Clear,377,270,107
2012-06-15,2012,June,16,Friday,Summer,Clear,558,426,132
2012-06-15,2012,June,17,Friday,Summer,Clear,823,698,125
2012-06-15,2012,June,18,Friday,Summer,Clear,693,572,121
2012-06-15,2012,June,19,Friday,Summer,Clear,467,369,98
2012-06-15,2012,June,20,Friday,Summer,Clear,385,296,89
2012-06-15,2012,June,21,Friday,Summer,Clear,333,250,83
2012-06-15,2012,June,22,Friday,Summer,Clear,321,242,79
2012-06-15,2012,June,23,Friday,Summer,Clear,222,176,46
2012-06-16,2012,June,0,Saturday,Summer,Clear,137,112,25
2012-06-16,2012,June,1,Saturday,Summer,Clear,95,79,16
2012-06-16,2012,June,2,Saturday,Summer,Clear,67,55,12
2012-06-16,2012,June,3,Saturday,Summer,Clear,27,19,8
2012-06-16,2012,June,4,Saturday,Summer,Clear,8,5,3
2012-06-16,2012,June,5,Saturday,Summer,Clear,23,21,2
2012-06-16,2012,June,6,Saturday,Summer,Clear,47,36,11
2012-06-16,2012,June,7,Saturday,Summer,Clear,78,68,10
2012-06-16,2012,June,8,Saturday,Summer,Clear,204,157,47
2012-06-16,2012,June,9,Saturday,Summer,Clear,367,279,88
2012-06-16,2012,June,10,Saturday,Summer,Clear,435,296,139
2012-06-16,2012,June,11,Saturday,Summer,Clear,566,353,213
2012-06-16,2012,June,12,Saturday,Summer,Clear,603,349,254
2012-06-16,2012,June,13,Saturday,Summer,Clear,617,324,293
2012-06-16,2012,June,14,Saturday,Summer,Clear,573,309,264
2012-06-16,2012,June,15,Saturday,Summer,Clear,583,288,295
2012-06-16,2012,June,16,Saturday,Summer,Cloudy,542,304,238
2012-06-16,2012,June,17,Saturday,Summer,Cloudy,593,349,244
2012-06-16,2012,June,18,Saturday,Summer,Cloudy,571,315,256
2012-06-16,2012,June,19,Saturday,Summer,Cloudy,461,277,184
2012-06-16,2012,June,20,Saturday,Summer,Cloudy,352,229,123
2012-06-16,2012,June,21,Saturday,Summer,Cloudy,290,192,98
2012-06-16,2012,June,22,Saturday,Summer,Clear,280,189,91
2012-06-16,2012,June,23,Saturday,Summer,Clear,183,134,49
2012-06-17,2012,June,0,Sunday,Summer,Clear,148,117,31
2012-06-17,2012,June,1,Sunday,Summer,Clear,88,67,21
2012-06-17,2012,June,2,Sunday,Summer,Clear,74,55,19
2012-06-17,2012,June,3,Sunday,Summer,Clear,28,22,6
2012-06-17,2012,June,4,Sunday,Summer,Clear,18,16,2
2012-06-17,2012,June,5,Sunday,Summer,Clear,17,13,4
2012-06-17,2012,June,6,Sunday,Summer,Clear,23,16,7
2012-06-17,2012,June,7,Sunday,Summer,Clear,48,30,18
2012-06-17,2012,June,8,Sunday,Summer,Clear,119,95,24
2012-06-17,2012,June,9,Sunday,Summer,Clear,274,183,91
2012-06-17,2012,June,10,Sunday,Summer,Clear,436,288,148
2012-06-17,2012,June,11,Sunday,Summer,Clear,546,350,196
2012-06-17,2012,June,12,Sunday,Summer,Clear,615,355,260
2012-06-17,2012,June,13,Sunday,Summer,Clear,614,347,267
2012-06-17,2012,June,14,Sunday,Summer,Clear,582,327,255
2012-06-17,2012,June,15,Sunday,Summer,Clear,463,260,203
2012-06-17,2012,June,16,Sunday,Summer,Clear,580,340,240
2012-06-17,2012,June,17,Sunday,Summer,Clear,593,361,232
2012-06-17,2012,June,18,Sunday,Summer,Clear,513,310,203
2012-06-17,2012,June,19,Sunday,Summer,Clear,390,244,146
2012-06-17,2012,June,20,Sunday,Summer,Clear,302,201,101
2012-06-17,2012,June,21,Sunday,Summer,Clear,246,170,76
2012-06-17,2012,June,22,Sunday,Summer,Clear,153,98,55
2012-06-17,2012,June,23,Sunday,Summer,Clear,108,79,29
2012-06-18,2012,June,0,Monday,Summer,Clear,40,28,12
2012-06-18,2012,June,1,Monday,Summer,Clear,14,5,9
2012-06-18,2012,June,2,Monday,Summer,Clear,9,6,3
2012-06-18,2012,June,3,Monday,Summer,Cloudy,4,3,1
2012-06-18,2012,June,4,Monday,Summer,Cloudy,9,9,0
2012-06-18,2012,June,5,Monday,Summer,Light Snow/Rain,23,22,1
2012-06-18,2012,June,6,Monday,Summer,Light Snow/Rain,37,37,0
2012-06-18,2012,June,7,Monday,Summer,Light Snow/Rain,145,135,10
2012-06-18,2012,June,8,Monday,Summer,Cloudy,474,447,27
2012-06-18,2012,June,9,Monday,Summer,Cloudy,250,222,28
2012-06-18,2012,June,10,Monday,Summer,Light Snow/Rain,91,78,13
2012-06-18,2012,June,11,Monday,Summer,Cloudy,121,96,25
2012-06-18,2012,June,12,Monday,Summer,Light Snow/Rain,168,139,29
2012-06-18,2012,June,13,Monday,Summer,Cloudy,225,174,51
2012-06-18,2012,June,14,Monday,Summer,Cloudy,219,160,59
2012-06-18,2012,June,15,Monday,Summer,Cloudy,237,176,61
2012-06-18,2012,June,16,Monday,Summer,Cloudy,332,279,53
2012-06-18,2012,June,17,Monday,Summer,Cloudy,723,669,54
2012-06-18,2012,June,18,Monday,Summer,Cloudy,642,595,47
2012-06-18,2012,June,19,Monday,Summer,Cloudy,463,411,52
2012-06-18,2012,June,20,Monday,Summer,Cloudy,362,317,45
2012-06-18,2012,June,21,Monday,Summer,Cloudy,273,238,35
2012-06-18,2012,June,22,Monday,Summer,Cloudy,164,143,21
2012-06-18,2012,June,23,Monday,Summer,Light Snow/Rain,74,57,17
2012-06-19,2012,June,0,Tuesday,Summer,Cloudy,35,30,5
2012-06-19,2012,June,1,Tuesday,Summer,Cloudy,14,13,1
2012-06-19,2012,June,2,Tuesday,Summer,Cloudy,15,14,1
2012-06-19,2012,June,3,Tuesday,Summer,Cloudy,8,7,1
2012-06-19,2012,June,4,Tuesday,Summer,Cloudy,10,9,1
2012-06-19,2012,June,5,Tuesday,Summer,Cloudy,37,34,3
2012-06-19,2012,June,6,Tuesday,Summer,Cloudy,161,152,9
2012-06-19,2012,June,7,Tuesday,Summer,Cloudy,480,462,18
2012-06-19,2012,June,8,Tuesday,Summer,Cloudy,673,633,40
2012-06-19,2012,June,9,Tuesday,Summer,Clear,328,288,40
2012-06-19,2012,June,10,Tuesday,Summer,Clear,180,136,44
2012-06-19,2012,June,11,Tuesday,Summer,Clear,230,174,56
2012-06-19,2012,June,12,Tuesday,Summer,Clear,292,222,70
2012-06-19,2012,June,13,Tuesday,Summer,Clear,272,203,69
2012-06-19,2012,June,14,Tuesday,Summer,Clear,227,166,61
2012-06-19,2012,June,15,Tuesday,Summer,Clear,259,187,72
2012-06-19,2012,June,16,Tuesday,Summer,Clear,334,286,48
2012-06-19,2012,June,17,Tuesday,Summer,Clear,811,725,86
2012-06-19,2012,June,18,Tuesday,Summer,Clear,795,704,91
2012-06-19,2012,June,19,Tuesday,Summer,Clear,514,432,82
2012-06-19,2012,June,20,Tuesday,Summer,Clear,458,399,59
2012-06-19,2012,June,21,Tuesday,Summer,Clear,276,239,37
2012-06-19,2012,June,22,Tuesday,Summer,Clear,291,240,51
2012-06-19,2012,June,23,Tuesday,Summer,Clear,125,102,23
2012-06-20,2012,June,0,Wednesday,Summer,Clear,53,48,5
2012-06-20,2012,June,1,Wednesday,Summer,Clear,27,20,7
2012-06-20,2012,June,2,Wednesday,Summer,Clear,6,5,1
2012-06-20,2012,June,3,Wednesday,Summer,Clear,8,6,2
2012-06-20,2012,June,4,Wednesday,Summer,Clear,7,6,1
2012-06-20,2012,June,5,Wednesday,Summer,Clear,39,37,2
2012-06-20,2012,June,6,Wednesday,Summer,Cloudy,165,156,9
2012-06-20,2012,June,7,Wednesday,Summer,Cloudy,464,444,20
2012-06-20,2012,June,8,Wednesday,Summer,Cloudy,643,600,43
2012-06-20,2012,June,9,Wednesday,Summer,Cloudy,316,276,40
2012-06-20,2012,June,10,Wednesday,Summer,Clear,167,126,41
2012-06-20,2012,June,11,Wednesday,Summer,Clear,188,134,54
2012-06-20,2012,June,12,Wednesday,Summer,Clear,180,150,30
2012-06-20,2012,June,13,Wednesday,Summer,Clear,211,163,48
2012-06-20,2012,June,14,Wednesday,Summer,Clear,190,134,56
2012-06-20,2012,June,15,Wednesday,Summer,Clear,179,143,36
2012-06-20,2012,June,16,Wednesday,Summer,Clear,335,284,51
2012-06-20,2012,June,17,Wednesday,Summer,Clear,691,611,80
2012-06-20,2012,June,18,Wednesday,Summer,Clear,672,591,81
2012-06-20,2012,June,19,Wednesday,Summer,Clear,539,449,90
2012-06-20,2012,June,20,Wednesday,Summer,Clear,407,326,81
2012-06-20,2012,June,21,Wednesday,Summer,Clear,344,302,42
2012-06-20,2012,June,22,Wednesday,Summer,Clear,257,226,31
2012-06-20,2012,June,23,Wednesday,Summer,Clear,123,102,21
2012-06-21,2012,June,0,Thursday,Fall,Clear,69,53,16
2012-06-21,2012,June,1,Thursday,Fall,Clear,18,16,2
2012-06-21,2012,June,2,Thursday,Fall,Clear,18,7,11
2012-06-21,2012,June,3,Thursday,Fall,Clear,11,8,3
2012-06-21,2012,June,4,Thursday,Fall,Clear,12,11,1
2012-06-21,2012,June,5,Thursday,Fall,Clear,40,37,3
2012-06-21,2012,June,6,Thursday,Fall,Cloudy,150,147,3
2012-06-21,2012,June,7,Thursday,Fall,Cloudy,463,437,26
2012-06-21,2012,June,8,Thursday,Fall,Clear,590,563,27
2012-06-21,2012,June,9,Thursday,Fall,Clear,256,224,32
2012-06-21,2012,June,10,Thursday,Fall,Clear,150,114,36
2012-06-21,2012,June,11,Thursday,Fall,Clear,161,121,40
2012-06-21,2012,June,12,Thursday,Fall,Clear,215,182,33
2012-06-21,2012,June,13,Thursday,Fall,Clear,172,141,31
2012-06-21,2012,June,14,Thursday,Fall,Clear,176,149,27
2012-06-21,2012,June,15,Thursday,Fall,Clear,194,154,40
2012-06-21,2012,June,16,Thursday,Fall,Clear,320,283,37
2012-06-21,2012,June,17,Thursday,Fall,Clear,615,535,80
2012-06-21,2012,June,18,Thursday,Fall,Clear,640,562,78
2012-06-21,2012,June,19,Thursday,Fall,Clear,499,415,84
2012-06-21,2012,June,20,Thursday,Fall,Clear,436,357,79
2012-06-21,2012,June,21,Thursday,Fall,Clear,311,256,55
2012-06-21,2012,June,22,Thursday,Fall,Clear,243,221,22
2012-06-21,2012,June,23,Thursday,Fall,Clear,146,134,12
2012-06-22,2012,June,0,Friday,Fall,Cloudy,93,77,16
2012-06-22,2012,June,1,Friday,Fall,Clear,31,28,3
2012-06-22,2012,June,2,Friday,Fall,Clear,12,12,0
2012-06-22,2012,June,3,Friday,Fall,Clear,7,6,1
2012-06-22,2012,June,4,Friday,Fall,Cloudy,10,7,3
2012-06-22,2012,June,5,Friday,Fall,Cloudy,38,35,3
2012-06-22,2012,June,6,Friday,Fall,Cloudy,122,118,4
2012-06-22,2012,June,7,Friday,Fall,Clear,359,340,19
2012-06-22,2012,June,8,Friday,Fall,Clear,613,564,49
2012-06-22,2012,June,9,Friday,Fall,Clear,333,278,55
2012-06-22,2012,June,10,Friday,Fall,Clear,185,133,52
2012-06-22,2012,June,11,Friday,Fall,Clear,236,160,76
2012-06-22,2012,June,12,Friday,Fall,Clear,254,191,63
2012-06-22,2012,June,13,Friday,Fall,Clear,300,228,72
2012-06-22,2012,June,14,Friday,Fall,Clear,263,198,65
2012-06-22,2012,June,15,Friday,Fall,Clear,284,212,72
2012-06-22,2012,June,16,Friday,Fall,Clear,380,313,67
2012-06-22,2012,June,17,Friday,Fall,Cloudy,646,551,95
2012-06-22,2012,June,18,Friday,Fall,Cloudy,505,443,62
2012-06-22,2012,June,19,Friday,Fall,Cloudy,362,317,45
2012-06-22,2012,June,20,Friday,Fall,Cloudy,202,171,31
2012-06-22,2012,June,21,Friday,Fall,Light Snow/Rain,217,177,40
2012-06-22,2012,June,22,Friday,Fall,Clear,197,155,42
2012-06-22,2012,June,23,Friday,Fall,Cloudy,174,145,29
2012-06-23,2012,June,0,Saturday,Fall,Clear,116,102,14
2012-06-23,2012,June,1,Saturday,Fall,Clear,123,107,16
2012-06-23,2012,June,2,Saturday,Fall,Cloudy,93,75,18
2012-06-23,2012,June,3,Saturday,Fall,Cloudy,42,32,10
2012-06-23,2012,June,4,Saturday,Fall,Cloudy,19,13,6
2012-06-23,2012,June,5,Saturday,Fall,Cloudy,12,11,1
2012-06-23,2012,June,6,Saturday,Fall,Clear,47,37,10
2012-06-23,2012,June,7,Saturday,Fall,Clear,78,59,19
2012-06-23,2012,June,8,Saturday,Fall,Clear,167,133,34
2012-06-23,2012,June,9,Saturday,Fall,Clear,332,247,85
2012-06-23,2012,June,10,Saturday,Fall,Clear,494,317,177
2012-06-23,2012,June,11,Saturday,Fall,Clear,516,349,167
2012-06-23,2012,June,12,Saturday,Fall,Clear,602,399,203
2012-06-23,2012,June,13,Saturday,Fall,Clear,564,338,226
2012-06-23,2012,June,14,Saturday,Fall,Clear,609,371,238
2012-06-23,2012,June,15,Saturday,Fall,Clear,483,266,217
2012-06-23,2012,June,16,Saturday,Fall,Clear,513,317,196
2012-06-23,2012,June,17,Saturday,Fall,Clear,530,316,214
2012-06-23,2012,June,18,Saturday,Fall,Clear,481,287,194
2012-06-23,2012,June,19,Saturday,Fall,Clear,425,240,185
2012-06-23,2012,June,20,Saturday,Fall,Clear,386,228,158
2012-06-23,2012,June,21,Saturday,Fall,Clear,322,223,99
2012-06-23,2012,June,22,Saturday,Fall,Clear,279,178,101
2012-06-23,2012,June,23,Saturday,Fall,Clear,225,156,69
2012-06-24,2012,June,0,Sunday,Fall,Clear,163,132,31
2012-06-24,2012,June,1,Sunday,Fall,Cloudy,127,88,39
2012-06-24,2012,June,2,Sunday,Fall,Cloudy,114,80,34
2012-06-24,2012,June,3,Sunday,Fall,Cloudy,60,41,19
2012-06-24,2012,June,4,Sunday,Fall,Cloudy,13,9,4
2012-06-24,2012,June,5,Sunday,Fall,Clear,8,7,1
2012-06-24,2012,June,6,Sunday,Fall,Clear,25,19,6
2012-06-24,2012,June,7,Sunday,Fall,Clear,71,48,23
2012-06-24,2012,June,8,Sunday,Fall,Clear,141,103,38
2012-06-24,2012,June,9,Sunday,Fall,Clear,232,169,63
2012-06-24,2012,June,10,Sunday,Fall,Clear,452,291,161
2012-06-24,2012,June,11,Sunday,Fall,Clear,506,291,215
2012-06-24,2012,June,12,Sunday,Fall,Clear,556,329,227
2012-06-24,2012,June,13,Sunday,Fall,Clear,585,348,237
2012-06-24,2012,June,14,Sunday,Fall,Clear,551,298,253
2012-06-24,2012,June,15,Sunday,Fall,Clear,487,290,197
2012-06-24,2012,June,16,Sunday,Fall,Clear,461,280,181
2012-06-24,2012,June,17,Sunday,Fall,Clear,532,329,203
2012-06-24,2012,June,18,Sunday,Fall,Clear,534,348,186
2012-06-24,2012,June,19,Sunday,Fall,Clear,423,247,176
2012-06-24,2012,June,20,Sunday,Fall,Clear,332,224,108
2012-06-24,2012,June,21,Sunday,Fall,Clear,253,177,76
2012-06-24,2012,June,22,Sunday,Fall,Clear,178,125,53
2012-06-24,2012,June,23,Sunday,Fall,Clear,87,67,20
2012-06-25,2012,June,0,Monday,Fall,Clear,68,37,31
2012-06-25,2012,June,1,Monday,Fall,Clear,31,20,11
2012-06-25,2012,June,2,Monday,Fall,Clear,14,10,4
2012-06-25,2012,June,3,Monday,Fall,Clear,5,4,1
2012-06-25,2012,June,4,Monday,Fall,Clear,4,4,0
2012-06-25,2012,June,5,Monday,Fall,Clear,43,42,1
2012-06-25,2012,June,6,Monday,Fall,Clear,158,147,11
2012-06-25,2012,June,7,Monday,Fall,Clear,485,455,30
2012-06-25,2012,June,8,Monday,Fall,Clear,608,555,53
2012-06-25,2012,June,9,Monday,Fall,Clear,268,231,37
2012-06-25,2012,June,10,Monday,Fall,Clear,184,126,58
2012-06-25,2012,June,11,Monday,Fall,Clear,181,127,54
2012-06-25,2012,June,12,Monday,Fall,Cloudy,270,196,74
2012-06-25,2012,June,13,Monday,Fall,Clear,260,181,79
2012-06-25,2012,June,14,Monday,Fall,Clear,251,161,90
2012-06-25,2012,June,15,Monday,Fall,Clear,233,168,65
2012-06-25,2012,June,16,Monday,Fall,Clear,414,310,104
2012-06-25,2012,June,17,Monday,Fall,Clear,833,757,76
2012-06-25,2012,June,18,Monday,Fall,Clear,791,691,100
2012-06-25,2012,June,19,Monday,Fall,Clear,582,508,74
2012-06-25,2012,June,20,Monday,Fall,Clear,475,375,100
2012-06-25,2012,June,21,Monday,Fall,Clear,331,281,50
2012-06-25,2012,June,22,Monday,Fall,Clear,187,166,21
2012-06-25,2012,June,23,Monday,Fall,Clear,103,88,15
2012-06-26,2012,June,0,Tuesday,Fall,Clear,37,29,8
2012-06-26,2012,June,1,Tuesday,Fall,Clear,30,19,11
2012-06-26,2012,June,2,Tuesday,Fall,Clear,9,7,2
2012-06-26,2012,June,3,Tuesday,Fall,Clear,9,7,2
2012-06-26,2012,June,4,Tuesday,Fall,Clear,10,9,1
2012-06-26,2012,June,5,Tuesday,Fall,Clear,39,36,3
2012-06-26,2012,June,6,Tuesday,Fall,Clear,188,176,12
2012-06-26,2012,June,7,Tuesday,Fall,Clear,552,531,21
2012-06-26,2012,June,8,Tuesday,Fall,Clear,656,622,34
2012-06-26,2012,June,9,Tuesday,Fall,Clear,328,298,30
2012-06-26,2012,June,10,Tuesday,Fall,Clear,190,153,37
2012-06-26,2012,June,11,Tuesday,Fall,Clear,235,189,46
2012-06-26,2012,June,12,Tuesday,Fall,Clear,308,228,80
2012-06-26,2012,June,13,Tuesday,Fall,Clear,306,232,74
2012-06-26,2012,June,14,Tuesday,Fall,Clear,267,186,81
2012-06-26,2012,June,15,Tuesday,Fall,Clear,317,229,88
2012-06-26,2012,June,16,Tuesday,Fall,Clear,416,349,67
2012-06-26,2012,June,17,Tuesday,Fall,Clear,900,796,104
2012-06-26,2012,June,18,Tuesday,Fall,Clear,824,719,105
2012-06-26,2012,June,19,Tuesday,Fall,Clear,612,529,83
2012-06-26,2012,June,20,Tuesday,Fall,Clear,505,417,88
2012-06-26,2012,June,21,Tuesday,Fall,Clear,328,267,61
2012-06-26,2012,June,22,Tuesday,Fall,Clear,245,219,26
2012-06-26,2012,June,23,Tuesday,Fall,Clear,131,118,13
2012-06-27,2012,June,0,Wednesday,Fall,Clear,54,39,15
2012-06-27,2012,June,1,Wednesday,Fall,Clear,23,18,5
2012-06-27,2012,June,2,Wednesday,Fall,Clear,14,12,2
2012-06-27,2012,June,3,Wednesday,Fall,Clear,8,7,1
2012-06-27,2012,June,4,Wednesday,Fall,Clear,11,11,0
2012-06-27,2012,June,5,Wednesday,Fall,Clear,36,34,2
2012-06-27,2012,June,6,Wednesday,Fall,Clear,200,193,7
2012-06-27,2012,June,7,Wednesday,Fall,Clear,527,498,29
2012-06-27,2012,June,8,Wednesday,Fall,Clear,687,638,49
2012-06-27,2012,June,9,Wednesday,Fall,Clear,282,253,29
2012-06-27,2012,June,10,Wednesday,Fall,Clear,172,138,34
2012-06-27,2012,June,11,Wednesday,Fall,Clear,209,145,64
2012-06-27,2012,June,12,Wednesday,Fall,Clear,322,245,77
2012-06-27,2012,June,13,Wednesday,Fall,Clear,321,244,77
2012-06-27,2012,June,14,Wednesday,Fall,Clear,270,192,78
2012-06-27,2012,June,15,Wednesday,Fall,Clear,249,188,61
2012-06-27,2012,June,16,Wednesday,Fall,Clear,392,337,55
2012-06-27,2012,June,17,Wednesday,Fall,Clear,843,730,113
2012-06-27,2012,June,18,Wednesday,Fall,Clear,804,719,85
2012-06-27,2012,June,19,Wednesday,Fall,Clear,643,542,101
2012-06-27,2012,June,20,Wednesday,Fall,Clear,445,369,76
2012-06-27,2012,June,21,Wednesday,Fall,Clear,367,313,54
2012-06-27,2012,June,22,Wednesday,Fall,Clear,297,245,52
2012-06-27,2012,June,23,Wednesday,Fall,Clear,159,148,11
2012-06-28,2012,June,0,Thursday,Fall,Clear,54,52,2
2012-06-28,2012,June,1,Thursday,Fall,Clear,25,14,11
2012-06-28,2012,June,2,Thursday,Fall,Clear,13,12,1
2012-06-28,2012,June,3,Thursday,Fall,Clear,7,6,1
2012-06-28,2012,June,4,Thursday,Fall,Clear,11,11,0
2012-06-28,2012,June,5,Thursday,Fall,Clear,47,39,8
2012-06-28,2012,June,6,Thursday,Fall,Clear,193,185,8
2012-06-28,2012,June,7,Thursday,Fall,Clear,508,484,24
2012-06-28,2012,June,8,Thursday,Fall,Clear,617,577,40
2012-06-28,2012,June,9,Thursday,Fall,Clear,351,318,33
2012-06-28,2012,June,10,Thursday,Fall,Clear,184,144,40
2012-06-28,2012,June,11,Thursday,Fall,Clear,211,170,41
2012-06-28,2012,June,12,Thursday,Fall,Clear,276,227,49
2012-06-28,2012,June,13,Thursday,Fall,Clear,236,205,31
2012-06-28,2012,June,14,Thursday,Fall,Clear,254,188,66
2012-06-28,2012,June,15,Thursday,Fall,Clear,219,195,24
2012-06-28,2012,June,16,Thursday,Fall,Clear,387,331,56
2012-06-28,2012,June,17,Thursday,Fall,Clear,705,634,71
2012-06-28,2012,June,18,Thursday,Fall,Clear,697,597,100
2012-06-28,2012,June,19,Thursday,Fall,Clear,571,492,79
2012-06-28,2012,June,20,Thursday,Fall,Clear,470,399,71
2012-06-28,2012,June,21,Thursday,Fall,Clear,398,309,89
2012-06-28,2012,June,22,Thursday,Fall,Clear,274,224,50
2012-06-28,2012,June,23,Thursday,Fall,Clear,171,145,26
2012-06-29,2012,June,0,Friday,Fall,Clear,114,90,24
2012-06-29,2012,June,1,Friday,Fall,Clear,42,33,9
2012-06-29,2012,June,2,Friday,Fall,Clear,18,15,3
2012-06-29,2012,June,3,Friday,Fall,Clear,8,5,3
2012-06-29,2012,June,4,Friday,Fall,Clear,10,9,1
2012-06-29,2012,June,5,Friday,Fall,Clear,45,39,6
2012-06-29,2012,June,6,Friday,Fall,Cloudy,163,148,15
2012-06-29,2012,June,7,Friday,Fall,Clear,380,361,19
2012-06-29,2012,June,8,Friday,Fall,Cloudy,624,576,48
2012-06-29,2012,June,9,Friday,Fall,Clear,300,261,39
2012-06-29,2012,June,10,Friday,Fall,Clear,171,139,32
2012-06-29,2012,June,11,Friday,Fall,Cloudy,188,137,51
2012-06-29,2012,June,12,Friday,Fall,Cloudy,226,173,53
2012-06-29,2012,June,13,Friday,Fall,Clear,239,194,45
2012-06-29,2012,June,14,Friday,Fall,Clear,233,184,49
2012-06-29,2012,June,15,Friday,Fall,Clear,230,183,47
2012-06-29,2012,June,16,Friday,Fall,Clear,351,292,59
2012-06-29,2012,June,17,Friday,Fall,Clear,539,457,82
2012-06-29,2012,June,18,Friday,Fall,Clear,464,414,50
2012-06-29,2012,June,19,Friday,Fall,Clear,363,303,60
2012-06-29,2012,June,20,Friday,Fall,Clear,308,255,53
2012-06-29,2012,June,21,Friday,Fall,Cloudy,236,195,41
2012-06-29,2012,June,22,Friday,Fall,Light Snow/Rain,163,129,34
2012-06-29,2012,June,23,Friday,Fall,Light Snow/Rain,48,42,6
2012-06-30,2012,June,0,Saturday,Fall,Light Snow/Rain,69,65,4
2012-06-30,2012,June,1,Saturday,Fall,Light Snow/Rain,58,55,3
2012-06-30,2012,June,2,Saturday,Fall,Cloudy,61,54,7
2012-06-30,2012,June,3,Saturday,Fall,Cloudy,23,20,3
2012-06-30,2012,June,4,Saturday,Fall,Cloudy,18,15,3
2012-06-30,2012,June,5,Saturday,Fall,Clear,10,7,3
2012-06-30,2012,June,6,Saturday,Fall,Clear,42,36,6
2012-06-30,2012,June,7,Saturday,Fall,Clear,92,82,10
2012-06-30,2012,June,8,Saturday,Fall,Clear,194,168,26
2012-06-30,2012,June,9,Saturday,Fall,Clear,275,234,41
2012-06-30,2012,June,10,Saturday,Fall,Clear,404,308,96
2012-06-30,2012,June,11,Saturday,Fall,Clear,452,350,102
2012-06-30,2012,June,12,Saturday,Fall,Clear,471,328,143
2012-06-30,2012,June,13,Saturday,Fall,Clear,428,323,105
2012-06-30,2012,June,14,Saturday,Fall,Clear,409,295,114
2012-06-30,2012,June,15,Saturday,Fall,Clear,404,287,117
2012-06-30,2012,June,16,Saturday,Fall,Clear,373,264,109
2012-06-30,2012,June,17,Saturday,Fall,Clear,362,231,131
2012-06-30,2012,June,18,Saturday,Fall,Clear,339,248,91
2012-06-30,2012,June,19,Saturday,Fall,Clear,374,240,134
2012-06-30,2012,June,20,Saturday,Fall,Clear,292,204,88
2012-06-30,2012,June,21,Saturday,Fall,Clear,213,165,48
2012-06-30,2012,June,22,Saturday,Fall,Clear,172,134,38
2012-06-30,2012,June,23,Saturday,Fall,Clear,152,119,33
2012-07-01,2012,July,0,Sunday,Fall,Clear,149,122,27
2012-07-01,2012,July,1,Sunday,Fall,Clear,93,81,12
2012-07-01,2012,July,2,Sunday,Fall,Clear,90,69,21
2012-07-01,2012,July,3,Sunday,Fall,Clear,33,27,6
2012-07-01,2012,July,4,Sunday,Fall,Clear,4,4,0
2012-07-01,2012,July,5,Sunday,Fall,Clear,10,7,3
2012-07-01,2012,July,6,Sunday,Fall,Clear,27,19,8
2012-07-01,2012,July,7,Sunday,Fall,Clear,50,37,13
2012-07-01,2012,July,8,Sunday,Fall,Clear,142,106,36
2012-07-01,2012,July,9,Sunday,Fall,Clear,219,168,51
2012-07-01,2012,July,10,Sunday,Fall,Clear,366,268,98
2012-07-01,2012,July,11,Sunday,Fall,Clear,377,256,121
2012-07-01,2012,July,12,Sunday,Fall,Clear,433,319,114
2012-07-01,2012,July,13,Sunday,Fall,Clear,420,309,111
2012-07-01,2012,July,14,Sunday,Fall,Clear,444,346,98
2012-07-01,2012,July,15,Sunday,Fall,Clear,345,244,101
2012-07-01,2012,July,16,Sunday,Fall,Clear,313,228,85
2012-07-01,2012,July,17,Sunday,Fall,Clear,413,323,90
2012-07-01,2012,July,18,Sunday,Fall,Clear,370,275,95
2012-07-01,2012,July,19,Sunday,Fall,Clear,382,279,103
2012-07-01,2012,July,20,Sunday,Fall,Clear,332,244,88
2012-07-01,2012,July,21,Sunday,Fall,Clear,258,181,77
2012-07-01,2012,July,22,Sunday,Fall,Clear,151,110,41
2012-07-01,2012,July,23,Sunday,Fall,Light Snow/Rain,110,88,22
2012-07-02,2012,July,0,Monday,Fall,Cloudy,43,31,12
2012-07-02,2012,July,1,Monday,Fall,Cloudy,17,14,3
2012-07-02,2012,July,2,Monday,Fall,Cloudy,15,14,1
2012-07-02,2012,July,3,Monday,Fall,Cloudy,5,5,0
2012-07-02,2012,July,4,Monday,Fall,Cloudy,12,10,2
2012-07-02,2012,July,5,Monday,Fall,Cloudy,40,37,3
2012-07-02,2012,July,6,Monday,Fall,Clear,136,132,4
2012-07-02,2012,July,7,Monday,Fall,Clear,398,390,8
2012-07-02,2012,July,8,Monday,Fall,Clear,568,548,20
2012-07-02,2012,July,9,Monday,Fall,Clear,295,239,56
2012-07-02,2012,July,10,Monday,Fall,Clear,174,104,70
2012-07-02,2012,July,11,Monday,Fall,Clear,201,134,67
2012-07-02,2012,July,12,Monday,Fall,Clear,257,183,74
2012-07-02,2012,July,13,Monday,Fall,Clear,236,162,74
2012-07-02,2012,July,14,Monday,Fall,Clear,230,151,79
2012-07-02,2012,July,15,Monday,Fall,Clear,234,175,59
2012-07-02,2012,July,16,Monday,Fall,Clear,365,304,61
2012-07-02,2012,July,17,Monday,Fall,Clear,747,665,82
2012-07-02,2012,July,18,Monday,Fall,Clear,730,658,72
2012-07-02,2012,July,19,Monday,Fall,Clear,581,510,71
2012-07-02,2012,July,20,Monday,Fall,Clear,395,357,38
2012-07-02,2012,July,21,Monday,Fall,Clear,258,241,17
2012-07-02,2012,July,22,Monday,Fall,Clear,188,169,19
2012-07-02,2012,July,23,Monday,Fall,Clear,102,90,12
2012-07-03,2012,July,0,Tuesday,Fall,Clear,53,44,9
2012-07-03,2012,July,1,Tuesday,Fall,Clear,14,9,5
2012-07-03,2012,July,2,Tuesday,Fall,Clear,10,8,2
2012-07-03,2012,July,3,Tuesday,Fall,Clear,2,2,0
2012-07-03,2012,July,4,Tuesday,Fall,Clear,6,6,0
2012-07-03,2012,July,5,Tuesday,Fall,Clear,35,33,2
2012-07-03,2012,July,6,Tuesday,Fall,Clear,154,149,5
2012-07-03,2012,July,7,Tuesday,Fall,Clear,483,462,21
2012-07-03,2012,July,8,Tuesday,Fall,Clear,646,604,42
2012-07-03,2012,July,9,Tuesday,Fall,Clear,272,226,46
2012-07-03,2012,July,10,Tuesday,Fall,Clear,209,153,56
2012-07-03,2012,July,11,Tuesday,Fall,Clear,217,151,66
2012-07-03,2012,July,12,Tuesday,Fall,Clear,272,198,74
2012-07-03,2012,July,13,Tuesday,Fall,Clear,283,203,80
2012-07-03,2012,July,14,Tuesday,Fall,Clear,310,241,69
2012-07-03,2012,July,15,Tuesday,Fall,Cloudy,401,330,71
2012-07-03,2012,July,16,Tuesday,Fall,Cloudy,527,437,90
2012-07-03,2012,July,17,Tuesday,Fall,Cloudy,722,620,102
2012-07-03,2012,July,18,Tuesday,Fall,Cloudy,627,542,85
2012-07-03,2012,July,19,Tuesday,Fall,Cloudy,497,431,66
2012-07-03,2012,July,20,Tuesday,Fall,Light Snow/Rain,376,296,80
2012-07-03,2012,July,21,Tuesday,Fall,Cloudy,196,160,36
2012-07-03,2012,July,22,Tuesday,Fall,Clear,177,151,26
2012-07-03,2012,July,23,Tuesday,Fall,Clear,171,152,19
2012-07-04,2012,July,0,Wednesday,Fall,Clear,159,140,19
2012-07-04,2012,July,1,Wednesday,Fall,Clear,123,96,27
2012-07-04,2012,July,2,Wednesday,Fall,Clear,93,66,27
2012-07-04,2012,July,3,Wednesday,Fall,Clear,32,23,9
2012-07-04,2012,July,4,Wednesday,Fall,Clear,16,11,5
2012-07-04,2012,July,5,Wednesday,Fall,Clear,19,14,5
2012-07-04,2012,July,6,Wednesday,Fall,Clear,32,23,9
2012-07-04,2012,July,7,Wednesday,Fall,Clear,72,62,10
2012-07-04,2012,July,8,Wednesday,Fall,Clear,153,110,43
2012-07-04,2012,July,9,Wednesday,Fall,Clear,293,203,90
2012-07-04,2012,July,10,Wednesday,Fall,Clear,447,304,143
2012-07-04,2012,July,11,Wednesday,Fall,Clear,485,321,164
2012-07-04,2012,July,12,Wednesday,Fall,Clear,494,330,164
2012-07-04,2012,July,13,Wednesday,Fall,Clear,499,322,177
2012-07-04,2012,July,14,Wednesday,Fall,Clear,547,357,190
2012-07-04,2012,July,15,Wednesday,Fall,Clear,454,299,155
2012-07-04,2012,July,16,Wednesday,Fall,Clear,389,226,163
2012-07-04,2012,July,17,Wednesday,Fall,Clear,414,253,161
2012-07-04,2012,July,18,Wednesday,Fall,Clear,430,271,159
2012-07-04,2012,July,19,Wednesday,Fall,Clear,432,255,177
2012-07-04,2012,July,20,Wednesday,Fall,Clear,551,314,237
2012-07-04,2012,July,21,Wednesday,Fall,Clear,584,362,222
2012-07-04,2012,July,22,Wednesday,Fall,Clear,502,327,175
2012-07-04,2012,July,23,Wednesday,Fall,Cloudy,183,152,31
2012-07-05,2012,July,0,Thursday,Fall,Clear,88,71,17
2012-07-05,2012,July,1,Thursday,Fall,Clear,30,24,6
2012-07-05,2012,July,2,Thursday,Fall,Clear,18,14,4
2012-07-05,2012,July,3,Thursday,Fall,Clear,7,5,2
2012-07-05,2012,July,4,Thursday,Fall,Clear,7,7,0
2012-07-05,2012,July,5,Thursday,Fall,Clear,29,28,1
2012-07-05,2012,July,6,Thursday,Fall,Clear,133,130,3
2012-07-05,2012,July,7,Thursday,Fall,Clear,343,316,27
2012-07-05,2012,July,8,Thursday,Fall,Clear,550,514,36
2012-07-05,2012,July,9,Thursday,Fall,Clear,293,246,47
2012-07-05,2012,July,10,Thursday,Fall,Clear,186,117,69
2012-07-05,2012,July,11,Thursday,Fall,Clear,244,137,107
2012-07-05,2012,July,12,Thursday,Fall,Clear,276,188,88
2012-07-05,2012,July,13,Thursday,Fall,Clear,310,181,129
2012-07-05,2012,July,14,Thursday,Fall,Clear,241,154,87
2012-07-05,2012,July,15,Thursday,Fall,Clear,254,183,71
2012-07-05,2012,July,16,Thursday,Fall,Clear,433,324,109
2012-07-05,2012,July,17,Thursday,Fall,Clear,689,575,114
2012-07-05,2012,July,18,Thursday,Fall,Cloudy,607,511,96
2012-07-05,2012,July,19,Thursday,Fall,Cloudy,503,375,128
2012-07-05,2012,July,20,Thursday,Fall,Cloudy,321,243,78
2012-07-05,2012,July,21,Thursday,Fall,Clear,323,232,91
2012-07-05,2012,July,22,Thursday,Fall,Clear,225,162,63
2012-07-05,2012,July,23,Thursday,Fall,Clear,131,99,32
2012-07-06,2012,July,0,Friday,Fall,Clear,102,63,39
2012-07-06,2012,July,1,Friday,Fall,Clear,29,22,7
2012-07-06,2012,July,2,Friday,Fall,Clear,17,13,4
2012-07-06,2012,July,3,Friday,Fall,Cloudy,7,6,1
2012-07-06,2012,July,4,Friday,Fall,Clear,6,4,2
2012-07-06,2012,July,5,Friday,Fall,Clear,35,31,4
2012-07-06,2012,July,6,Friday,Fall,Clear,131,127,4
2012-07-06,2012,July,7,Friday,Fall,Clear,353,333,20
2012-07-06,2012,July,8,Friday,Fall,Clear,585,557,28
2012-07-06,2012,July,9,Friday,Fall,Clear,304,249,55
2012-07-06,2012,July,10,Friday,Fall,Clear,210,130,80
2012-07-06,2012,July,11,Friday,Fall,Clear,233,141,92
2012-07-06,2012,July,12,Friday,Fall,Clear,331,220,111
2012-07-06,2012,July,13,Friday,Fall,Clear,293,194,99
2012-07-06,2012,July,14,Friday,Fall,Clear,275,184,91
2012-07-06,2012,July,15,Friday,Fall,Clear,285,206,79
2012-07-06,2012,July,16,Friday,Fall,Clear,369,300,69
2012-07-06,2012,July,17,Friday,Fall,Clear,576,486,90
2012-07-06,2012,July,18,Friday,Fall,Clear,560,454,106
2012-07-06,2012,July,19,Friday,Fall,Clear,418,306,112
2012-07-06,2012,July,20,Friday,Fall,Clear,336,245,91
2012-07-06,2012,July,21,Friday,Fall,Clear,300,223,77
2012-07-06,2012,July,22,Friday,Fall,Clear,288,210,78
2012-07-06,2012,July,23,Friday,Fall,Clear,164,137,27
2012-07-07,2012,July,0,Saturday,Fall,Clear,150,115,35
2012-07-07,2012,July,1,Saturday,Fall,Clear,71,55,16
2012-07-07,2012,July,2,Saturday,Fall,Clear,58,47,11
2012-07-07,2012,July,3,Saturday,Fall,Clear,31,19,12
2012-07-07,2012,July,4,Saturday,Fall,Clear,16,13,3
2012-07-07,2012,July,5,Saturday,Fall,Clear,14,12,2
2012-07-07,2012,July,6,Saturday,Fall,Clear,31,27,4
2012-07-07,2012,July,7,Saturday,Fall,Clear,71,63,8
2012-07-07,2012,July,8,Saturday,Fall,Clear,152,120,32
2012-07-07,2012,July,9,Saturday,Fall,Clear,256,187,69
2012-07-07,2012,July,10,Saturday,Fall,Clear,325,225,100
2012-07-07,2012,July,11,Saturday,Fall,Clear,367,245,122
2012-07-07,2012,July,12,Saturday,Fall,Clear,342,218,124
2012-07-07,2012,July,13,Saturday,Fall,Cloudy,360,244,116
2012-07-07,2012,July,14,Saturday,Fall,Cloudy,308,203,105
2012-07-07,2012,July,15,Saturday,Fall,Clear,306,193,113
2012-07-07,2012,July,16,Saturday,Fall,Clear,294,192,102
2012-07-07,2012,July,17,Saturday,Fall,Clear,279,176,103
2012-07-07,2012,July,18,Saturday,Fall,Clear,277,194,83
2012-07-07,2012,July,19,Saturday,Fall,Clear,287,219,68
2012-07-07,2012,July,20,Saturday,Fall,Clear,276,197,79
2012-07-07,2012,July,21,Saturday,Fall,Clear,201,150,51
2012-07-07,2012,July,22,Saturday,Fall,Clear,220,164,56
2012-07-07,2012,July,23,Saturday,Fall,Clear,148,114,34
2012-07-08,2012,July,0,Sunday,Fall,Clear,147,125,22
2012-07-08,2012,July,1,Sunday,Fall,Clear,124,99,25
2012-07-08,2012,July,2,Sunday,Fall,Clear,70,59,11
2012-07-08,2012,July,3,Sunday,Fall,Clear,35,34,1
2012-07-08,2012,July,4,Sunday,Fall,Clear,13,11,2
2012-07-08,2012,July,5,Sunday,Fall,Clear,6,5,1
2012-07-08,2012,July,6,Sunday,Fall,Clear,21,16,5
2012-07-08,2012,July,7,Sunday,Fall,Clear,52,33,19
2012-07-08,2012,July,8,Sunday,Fall,Clear,130,95,35
2012-07-08,2012,July,9,Sunday,Fall,Clear,242,172,70
2012-07-08,2012,July,10,Sunday,Fall,Clear,319,234,85
2012-07-08,2012,July,11,Sunday,Fall,Clear,389,269,120
2012-07-08,2012,July,12,Sunday,Fall,Clear,376,271,105
2012-07-08,2012,July,13,Sunday,Fall,Clear,337,219,118
2012-07-08,2012,July,14,Sunday,Fall,Clear,312,235,77
2012-07-08,2012,July,15,Sunday,Fall,Light Snow/Rain,298,218,80
2012-07-08,2012,July,16,Sunday,Fall,Cloudy,291,226,65
2012-07-08,2012,July,17,Sunday,Fall,Clear,270,202,68
2012-07-08,2012,July,18,Sunday,Fall,Clear,253,199,54
2012-07-08,2012,July,19,Sunday,Fall,Clear,250,184,66
2012-07-08,2012,July,20,Sunday,Fall,Clear,285,206,79
2012-07-08,2012,July,21,Sunday,Fall,Clear,207,149,58
2012-07-08,2012,July,22,Sunday,Fall,Light Snow/Rain,122,110,12
2012-07-08,2012,July,23,Sunday,Fall,Light Snow/Rain,123,98,25
2012-07-09,2012,July,0,Monday,Fall,Cloudy,39,33,6
2012-07-09,2012,July,1,Monday,Fall,Light Snow/Rain,18,13,5
2012-07-09,2012,July,2,Monday,Fall,Light Snow/Rain,5,4,1
2012-07-09,2012,July,3,Monday,Fall,Light Snow/Rain,5,5,0
2012-07-09,2012,July,4,Monday,Fall,Light Snow/Rain,2,1,1
2012-07-09,2012,July,5,Monday,Fall,Cloudy,28,27,1
2012-07-09,2012,July,6,Monday,Fall,Light Snow/Rain,92,86,6
2012-07-09,2012,July,7,Monday,Fall,Light Snow/Rain,230,223,7
2012-07-09,2012,July,8,Monday,Fall,Cloudy,455,429,26
2012-07-09,2012,July,9,Monday,Fall,Cloudy,363,325,38
2012-07-09,2012,July,10,Monday,Fall,Cloudy,175,117,58
2012-07-09,2012,July,11,Monday,Fall,Cloudy,216,144,72
2012-07-09,2012,July,12,Monday,Fall,Cloudy,266,205,61
2012-07-09,2012,July,13,Monday,Fall,Cloudy,255,188,67
2012-07-09,2012,July,14,Monday,Fall,Cloudy,242,184,58
2012-07-09,2012,July,15,Monday,Fall,Cloudy,280,214,66
2012-07-09,2012,July,16,Monday,Fall,Clear,413,325,88
2012-07-09,2012,July,17,Monday,Fall,Clear,849,741,108
2012-07-09,2012,July,18,Monday,Fall,Clear,872,790,82
2012-07-09,2012,July,19,Monday,Fall,Clear,631,543,88
2012-07-09,2012,July,20,Monday,Fall,Cloudy,447,378,69
2012-07-09,2012,July,21,Monday,Fall,Cloudy,331,298,33
2012-07-09,2012,July,22,Monday,Fall,Cloudy,224,189,35
2012-07-09,2012,July,23,Monday,Fall,Cloudy,131,109,22
2012-07-10,2012,July,0,Tuesday,Fall,Clear,69,53,16
2012-07-10,2012,July,1,Tuesday,Fall,Clear,15,15,0
2012-07-10,2012,July,2,Tuesday,Fall,Clear,16,15,1
2012-07-10,2012,July,3,Tuesday,Fall,Clear,3,3,0
2012-07-10,2012,July,4,Tuesday,Fall,Clear,4,4,0
2012-07-10,2012,July,5,Tuesday,Fall,Clear,42,39,3
2012-07-10,2012,July,6,Tuesday,Fall,Cloudy,187,183,4
2012-07-10,2012,July,7,Tuesday,Fall,Cloudy,520,489,31
2012-07-10,2012,July,8,Tuesday,Fall,Clear,649,615,34
2012-07-10,2012,July,9,Tuesday,Fall,Clear,331,284,47
2012-07-10,2012,July,10,Tuesday,Fall,Clear,190,134,56
2012-07-10,2012,July,11,Tuesday,Fall,Clear,249,157,92
2012-07-10,2012,July,12,Tuesday,Fall,Clear,272,203,69
2012-07-10,2012,July,13,Tuesday,Fall,Clear,280,203,77
2012-07-10,2012,July,14,Tuesday,Fall,Clear,242,171,71
2012-07-10,2012,July,15,Tuesday,Fall,Clear,265,188,77
2012-07-10,2012,July,16,Tuesday,Fall,Clear,435,346,89
2012-07-10,2012,July,17,Tuesday,Fall,Clear,872,769,103
2012-07-10,2012,July,18,Tuesday,Fall,Light Snow/Rain,819,749,70
2012-07-10,2012,July,19,Tuesday,Fall,Light Snow/Rain,414,359,55
2012-07-10,2012,July,20,Tuesday,Fall,Light Snow/Rain,84,75,9
2012-07-10,2012,July,21,Tuesday,Fall,Light Snow/Rain,90,83,7
2012-07-10,2012,July,22,Tuesday,Fall,Cloudy,139,125,14
2012-07-10,2012,July,23,Tuesday,Fall,Cloudy,103,74,29
2012-07-11,2012,July,0,Wednesday,Fall,Cloudy,44,38,6
2012-07-11,2012,July,1,Wednesday,Fall,Clear,14,11,3
2012-07-11,2012,July,2,Wednesday,Fall,Clear,5,5,0
2012-07-11,2012,July,3,Wednesday,Fall,Clear,5,5,0
2012-07-11,2012,July,4,Wednesday,Fall,Clear,7,6,1
2012-07-11,2012,July,5,Wednesday,Fall,Clear,41,36,5
2012-07-11,2012,July,6,Wednesday,Fall,Clear,185,168,17
2012-07-11,2012,July,7,Wednesday,Fall,Cloudy,497,471,26
2012-07-11,2012,July,8,Wednesday,Fall,Cloudy,674,644,30
2012-07-11,2012,July,9,Wednesday,Fall,Cloudy,328,298,30
2012-07-11,2012,July,10,Wednesday,Fall,Cloudy,195,148,47
2012-07-11,2012,July,11,Wednesday,Fall,Cloudy,229,173,56
2012-07-11,2012,July,12,Wednesday,Fall,Cloudy,292,223,69
2012-07-11,2012,July,13,Wednesday,Fall,Cloudy,273,208,65
2012-07-11,2012,July,14,Wednesday,Fall,Clear,241,175,66
2012-07-11,2012,July,15,Wednesday,Fall,Clear,276,220,56
2012-07-11,2012,July,16,Wednesday,Fall,Clear,411,358,53
2012-07-11,2012,July,17,Wednesday,Fall,Clear,830,740,90
2012-07-11,2012,July,18,Wednesday,Fall,Clear,814,735,79
2012-07-11,2012,July,19,Wednesday,Fall,Clear,633,560,73
2012-07-11,2012,July,20,Wednesday,Fall,Clear,483,410,73
2012-07-11,2012,July,21,Wednesday,Fall,Clear,391,322,69
2012-07-11,2012,July,22,Wednesday,Fall,Clear,244,203,41
2012-07-11,2012,July,23,Wednesday,Fall,Cloudy,152,132,20
2012-07-12,2012,July,0,Thursday,Fall,Cloudy,56,55,1
2012-07-12,2012,July,1,Thursday,Fall,Cloudy,21,21,0
2012-07-12,2012,July,2,Thursday,Fall,Cloudy,9,9,0
2012-07-12,2012,July,3,Thursday,Fall,Clear,10,10,0
2012-07-12,2012,July,4,Thursday,Fall,Clear,5,5,0
2012-07-12,2012,July,5,Thursday,Fall,Clear,44,40,4
2012-07-12,2012,July,6,Thursday,Fall,Clear,178,171,7
2012-07-12,2012,July,7,Thursday,Fall,Clear,512,480,32
2012-07-12,2012,July,8,Thursday,Fall,Clear,702,653,49
2012-07-12,2012,July,9,Thursday,Fall,Clear,327,285,42
2012-07-12,2012,July,10,Thursday,Fall,Clear,214,145,69
2012-07-12,2012,July,11,Thursday,Fall,Clear,215,166,49
2012-07-12,2012,July,12,Thursday,Fall,Clear,292,221,71
2012-07-12,2012,July,13,Thursday,Fall,Clear,277,225,52
2012-07-12,2012,July,14,Thursday,Fall,Clear,209,167,42
2012-07-12,2012,July,15,Thursday,Fall,Clear,271,208,63
2012-07-12,2012,July,16,Thursday,Fall,Clear,439,370,69
2012-07-12,2012,July,17,Thursday,Fall,Clear,795,704,91
2012-07-12,2012,July,18,Thursday,Fall,Clear,825,739,86
2012-07-12,2012,July,19,Thursday,Fall,Clear,629,532,97
2012-07-12,2012,July,20,Thursday,Fall,Clear,514,439,75
2012-07-12,2012,July,21,Thursday,Fall,Clear,373,329,44
2012-07-12,2012,July,22,Thursday,Fall,Clear,318,262,56
2012-07-12,2012,July,23,Thursday,Fall,Cloudy,211,178,33
2012-07-13,2012,July,0,Friday,Fall,Cloudy,95,76,19
2012-07-13,2012,July,1,Friday,Fall,Cloudy,59,42,17
2012-07-13,2012,July,2,Friday,Fall,Cloudy,17,15,2
2012-07-13,2012,July,3,Friday,Fall,Cloudy,9,7,2
2012-07-13,2012,July,4,Friday,Fall,Cloudy,11,11,0
2012-07-13,2012,July,5,Friday,Fall,Cloudy,34,30,4
2012-07-13,2012,July,6,Friday,Fall,Cloudy,127,120,7
2012-07-13,2012,July,7,Friday,Fall,Cloudy,380,353,27
2012-07-13,2012,July,8,Friday,Fall,Cloudy,713,660,53
2012-07-13,2012,July,9,Friday,Fall,Cloudy,414,344,70
2012-07-13,2012,July,10,Friday,Fall,Cloudy,268,190,78
2012-07-13,2012,July,11,Friday,Fall,Cloudy,288,220,68
2012-07-13,2012,July,12,Friday,Fall,Cloudy,379,254,125
2012-07-13,2012,July,13,Friday,Fall,Cloudy,374,274,100
2012-07-13,2012,July,14,Friday,Fall,Cloudy,369,249,120
2012-07-13,2012,July,15,Friday,Fall,Cloudy,353,261,92
2012-07-13,2012,July,16,Friday,Fall,Cloudy,492,381,111
2012-07-13,2012,July,17,Friday,Fall,Cloudy,835,697,138
2012-07-13,2012,July,18,Friday,Fall,Clear,631,523,108
2012-07-13,2012,July,19,Friday,Fall,Clear,488,385,103
2012-07-13,2012,July,20,Friday,Fall,Clear,389,294,95
2012-07-13,2012,July,21,Friday,Fall,Clear,299,223,76
2012-07-13,2012,July,22,Friday,Fall,Clear,263,204,59
2012-07-13,2012,July,23,Friday,Fall,Cloudy,212,175,37
2012-07-14,2012,July,0,Saturday,Fall,Cloudy,191,156,35
2012-07-14,2012,July,1,Saturday,Fall,Cloudy,118,105,13
2012-07-14,2012,July,2,Saturday,Fall,Cloudy,101,91,10
2012-07-14,2012,July,3,Saturday,Fall,Cloudy,40,31,9
2012-07-14,2012,July,4,Saturday,Fall,Light Snow/Rain,9,6,3
2012-07-14,2012,July,5,Saturday,Fall,Cloudy,5,5,0
2012-07-14,2012,July,6,Saturday,Fall,Cloudy,35,29,6
2012-07-14,2012,July,7,Saturday,Fall,Clear,48,41,7
2012-07-14,2012,July,8,Saturday,Fall,Clear,151,118,33
2012-07-14,2012,July,9,Saturday,Fall,Clear,282,200,82
2012-07-14,2012,July,10,Saturday,Fall,Cloudy,401,278,123
2012-07-14,2012,July,11,Saturday,Fall,Cloudy,439,296,143
2012-07-14,2012,July,12,Saturday,Fall,Cloudy,499,318,181
2012-07-14,2012,July,13,Saturday,Fall,Cloudy,591,372,219
2012-07-14,2012,July,14,Saturday,Fall,Clear,632,363,269
2012-07-14,2012,July,15,Saturday,Fall,Clear,560,317,243
2012-07-14,2012,July,16,Saturday,Fall,Cloudy,566,340,226
2012-07-14,2012,July,17,Saturday,Fall,Light Snow/Rain,458,259,199
2012-07-14,2012,July,18,Saturday,Fall,Clear,351,243,108
2012-07-14,2012,July,19,Saturday,Fall,Clear,431,275,156
2012-07-14,2012,July,20,Saturday,Fall,Clear,356,255,101
2012-07-14,2012,July,21,Saturday,Fall,Clear,269,200,69
2012-07-14,2012,July,22,Saturday,Fall,Clear,225,160,65
2012-07-14,2012,July,23,Saturday,Fall,Cloudy,211,156,55
2012-07-15,2012,July,0,Sunday,Fall,Clear,187,147,40
2012-07-15,2012,July,1,Sunday,Fall,Cloudy,168,119,49
2012-07-15,2012,July,2,Sunday,Fall,Cloudy,115,86,29
2012-07-15,2012,July,3,Sunday,Fall,Cloudy,57,42,15
2012-07-15,2012,July,4,Sunday,Fall,Cloudy,19,11,8
2012-07-15,2012,July,5,Sunday,Fall,Clear,9,7,2
2012-07-15,2012,July,6,Sunday,Fall,Clear,15,9,6
2012-07-15,2012,July,7,Sunday,Fall,Clear,47,30,17
2012-07-15,2012,July,8,Sunday,Fall,Cloudy,133,96,37
2012-07-15,2012,July,9,Sunday,Fall,Cloudy,221,163,58
2012-07-15,2012,July,10,Sunday,Fall,Clear,382,241,141
2012-07-15,2012,July,11,Sunday,Fall,Clear,451,281,170
2012-07-15,2012,July,12,Sunday,Fall,Clear,489,336,153
2012-07-15,2012,July,13,Sunday,Fall,Clear,480,309,171
2012-07-15,2012,July,14,Sunday,Fall,Clear,476,314,162
2012-07-15,2012,July,15,Sunday,Fall,Clear,489,307,182
2012-07-15,2012,July,16,Sunday,Fall,Clear,495,343,152
2012-07-15,2012,July,17,Sunday,Fall,Clear,436,314,122
2012-07-15,2012,July,18,Sunday,Fall,Light Snow/Rain,312,228,84
2012-07-15,2012,July,19,Sunday,Fall,Clear,312,203,109
2012-07-15,2012,July,20,Sunday,Fall,Clear,294,199,95
2012-07-15,2012,July,21,Sunday,Fall,Clear,223,164,59
2012-07-15,2012,July,22,Sunday,Fall,Clear,130,96,34
2012-07-15,2012,July,23,Sunday,Fall,Clear,91,66,25
2012-07-16,2012,July,0,Monday,Fall,Light Snow/Rain,43,32,11
2012-07-16,2012,July,1,Monday,Fall,Cloudy,11,10,1
2012-07-16,2012,July,2,Monday,Fall,Clear,15,11,4
2012-07-16,2012,July,3,Monday,Fall,Clear,6,4,2
2012-07-16,2012,July,4,Monday,Fall,Clear,12,11,1
2012-07-16,2012,July,5,Monday,Fall,Clear,50,40,10
2012-07-16,2012,July,6,Monday,Fall,Clear,140,132,8
2012-07-16,2012,July,7,Monday,Fall,Clear,483,459,24
2012-07-16,2012,July,8,Monday,Fall,Clear,667,619,48
2012-07-16,2012,July,9,Monday,Fall,Clear,348,297,51
2012-07-16,2012,July,10,Monday,Fall,Clear,186,117,69
2012-07-16,2012,July,11,Monday,Fall,Clear,182,125,57
2012-07-16,2012,July,12,Monday,Fall,Clear,237,158,79
2012-07-16,2012,July,13,Monday,Fall,Clear,239,176,63
2012-07-16,2012,July,14,Monday,Fall,Clear,212,159,53
2012-07-16,2012,July,15,Monday,Fall,Clear,237,176,61
2012-07-16,2012,July,16,Monday,Fall,Light Snow/Rain,386,309,77
2012-07-16,2012,July,17,Monday,Fall,Light Snow/Rain,755,669,86
2012-07-16,2012,July,18,Monday,Fall,Clear,794,697,97
2012-07-16,2012,July,19,Monday,Fall,Clear,595,503,92
2012-07-16,2012,July,20,Monday,Fall,Clear,454,388,66
2012-07-16,2012,July,21,Monday,Fall,Clear,328,283,45
2012-07-16,2012,July,22,Monday,Fall,Clear,284,228,56
2012-07-16,2012,July,23,Monday,Fall,Clear,166,139,27
2012-07-17,2012,July,0,Tuesday,Fall,Clear,53,43,10
2012-07-17,2012,July,1,Tuesday,Fall,Clear,25,21,4
2012-07-17,2012,July,2,Tuesday,Fall,Clear,7,6,1
2012-07-17,2012,July,3,Tuesday,Fall,Clear,3,3,0
2012-07-17,2012,July,4,Tuesday,Fall,Clear,7,7,0
2012-07-17,2012,July,5,Tuesday,Fall,Clear,38,31,7
2012-07-17,2012,July,6,Tuesday,Fall,Clear,213,197,16
2012-07-17,2012,July,7,Tuesday,Fall,Cloudy,526,500,26
2012-07-17,2012,July,8,Tuesday,Fall,Cloudy,661,618,43
2012-07-17,2012,July,9,Tuesday,Fall,Cloudy,320,288,32
2012-07-17,2012,July,10,Tuesday,Fall,Cloudy,159,122,37
2012-07-17,2012,July,11,Tuesday,Fall,Cloudy,206,146,60
2012-07-17,2012,July,12,Tuesday,Fall,Cloudy,254,174,80
2012-07-17,2012,July,13,Tuesday,Fall,Clear,221,168,53
2012-07-17,2012,July,14,Tuesday,Fall,Clear,214,160,54
2012-07-17,2012,July,15,Tuesday,Fall,Clear,244,187,57
2012-07-17,2012,July,16,Tuesday,Fall,Clear,381,317,64
2012-07-17,2012,July,17,Tuesday,Fall,Clear,770,675,95
2012-07-17,2012,July,18,Tuesday,Fall,Clear,772,712,60
2012-07-17,2012,July,19,Tuesday,Fall,Clear,547,478,69
2012-07-17,2012,July,20,Tuesday,Fall,Clear,427,375,52
2012-07-17,2012,July,21,Tuesday,Fall,Clear,333,283,50
2012-07-17,2012,July,22,Tuesday,Fall,Clear,244,215,29
2012-07-17,2012,July,23,Tuesday,Fall,Clear,161,139,22
2012-07-18,2012,July,0,Wednesday,Fall,Clear,53,45,8
2012-07-18,2012,July,1,Wednesday,Fall,Clear,16,14,2
2012-07-18,2012,July,2,Wednesday,Fall,Clear,8,5,3
2012-07-18,2012,July,3,Wednesday,Fall,Clear,4,2,2
2012-07-18,2012,July,4,Wednesday,Fall,Clear,6,6,0
2012-07-18,2012,July,5,Wednesday,Fall,Clear,46,41,5
2012-07-18,2012,July,6,Wednesday,Fall,Clear,162,152,10
2012-07-18,2012,July,7,Wednesday,Fall,Clear,495,472,23
2012-07-18,2012,July,8,Wednesday,Fall,Clear,679,624,55
2012-07-18,2012,July,9,Wednesday,Fall,Clear,297,253,44
2012-07-18,2012,July,10,Wednesday,Fall,Clear,138,99,39
2012-07-18,2012,July,11,Wednesday,Fall,Clear,183,136,47
2012-07-18,2012,July,12,Wednesday,Fall,Clear,202,166,36
2012-07-18,2012,July,13,Wednesday,Fall,Clear,203,154,49
2012-07-18,2012,July,14,Wednesday,Fall,Clear,170,116,54
2012-07-18,2012,July,15,Wednesday,Fall,Light Snow/Rain,194,152,42
2012-07-18,2012,July,16,Wednesday,Fall,Clear,224,190,34
2012-07-18,2012,July,17,Wednesday,Fall,Clear,370,335,35
2012-07-18,2012,July,18,Wednesday,Fall,Cloudy,643,580,63
2012-07-18,2012,July,19,Wednesday,Fall,Cloudy,516,438,78
2012-07-18,2012,July,20,Wednesday,Fall,Clear,366,310,56
2012-07-18,2012,July,21,Wednesday,Fall,Clear,319,266,53
2012-07-18,2012,July,22,Wednesday,Fall,Clear,288,246,42
2012-07-18,2012,July,23,Wednesday,Fall,Clear,131,112,19
2012-07-19,2012,July,0,Thursday,Fall,Clear,66,50,16
2012-07-19,2012,July,1,Thursday,Fall,Clear,25,19,6
2012-07-19,2012,July,2,Thursday,Fall,Clear,7,7,0
2012-07-19,2012,July,3,Thursday,Fall,Clear,5,4,1
2012-07-19,2012,July,4,Thursday,Fall,Clear,8,8,0
2012-07-19,2012,July,5,Thursday,Fall,Cloudy,40,35,5
2012-07-19,2012,July,6,Thursday,Fall,Clear,152,144,8
2012-07-19,2012,July,7,Thursday,Fall,Clear,473,450,23
2012-07-19,2012,July,8,Thursday,Fall,Clear,657,625,32
2012-07-19,2012,July,9,Thursday,Fall,Cloudy,318,282,36
2012-07-19,2012,July,10,Thursday,Fall,Clear,198,157,41
2012-07-19,2012,July,11,Thursday,Fall,Clear,216,162,54
2012-07-19,2012,July,12,Thursday,Fall,Clear,274,215,59
2012-07-19,2012,July,13,Thursday,Fall,Clear,254,180,74
2012-07-19,2012,July,14,Thursday,Fall,Clear,197,151,46
2012-07-19,2012,July,15,Thursday,Fall,Clear,292,226,66
2012-07-19,2012,July,16,Thursday,Fall,Clear,358,288,70
2012-07-19,2012,July,17,Thursday,Fall,Clear,771,678,93
2012-07-19,2012,July,18,Thursday,Fall,Clear,777,684,93
2012-07-19,2012,July,19,Thursday,Fall,Clear,533,480,53
2012-07-19,2012,July,20,Thursday,Fall,Clear,505,440,65
2012-07-19,2012,July,21,Thursday,Fall,Light Snow/Rain,332,294,38
2012-07-19,2012,July,22,Thursday,Fall,Light Snow/Rain,68,62,6
2012-07-19,2012,July,23,Thursday,Fall,Light Snow/Rain,65,62,3
2012-07-20,2012,July,0,Friday,Fall,Light Snow/Rain,34,32,2
2012-07-20,2012,July,1,Friday,Fall,Clear,11,9,2
2012-07-20,2012,July,2,Friday,Fall,Cloudy,19,14,5
2012-07-20,2012,July,3,Friday,Fall,Cloudy,36,29,7
2012-07-20,2012,July,4,Friday,Fall,Cloudy,9,6,3
2012-07-20,2012,July,5,Friday,Fall,Cloudy,42,40,2
2012-07-20,2012,July,6,Friday,Fall,Cloudy,126,123,3
2012-07-20,2012,July,7,Friday,Fall,Cloudy,360,346,14
2012-07-20,2012,July,8,Friday,Fall,Cloudy,691,652,39
2012-07-20,2012,July,9,Friday,Fall,Cloudy,373,328,45
2012-07-20,2012,July,10,Friday,Fall,Cloudy,233,182,51
2012-07-20,2012,July,11,Friday,Fall,Light Snow/Rain,212,161,51
2012-07-20,2012,July,12,Friday,Fall,Light Snow/Rain,274,233,41
2012-07-20,2012,July,13,Friday,Fall,Light Snow/Rain,156,136,20
2012-07-20,2012,July,14,Friday,Fall,Light Snow/Rain,229,176,53
2012-07-20,2012,July,15,Friday,Fall,Cloudy,216,169,47
2012-07-20,2012,July,16,Friday,Fall,Cloudy,436,366,70
2012-07-20,2012,July,17,Friday,Fall,Cloudy,715,620,95
2012-07-20,2012,July,18,Friday,Fall,Cloudy,622,549,73
2012-07-20,2012,July,19,Friday,Fall,Cloudy,402,358,44
2012-07-20,2012,July,20,Friday,Fall,Light Snow/Rain,251,216,35
2012-07-20,2012,July,21,Friday,Fall,Light Snow/Rain,122,108,14
2012-07-20,2012,July,22,Friday,Fall,Cloudy,135,122,13
2012-07-20,2012,July,23,Friday,Fall,Cloudy,166,148,18
2012-07-21,2012,July,0,Saturday,Fall,Light Snow/Rain,103,92,11
2012-07-21,2012,July,1,Saturday,Fall,Cloudy,72,62,10
2012-07-21,2012,July,2,Saturday,Fall,Light Snow/Rain,60,55,5
2012-07-21,2012,July,3,Saturday,Fall,Light Snow/Rain,25,18,7
2012-07-21,2012,July,4,Saturday,Fall,Light Snow/Rain,16,5,11
2012-07-21,2012,July,5,Saturday,Fall,Light Snow/Rain,17,10,7
2012-07-21,2012,July,6,Saturday,Fall,Light Snow/Rain,15,12,3
2012-07-21,2012,July,7,Saturday,Fall,Cloudy,37,29,8
2012-07-21,2012,July,8,Saturday,Fall,Cloudy,112,94,18
2012-07-21,2012,July,9,Saturday,Fall,Cloudy,207,175,32
2012-07-21,2012,July,10,Saturday,Fall,Light Snow/Rain,268,219,49
2012-07-21,2012,July,11,Saturday,Fall,Cloudy,305,225,80
2012-07-21,2012,July,12,Saturday,Fall,Light Snow/Rain,457,301,156
2012-07-21,2012,July,13,Saturday,Fall,Light Snow/Rain,354,248,106
2012-07-21,2012,July,14,Saturday,Fall,Cloudy,343,222,121
2012-07-21,2012,July,15,Saturday,Fall,Light Snow/Rain,380,232,148
2012-07-21,2012,July,16,Saturday,Fall,Light Snow/Rain,326,196,130
2012-07-21,2012,July,17,Saturday,Fall,Light Snow/Rain,241,149,92
2012-07-21,2012,July,18,Saturday,Fall,Cloudy,177,126,51
2012-07-21,2012,July,19,Saturday,Fall,Cloudy,238,171,67
2012-07-21,2012,July,20,Saturday,Fall,Light Snow/Rain,214,163,51
2012-07-21,2012,July,21,Saturday,Fall,Cloudy,163,134,29
2012-07-21,2012,July,22,Saturday,Fall,Cloudy,180,140,40
2012-07-21,2012,July,23,Saturday,Fall,Cloudy,149,117,32
2012-07-22,2012,July,0,Sunday,Fall,Cloudy,113,96,17
2012-07-22,2012,July,1,Sunday,Fall,Cloudy,130,99,31
2012-07-22,2012,July,2,Sunday,Fall,Cloudy,122,90,32
2012-07-22,2012,July,3,Sunday,Fall,Cloudy,43,30,13
2012-07-22,2012,July,4,Sunday,Fall,Clear,16,10,6
2012-07-22,2012,July,5,Sunday,Fall,Clear,6,6,0
2012-07-22,2012,July,6,Sunday,Fall,Cloudy,19,14,5
2012-07-22,2012,July,7,Sunday,Fall,Cloudy,38,25,13
2012-07-22,2012,July,8,Sunday,Fall,Cloudy,153,122,31
2012-07-22,2012,July,9,Sunday,Fall,Cloudy,258,179,79
2012-07-22,2012,July,10,Sunday,Fall,Cloudy,379,265,114
2012-07-22,2012,July,11,Sunday,Fall,Cloudy,505,314,191
2012-07-22,2012,July,12,Sunday,Fall,Cloudy,504,326,178
2012-07-22,2012,July,13,Sunday,Fall,Cloudy,626,388,238
2012-07-22,2012,July,14,Sunday,Fall,Clear,616,360,256
2012-07-22,2012,July,15,Sunday,Fall,Clear,624,370,254
2012-07-22,2012,July,16,Sunday,Fall,Clear,628,383,245
2012-07-22,2012,July,17,Sunday,Fall,Clear,556,368,188
2012-07-22,2012,July,18,Sunday,Fall,Clear,515,342,173
2012-07-22,2012,July,19,Sunday,Fall,Clear,522,342,180
2012-07-22,2012,July,20,Sunday,Fall,Clear,378,254,124
2012-07-22,2012,July,21,Sunday,Fall,Clear,345,257,88
2012-07-22,2012,July,22,Sunday,Fall,Clear,191,136,55
2012-07-22,2012,July,23,Sunday,Fall,Clear,123,90,33
2012-07-23,2012,July,0,Monday,Fall,Clear,47,36,11
2012-07-23,2012,July,1,Monday,Fall,Clear,27,20,7
2012-07-23,2012,July,2,Monday,Fall,Cloudy,17,14,3
2012-07-23,2012,July,3,Monday,Fall,Cloudy,2,2,0
2012-07-23,2012,July,4,Monday,Fall,Cloudy,8,8,0
2012-07-23,2012,July,5,Monday,Fall,Cloudy,51,48,3
2012-07-23,2012,July,6,Monday,Fall,Cloudy,157,148,9
2012-07-23,2012,July,7,Monday,Fall,Clear,421,404,17
2012-07-23,2012,July,8,Monday,Fall,Clear,738,691,47
2012-07-23,2012,July,9,Monday,Fall,Cloudy,345,288,57
2012-07-23,2012,July,10,Monday,Fall,Cloudy,200,137,63
2012-07-23,2012,July,11,Monday,Fall,Cloudy,198,129,69
2012-07-23,2012,July,12,Monday,Fall,Cloudy,314,205,109
2012-07-23,2012,July,13,Monday,Fall,Cloudy,240,176,64
2012-07-23,2012,July,14,Monday,Fall,Cloudy,271,189,82
2012-07-23,2012,July,15,Monday,Fall,Clear,281,205,76
2012-07-23,2012,July,16,Monday,Fall,Clear,457,346,111
2012-07-23,2012,July,17,Monday,Fall,Clear,847,760,87
2012-07-23,2012,July,18,Monday,Fall,Clear,741,672,69
2012-07-23,2012,July,19,Monday,Fall,Clear,582,488,94
2012-07-23,2012,July,20,Monday,Fall,Clear,403,347,56
2012-07-23,2012,July,21,Monday,Fall,Clear,296,251,45
2012-07-23,2012,July,22,Monday,Fall,Clear,209,169,40
2012-07-23,2012,July,23,Monday,Fall,Clear,114,98,16
2012-07-24,2012,July,0,Tuesday,Fall,Clear,64,52,12
2012-07-24,2012,July,1,Tuesday,Fall,Clear,17,10,7
2012-07-24,2012,July,2,Tuesday,Fall,Clear,16,10,6
2012-07-24,2012,July,3,Tuesday,Fall,Clear,6,5,1
2012-07-24,2012,July,4,Tuesday,Fall,Clear,6,6,0
2012-07-24,2012,July,5,Tuesday,Fall,Clear,50,45,5
2012-07-24,2012,July,6,Tuesday,Fall,Clear,190,173,17
2012-07-24,2012,July,7,Tuesday,Fall,Clear,516,492,24
2012-07-24,2012,July,8,Tuesday,Fall,Clear,743,694,49
2012-07-24,2012,July,9,Tuesday,Fall,Clear,339,299,40
2012-07-24,2012,July,10,Tuesday,Fall,Clear,218,156,62
2012-07-24,2012,July,11,Tuesday,Fall,Cloudy,201,156,45
2012-07-24,2012,July,12,Tuesday,Fall,Cloudy,229,169,60
2012-07-24,2012,July,13,Tuesday,Fall,Cloudy,273,200,73
2012-07-24,2012,July,14,Tuesday,Fall,Cloudy,244,196,48
2012-07-24,2012,July,15,Tuesday,Fall,Clear,285,212,73
2012-07-24,2012,July,16,Tuesday,Fall,Clear,455,369,86
2012-07-24,2012,July,17,Tuesday,Fall,Clear,869,775,94
2012-07-24,2012,July,18,Tuesday,Fall,Clear,877,767,110
2012-07-24,2012,July,19,Tuesday,Fall,Clear,632,523,109
2012-07-24,2012,July,20,Tuesday,Fall,Clear,523,438,85
2012-07-24,2012,July,21,Tuesday,Fall,Clear,378,325,53
2012-07-24,2012,July,22,Tuesday,Fall,Clear,269,226,43
2012-07-24,2012,July,23,Tuesday,Fall,Clear,192,154,38
2012-07-25,2012,July,0,Wednesday,Fall,Clear,66,57,9
2012-07-25,2012,July,1,Wednesday,Fall,Clear,28,26,2
2012-07-25,2012,July,2,Wednesday,Fall,Clear,12,11,1
2012-07-25,2012,July,3,Wednesday,Fall,Clear,12,11,1
2012-07-25,2012,July,4,Wednesday,Fall,Clear,4,4,0
2012-07-25,2012,July,5,Wednesday,Fall,Clear,59,54,5
2012-07-25,2012,July,6,Wednesday,Fall,Clear,190,179,11
2012-07-25,2012,July,7,Wednesday,Fall,Clear,507,473,34
2012-07-25,2012,July,8,Wednesday,Fall,Clear,788,745,43
2012-07-25,2012,July,9,Wednesday,Fall,Clear,342,277,65
2012-07-25,2012,July,10,Wednesday,Fall,Clear,231,163,68
2012-07-25,2012,July,11,Wednesday,Fall,Clear,281,202,79
2012-07-25,2012,July,12,Wednesday,Fall,Clear,310,233,77
2012-07-25,2012,July,13,Wednesday,Fall,Clear,312,231,81
2012-07-25,2012,July,14,Wednesday,Fall,Clear,247,159,88
2012-07-25,2012,July,15,Wednesday,Fall,Clear,317,223,94
2012-07-25,2012,July,16,Wednesday,Fall,Clear,484,393,91
2012-07-25,2012,July,17,Wednesday,Fall,Clear,913,783,130
2012-07-25,2012,July,18,Wednesday,Fall,Clear,891,787,104
2012-07-25,2012,July,19,Wednesday,Fall,Clear,698,582,116
2012-07-25,2012,July,20,Wednesday,Fall,Clear,567,461,106
2012-07-25,2012,July,21,Wednesday,Fall,Clear,397,326,71
2012-07-25,2012,July,22,Wednesday,Fall,Clear,278,223,55
2012-07-25,2012,July,23,Wednesday,Fall,Clear,239,187,52
2012-07-26,2012,July,0,Thursday,Fall,Clear,92,65,27
2012-07-26,2012,July,1,Thursday,Fall,Clear,29,23,6
2012-07-26,2012,July,2,Thursday,Fall,Clear,21,16,5
2012-07-26,2012,July,3,Thursday,Fall,Clear,8,8,0
2012-07-26,2012,July,4,Thursday,Fall,Clear,4,4,0
2012-07-26,2012,July,5,Thursday,Fall,Clear,42,40,2
2012-07-26,2012,July,6,Thursday,Fall,Clear,181,165,16
2012-07-26,2012,July,7,Thursday,Fall,Clear,495,478,17
2012-07-26,2012,July,8,Thursday,Fall,Cloudy,729,680,49
2012-07-26,2012,July,9,Thursday,Fall,Cloudy,344,289,55
2012-07-26,2012,July,10,Thursday,Fall,Clear,222,143,79
2012-07-26,2012,July,11,Thursday,Fall,Clear,212,143,69
2012-07-26,2012,July,12,Thursday,Fall,Clear,279,206,73
2012-07-26,2012,July,13,Thursday,Fall,Clear,242,189,53
2012-07-26,2012,July,14,Thursday,Fall,Clear,213,151,62
2012-07-26,2012,July,15,Thursday,Fall,Clear,238,173,65
2012-07-26,2012,July,16,Thursday,Fall,Clear,374,312,62
2012-07-26,2012,July,17,Thursday,Fall,Clear,738,628,110
2012-07-26,2012,July,18,Thursday,Fall,Clear,688,615,73
2012-07-26,2012,July,19,Thursday,Fall,Clear,614,534,80
2012-07-26,2012,July,20,Thursday,Fall,Clear,446,399,47
2012-07-26,2012,July,21,Thursday,Fall,Clear,271,236,35
2012-07-26,2012,July,22,Thursday,Fall,Clear,234,201,33
2012-07-26,2012,July,23,Thursday,Fall,Clear,145,127,18
2012-07-27,2012,July,0,Friday,Fall,Clear,97,83,14
2012-07-27,2012,July,1,Friday,Fall,Clear,54,42,12
2012-07-27,2012,July,2,Friday,Fall,Clear,26,18,8
2012-07-27,2012,July,3,Friday,Fall,Clear,12,9,3
2012-07-27,2012,July,4,Friday,Fall,Clear,8,5,3
2012-07-27,2012,July,5,Friday,Fall,Clear,37,34,3
2012-07-27,2012,July,6,Friday,Fall,Clear,139,129,10
2012-07-27,2012,July,7,Friday,Fall,Clear,410,397,13
2012-07-27,2012,July,8,Friday,Fall,Clear,676,642,34
2012-07-27,2012,July,9,Friday,Fall,Clear,363,329,34
2012-07-27,2012,July,10,Friday,Fall,Clear,231,146,85
2012-07-27,2012,July,11,Friday,Fall,Clear,251,184,67
2012-07-27,2012,July,12,Friday,Fall,Clear,299,207,92
2012-07-27,2012,July,13,Friday,Fall,Clear,314,231,83
2012-07-27,2012,July,14,Friday,Fall,Clear,326,221,105
2012-07-27,2012,July,15,Friday,Fall,Clear,323,242,81
2012-07-27,2012,July,16,Friday,Fall,Clear,499,419,80
2012-07-27,2012,July,17,Friday,Fall,Clear,699,598,101
2012-07-27,2012,July,18,Friday,Fall,Clear,622,522,100
2012-07-27,2012,July,19,Friday,Fall,Clear,516,423,93
2012-07-27,2012,July,20,Friday,Fall,Clear,354,269,85
2012-07-27,2012,July,21,Friday,Fall,Clear,260,189,71
2012-07-27,2012,July,22,Friday,Fall,Clear,199,151,48
2012-07-27,2012,July,23,Friday,Fall,Clear,189,155,34
2012-07-28,2012,July,0,Saturday,Fall,Clear,191,170,21
2012-07-28,2012,July,1,Saturday,Fall,Clear,80,69,11
2012-07-28,2012,July,2,Saturday,Fall,Clear,90,76,14
2012-07-28,2012,July,3,Saturday,Fall,Clear,43,33,10
2012-07-28,2012,July,4,Saturday,Fall,Clear,11,10,1
2012-07-28,2012,July,5,Saturday,Fall,Clear,14,10,4
2012-07-28,2012,July,6,Saturday,Fall,Clear,50,40,10
2012-07-28,2012,July,7,Saturday,Fall,Clear,76,58,18
2012-07-28,2012,July,8,Saturday,Fall,Clear,163,127,36
2012-07-28,2012,July,9,Saturday,Fall,Clear,337,227,110
2012-07-28,2012,July,10,Saturday,Fall,Clear,395,266,129
2012-07-28,2012,July,11,Saturday,Fall,Clear,457,295,162
2012-07-28,2012,July,12,Saturday,Fall,Clear,487,330,157
2012-07-28,2012,July,13,Saturday,Fall,Clear,498,325,173
2012-07-28,2012,July,14,Saturday,Fall,Clear,494,308,186
2012-07-28,2012,July,15,Saturday,Fall,Clear,497,291,206
2012-07-28,2012,July,16,Saturday,Fall,Clear,487,279,208
2012-07-28,2012,July,17,Saturday,Fall,Clear,479,280,199
2012-07-28,2012,July,18,Saturday,Fall,Clear,481,330,151
2012-07-28,2012,July,19,Saturday,Fall,Clear,338,223,115
2012-07-28,2012,July,20,Saturday,Fall,Clear,233,154,79
2012-07-28,2012,July,21,Saturday,Fall,Clear,300,206,94
2012-07-28,2012,July,22,Saturday,Fall,Clear,276,188,88
2012-07-28,2012,July,23,Saturday,Fall,Clear,208,156,52
2012-07-29,2012,July,0,Sunday,Fall,Clear,188,129,59
2012-07-29,2012,July,1,Sunday,Fall,Clear,158,109,49
2012-07-29,2012,July,2,Sunday,Fall,Clear,112,79,33
2012-07-29,2012,July,3,Sunday,Fall,Clear,55,37,18
2012-07-29,2012,July,4,Sunday,Fall,Clear,13,11,2
2012-07-29,2012,July,5,Sunday,Fall,Clear,17,14,3
2012-07-29,2012,July,6,Sunday,Fall,Clear,18,12,6
2012-07-29,2012,July,7,Sunday,Fall,Clear,40,36,4
2012-07-29,2012,July,8,Sunday,Fall,Clear,127,90,37
2012-07-29,2012,July,9,Sunday,Fall,Clear,226,162,64
2012-07-29,2012,July,10,Sunday,Fall,Clear,381,258,123
2012-07-29,2012,July,11,Sunday,Fall,Clear,509,326,183
2012-07-29,2012,July,12,Sunday,Fall,Clear,511,357,154
2012-07-29,2012,July,13,Sunday,Fall,Clear,483,302,181
2012-07-29,2012,July,14,Sunday,Fall,Clear,522,291,231
2012-07-29,2012,July,15,Sunday,Fall,Clear,501,306,195
2012-07-29,2012,July,16,Sunday,Fall,Clear,521,330,191
2012-07-29,2012,July,17,Sunday,Fall,Clear,531,367,164
2012-07-29,2012,July,18,Sunday,Fall,Clear,419,302,117
2012-07-29,2012,July,19,Sunday,Fall,Clear,443,300,143
2012-07-29,2012,July,20,Sunday,Fall,Clear,303,228,75
2012-07-29,2012,July,21,Sunday,Fall,Clear,271,199,72
2012-07-29,2012,July,22,Sunday,Fall,Clear,148,117,31
2012-07-29,2012,July,23,Sunday,Fall,Clear,100,82,18
2012-07-30,2012,July,0,Monday,Fall,Clear,58,46,12
2012-07-30,2012,July,1,Monday,Fall,Clear,19,15,4
2012-07-30,2012,July,2,Monday,Fall,Clear,8,6,2
2012-07-30,2012,July,3,Monday,Fall,Clear,3,3,0
2012-07-30,2012,July,4,Monday,Fall,Clear,5,5,0
2012-07-30,2012,July,5,Monday,Fall,Clear,47,43,4
2012-07-30,2012,July,6,Monday,Fall,Clear,161,155,6
2012-07-30,2012,July,7,Monday,Fall,Clear,469,455,14
2012-07-30,2012,July,8,Monday,Fall,Cloudy,751,720,31
2012-07-30,2012,July,9,Monday,Fall,Cloudy,293,259,34
2012-07-30,2012,July,10,Monday,Fall,Cloudy,189,135,54
2012-07-30,2012,July,11,Monday,Fall,Cloudy,215,146,69
2012-07-30,2012,July,12,Monday,Fall,Cloudy,278,201,77
2012-07-30,2012,July,13,Monday,Fall,Clear,226,169,57
2012-07-30,2012,July,14,Monday,Fall,Clear,254,167,87
2012-07-30,2012,July,15,Monday,Fall,Clear,236,185,51
2012-07-30,2012,July,16,Monday,Fall,Clear,425,337,88
2012-07-30,2012,July,17,Monday,Fall,Clear,827,765,62
2012-07-30,2012,July,18,Monday,Fall,Clear,812,735,77
2012-07-30,2012,July,19,Monday,Fall,Clear,665,584,81
2012-07-30,2012,July,20,Monday,Fall,Clear,462,384,78
2012-07-30,2012,July,21,Monday,Fall,Clear,322,251,71
2012-07-30,2012,July,22,Monday,Fall,Cloudy,230,183,47
2012-07-30,2012,July,23,Monday,Fall,Clear,150,116,34
2012-07-31,2012,July,0,Tuesday,Fall,Clear,38,27,11
2012-07-31,2012,July,1,Tuesday,Fall,Clear,21,18,3
2012-07-31,2012,July,2,Tuesday,Fall,Clear,8,8,0
2012-07-31,2012,July,3,Tuesday,Fall,Clear,6,5,1
2012-07-31,2012,July,4,Tuesday,Fall,Clear,6,6,0
2012-07-31,2012,July,5,Tuesday,Fall,Clear,45,40,5
2012-07-31,2012,July,6,Tuesday,Fall,Clear,194,192,2
2012-07-31,2012,July,7,Tuesday,Fall,Clear,513,492,21
2012-07-31,2012,July,8,Tuesday,Fall,Clear,760,730,30
2012-07-31,2012,July,9,Tuesday,Fall,Clear,333,302,31
2012-07-31,2012,July,10,Tuesday,Fall,Clear,227,154,73
2012-07-31,2012,July,11,Tuesday,Fall,Clear,224,170,54
2012-07-31,2012,July,12,Tuesday,Fall,Clear,248,198,50
2012-07-31,2012,July,13,Tuesday,Fall,Clear,288,219,69
2012-07-31,2012,July,14,Tuesday,Fall,Clear,260,188,72
2012-07-31,2012,July,15,Tuesday,Fall,Clear,144,115,29
2012-07-31,2012,July,16,Tuesday,Fall,Clear,402,336,66
2012-07-31,2012,July,17,Tuesday,Fall,Clear,820,726,94
2012-07-31,2012,July,18,Tuesday,Fall,Clear,857,758,99
2012-07-31,2012,July,19,Tuesday,Fall,Light Snow/Rain,614,524,90
2012-07-31,2012,July,20,Tuesday,Fall,Light Snow/Rain,452,397,55
2012-07-31,2012,July,21,Tuesday,Fall,Clear,352,292,60
2012-07-31,2012,July,22,Tuesday,Fall,Clear,257,224,33
2012-07-31,2012,July,23,Tuesday,Fall,Cloudy,147,127,20
2012-08-01,2012,August,0,Wednesday,Fall,Clear,47,44,3
2012-08-01,2012,August,1,Wednesday,Fall,Clear,33,28,5
2012-08-01,2012,August,2,Wednesday,Fall,Clear,13,13,0
2012-08-01,2012,August,3,Wednesday,Fall,Clear,7,7,0
2012-08-01,2012,August,4,Wednesday,Fall,Cloudy,4,3,1
2012-08-01,2012,August,5,Wednesday,Fall,Cloudy,49,46,3
2012-08-01,2012,August,6,Wednesday,Fall,Clear,185,179,6
2012-08-01,2012,August,7,Wednesday,Fall,Cloudy,487,468,19
2012-08-01,2012,August,8,Wednesday,Fall,Cloudy,681,649,32
2012-08-01,2012,August,9,Wednesday,Fall,Cloudy,350,316,34
2012-08-01,2012,August,10,Wednesday,Fall,Clear,236,175,61
2012-08-01,2012,August,11,Wednesday,Fall,Clear,234,180,54
2012-08-01,2012,August,12,Wednesday,Fall,Clear,284,209,75
2012-08-01,2012,August,13,Wednesday,Fall,Clear,280,221,59
2012-08-01,2012,August,14,Wednesday,Fall,Clear,263,175,88
2012-08-01,2012,August,15,Wednesday,Fall,Clear,295,206,89
2012-08-01,2012,August,16,Wednesday,Fall,Clear,479,386,93
2012-08-01,2012,August,17,Wednesday,Fall,Clear,837,734,103
2012-08-01,2012,August,18,Wednesday,Fall,Light Snow/Rain,891,786,105
2012-08-01,2012,August,19,Wednesday,Fall,Clear,652,564,88
2012-08-01,2012,August,20,Wednesday,Fall,Clear,513,448,65
2012-08-01,2012,August,21,Wednesday,Fall,Clear,320,284,36
2012-08-01,2012,August,22,Wednesday,Fall,Clear,288,251,37
2012-08-01,2012,August,23,Wednesday,Fall,Clear,152,134,18
2012-08-02,2012,August,0,Thursday,Fall,Clear,63,55,8
2012-08-02,2012,August,1,Thursday,Fall,Clear,42,36,6
2012-08-02,2012,August,2,Thursday,Fall,Clear,11,8,3
2012-08-02,2012,August,3,Thursday,Fall,Clear,6,6,0
2012-08-02,2012,August,4,Thursday,Fall,Clear,9,9,0
2012-08-02,2012,August,5,Thursday,Fall,Clear,41,37,4
2012-08-02,2012,August,6,Thursday,Fall,Clear,183,177,6
2012-08-02,2012,August,7,Thursday,Fall,Clear,473,452,21
2012-08-02,2012,August,8,Thursday,Fall,Clear,739,718,21
2012-08-02,2012,August,9,Thursday,Fall,Clear,343,312,31
2012-08-02,2012,August,10,Thursday,Fall,Clear,181,130,51
2012-08-02,2012,August,11,Thursday,Fall,Clear,226,167,59
2012-08-02,2012,August,12,Thursday,Fall,Clear,286,230,56
2012-08-02,2012,August,13,Thursday,Fall,Clear,310,212,98
2012-08-02,2012,August,14,Thursday,Fall,Clear,225,171,54
2012-08-02,2012,August,15,Thursday,Fall,Clear,270,202,68
2012-08-02,2012,August,16,Thursday,Fall,Clear,406,335,71
2012-08-02,2012,August,17,Thursday,Fall,Clear,865,775,90
2012-08-02,2012,August,18,Thursday,Fall,Clear,767,681,86
2012-08-02,2012,August,19,Thursday,Fall,Clear,607,509,98
2012-08-02,2012,August,20,Thursday,Fall,Clear,427,376,51
2012-08-02,2012,August,21,Thursday,Fall,Clear,342,301,41
2012-08-02,2012,August,22,Thursday,Fall,Clear,262,227,35
2012-08-02,2012,August,23,Thursday,Fall,Clear,177,152,25
2012-08-03,2012,August,0,Friday,Fall,Clear,71,56,15
2012-08-03,2012,August,1,Friday,Fall,Clear,43,32,11
2012-08-03,2012,August,2,Friday,Fall,Clear,14,14,0
2012-08-03,2012,August,3,Friday,Fall,Clear,6,5,1
2012-08-03,2012,August,4,Friday,Fall,Clear,12,11,1
2012-08-03,2012,August,5,Friday,Fall,Clear,37,35,2
2012-08-03,2012,August,6,Friday,Fall,Clear,163,158,5
2012-08-03,2012,August,7,Friday,Fall,Clear,421,396,25
2012-08-03,2012,August,8,Friday,Fall,Clear,668,636,32
2012-08-03,2012,August,9,Friday,Fall,Cloudy,396,327,69
2012-08-03,2012,August,10,Friday,Fall,Cloudy,249,167,82
2012-08-03,2012,August,11,Friday,Fall,Cloudy,263,186,77
2012-08-03,2012,August,12,Friday,Fall,Cloudy,338,243,95
2012-08-03,2012,August,13,Friday,Fall,Cloudy,345,247,98
2012-08-03,2012,August,14,Friday,Fall,Cloudy,331,229,102
2012-08-03,2012,August,15,Friday,Fall,Clear,380,268,112
2012-08-03,2012,August,16,Friday,Fall,Cloudy,492,380,112
2012-08-03,2012,August,17,Friday,Fall,Cloudy,741,646,95
2012-08-03,2012,August,18,Friday,Fall,Cloudy,671,573,98
2012-08-03,2012,August,19,Friday,Fall,Cloudy,469,388,81
2012-08-03,2012,August,20,Friday,Fall,Cloudy,389,300,89
2012-08-03,2012,August,21,Friday,Fall,Cloudy,278,224,54
2012-08-03,2012,August,22,Friday,Fall,Clear,202,156,46
2012-08-03,2012,August,23,Friday,Fall,Clear,196,170,26
2012-08-04,2012,August,0,Saturday,Fall,Clear,161,137,24
2012-08-04,2012,August,1,Saturday,Fall,Clear,122,99,23
2012-08-04,2012,August,2,Saturday,Fall,Clear,84,64,20
2012-08-04,2012,August,3,Saturday,Fall,Clear,30,19,11
2012-08-04,2012,August,4,Saturday,Fall,Clear,13,11,2
2012-08-04,2012,August,5,Saturday,Fall,Clear,17,16,1
2012-08-04,2012,August,6,Saturday,Fall,Clear,49,37,12
2012-08-04,2012,August,7,Saturday,Fall,Clear,67,49,18
2012-08-04,2012,August,8,Saturday,Fall,Clear,181,132,49
2012-08-04,2012,August,9,Saturday,Fall,Clear,278,217,61
2012-08-04,2012,August,10,Saturday,Fall,Clear,396,288,108
2012-08-04,2012,August,11,Saturday,Fall,Clear,470,315,155
2012-08-04,2012,August,12,Saturday,Fall,Clear,547,325,222
2012-08-04,2012,August,13,Saturday,Fall,Clear,527,332,195
2012-08-04,2012,August,14,Saturday,Fall,Clear,472,289,183
2012-08-04,2012,August,15,Saturday,Fall,Clear,489,284,205
2012-08-04,2012,August,16,Saturday,Fall,Clear,450,253,197
2012-08-04,2012,August,17,Saturday,Fall,Clear,492,313,179
2012-08-04,2012,August,18,Saturday,Fall,Clear,490,321,169
2012-08-04,2012,August,19,Saturday,Fall,Clear,397,264,133
2012-08-04,2012,August,20,Saturday,Fall,Clear,312,195,117
2012-08-04,2012,August,21,Saturday,Fall,Clear,289,193,96
2012-08-04,2012,August,22,Saturday,Fall,Clear,269,165,104
2012-08-04,2012,August,23,Saturday,Fall,Clear,222,161,61
2012-08-05,2012,August,0,Sunday,Fall,Clear,153,121,32
2012-08-05,2012,August,1,Sunday,Fall,Clear,87,79,8
2012-08-05,2012,August,2,Sunday,Fall,Clear,73,68,5
2012-08-05,2012,August,3,Sunday,Fall,Clear,41,32,9
2012-08-05,2012,August,4,Sunday,Fall,Clear,14,11,3
2012-08-05,2012,August,5,Sunday,Fall,Clear,19,18,1
2012-08-05,2012,August,6,Sunday,Fall,Clear,19,12,7
2012-08-05,2012,August,7,Sunday,Fall,Clear,68,50,18
2012-08-05,2012,August,8,Sunday,Fall,Clear,108,81,27
2012-08-05,2012,August,9,Sunday,Fall,Clear,229,168,61
2012-08-05,2012,August,10,Sunday,Fall,Clear,364,253,111
2012-08-05,2012,August,11,Sunday,Fall,Clear,437,282,155
2012-08-05,2012,August,12,Sunday,Fall,Clear,491,330,161
2012-08-05,2012,August,13,Sunday,Fall,Clear,523,315,208
2012-08-05,2012,August,14,Sunday,Fall,Clear,526,365,161
2012-08-05,2012,August,15,Sunday,Fall,Clear,450,286,164
2012-08-05,2012,August,16,Sunday,Fall,Clear,421,278,143
2012-08-05,2012,August,17,Sunday,Fall,Clear,382,260,122
2012-08-05,2012,August,18,Sunday,Fall,Light Snow/Rain,229,154,75
2012-08-05,2012,August,19,Sunday,Fall,Clear,185,139,46
2012-08-05,2012,August,20,Sunday,Fall,Clear,193,140,53
2012-08-05,2012,August,21,Sunday,Fall,Clear,208,157,51
2012-08-05,2012,August,22,Sunday,Fall,Clear,157,100,57
2012-08-05,2012,August,23,Sunday,Fall,Cloudy,87,58,29
2012-08-06,2012,August,0,Monday,Fall,Cloudy,33,24,9
2012-08-06,2012,August,1,Monday,Fall,Clear,11,10,1
2012-08-06,2012,August,2,Monday,Fall,Cloudy,5,5,0
2012-08-06,2012,August,3,Monday,Fall,Light Snow/Rain,5,5,0
2012-08-06,2012,August,4,Monday,Fall,Cloudy,11,8,3
2012-08-06,2012,August,5,Monday,Fall,Clear,25,23,2
2012-08-06,2012,August,6,Monday,Fall,Cloudy,141,137,4
2012-08-06,2012,August,7,Monday,Fall,Light Snow/Rain,407,393,14
2012-08-06,2012,August,8,Monday,Fall,Cloudy,605,578,27
2012-08-06,2012,August,9,Monday,Fall,Light Snow/Rain,276,248,28
2012-08-06,2012,August,10,Monday,Fall,Clear,213,159,54
2012-08-06,2012,August,11,Monday,Fall,Clear,260,152,108
2012-08-06,2012,August,12,Monday,Fall,Cloudy,285,213,72
2012-08-06,2012,August,13,Monday,Fall,Clear,289,204,85
2012-08-06,2012,August,14,Monday,Fall,Clear,287,188,99
2012-08-06,2012,August,15,Monday,Fall,Clear,274,183,91
2012-08-06,2012,August,16,Monday,Fall,Clear,451,363,88
2012-08-06,2012,August,17,Monday,Fall,Clear,858,746,112
2012-08-06,2012,August,18,Monday,Fall,Clear,843,743,100
2012-08-06,2012,August,19,Monday,Fall,Clear,640,531,109
2012-08-06,2012,August,20,Monday,Fall,Clear,457,368,89
2012-08-06,2012,August,21,Monday,Fall,Clear,317,245,72
2012-08-06,2012,August,22,Monday,Fall,Clear,207,157,50
2012-08-06,2012,August,23,Monday,Fall,Clear,113,97,16
2012-08-07,2012,August,0,Tuesday,Fall,Clear,47,32,15
2012-08-07,2012,August,1,Tuesday,Fall,Clear,18,16,2
2012-08-07,2012,August,2,Tuesday,Fall,Clear,13,7,6
2012-08-07,2012,August,3,Tuesday,Fall,Clear,6,6,0
2012-08-07,2012,August,4,Tuesday,Fall,Clear,9,7,2
2012-08-07,2012,August,5,Tuesday,Fall,Clear,36,33,3
2012-08-07,2012,August,6,Tuesday,Fall,Cloudy,179,176,3
2012-08-07,2012,August,7,Tuesday,Fall,Cloudy,502,481,21
2012-08-07,2012,August,8,Tuesday,Fall,Cloudy,705,664,41
2012-08-07,2012,August,9,Tuesday,Fall,Cloudy,327,283,44
2012-08-07,2012,August,10,Tuesday,Fall,Cloudy,250,161,89
2012-08-07,2012,August,11,Tuesday,Fall,Cloudy,214,130,84
2012-08-07,2012,August,12,Tuesday,Fall,Cloudy,283,197,86
2012-08-07,2012,August,13,Tuesday,Fall,Cloudy,253,185,68
2012-08-07,2012,August,14,Tuesday,Fall,Cloudy,261,185,76
2012-08-07,2012,August,15,Tuesday,Fall,Clear,306,206,100
2012-08-07,2012,August,16,Tuesday,Fall,Light Snow/Rain,445,344,101
2012-08-07,2012,August,17,Tuesday,Fall,Cloudy,868,743,125
2012-08-07,2012,August,18,Tuesday,Fall,Cloudy,814,711,103
2012-08-07,2012,August,19,Tuesday,Fall,Cloudy,610,506,104
2012-08-07,2012,August,20,Tuesday,Fall,Cloudy,448,374,74
2012-08-07,2012,August,21,Tuesday,Fall,Cloudy,317,247,70
2012-08-07,2012,August,22,Tuesday,Fall,Clear,224,181,43
2012-08-07,2012,August,23,Tuesday,Fall,Clear,138,120,18
2012-08-08,2012,August,0,Wednesday,Fall,Clear,58,46,12
2012-08-08,2012,August,1,Wednesday,Fall,Clear,23,20,3
2012-08-08,2012,August,2,Wednesday,Fall,Clear,6,5,1
2012-08-08,2012,August,3,Wednesday,Fall,Clear,7,6,1
2012-08-08,2012,August,4,Wednesday,Fall,Clear,7,6,1
2012-08-08,2012,August,5,Wednesday,Fall,Cloudy,43,40,3
2012-08-08,2012,August,6,Wednesday,Fall,Cloudy,173,169,4
2012-08-08,2012,August,7,Wednesday,Fall,Cloudy,482,458,24
2012-08-08,2012,August,8,Wednesday,Fall,Cloudy,737,689,48
2012-08-08,2012,August,9,Wednesday,Fall,Cloudy,341,308,33
2012-08-08,2012,August,10,Wednesday,Fall,Cloudy,214,151,63
2012-08-08,2012,August,11,Wednesday,Fall,Cloudy,239,159,80
2012-08-08,2012,August,12,Wednesday,Fall,Cloudy,280,217,63
2012-08-08,2012,August,13,Wednesday,Fall,Cloudy,313,212,101
2012-08-08,2012,August,14,Wednesday,Fall,Cloudy,236,173,63
2012-08-08,2012,August,15,Wednesday,Fall,Cloudy,278,168,110
2012-08-08,2012,August,16,Wednesday,Fall,Cloudy,441,328,113
2012-08-08,2012,August,17,Wednesday,Fall,Cloudy,858,751,107
2012-08-08,2012,August,18,Wednesday,Fall,Cloudy,862,745,117
2012-08-08,2012,August,19,Wednesday,Fall,Clear,686,567,119
2012-08-08,2012,August,20,Wednesday,Fall,Clear,500,424,76
2012-08-08,2012,August,21,Wednesday,Fall,Clear,381,311,70
2012-08-08,2012,August,22,Wednesday,Fall,Clear,233,198,35
2012-08-08,2012,August,23,Wednesday,Fall,Clear,136,120,16
2012-08-09,2012,August,0,Thursday,Fall,Clear,67,51,16
2012-08-09,2012,August,1,Thursday,Fall,Clear,28,23,5
2012-08-09,2012,August,2,Thursday,Fall,Clear,14,12,2
2012-08-09,2012,August,3,Thursday,Fall,Clear,6,5,1
2012-08-09,2012,August,4,Thursday,Fall,Cloudy,10,10,0
2012-08-09,2012,August,5,Thursday,Fall,Cloudy,41,37,4
2012-08-09,2012,August,6,Thursday,Fall,Clear,167,162,5
2012-08-09,2012,August,7,Thursday,Fall,Cloudy,475,451,24
2012-08-09,2012,August,8,Thursday,Fall,Clear,698,670,28
2012-08-09,2012,August,9,Thursday,Fall,Clear,353,299,54
2012-08-09,2012,August,10,Thursday,Fall,Clear,205,133,72
2012-08-09,2012,August,11,Thursday,Fall,Clear,260,166,94
2012-08-09,2012,August,12,Thursday,Fall,Clear,277,192,85
2012-08-09,2012,August,13,Thursday,Fall,Clear,281,201,80
2012-08-09,2012,August,14,Thursday,Fall,Clear,247,161,86
2012-08-09,2012,August,15,Thursday,Fall,Clear,267,204,63
2012-08-09,2012,August,16,Thursday,Fall,Clear,417,320,97
2012-08-09,2012,August,17,Thursday,Fall,Clear,810,699,111
2012-08-09,2012,August,18,Thursday,Fall,Cloudy,811,733,78
2012-08-09,2012,August,19,Thursday,Fall,Clear,623,533,90
2012-08-09,2012,August,20,Thursday,Fall,Clear,478,387,91
2012-08-09,2012,August,21,Thursday,Fall,Cloudy,336,286,50
2012-08-09,2012,August,22,Thursday,Fall,Cloudy,259,218,41
2012-08-09,2012,August,23,Thursday,Fall,Clear,156,137,19
2012-08-10,2012,August,0,Friday,Fall,Clear,85,68,17
2012-08-10,2012,August,1,Friday,Fall,Clear,41,35,6
2012-08-10,2012,August,2,Friday,Fall,Clear,20,14,6
2012-08-10,2012,August,3,Friday,Fall,Cloudy,9,6,3
2012-08-10,2012,August,4,Friday,Fall,Light Snow/Rain,7,7,0
2012-08-10,2012,August,5,Friday,Fall,Light Snow/Rain,33,29,4
2012-08-10,2012,August,6,Friday,Fall,Light Snow/Rain,44,41,3
2012-08-10,2012,August,7,Friday,Fall,Light Snow/Rain,133,128,5
2012-08-10,2012,August,8,Friday,Fall,Light Snow/Rain,119,112,7
2012-08-10,2012,August,9,Friday,Fall,Cloudy,220,199,21
2012-08-10,2012,August,10,Friday,Fall,Clear,193,166,27
2012-08-10,2012,August,11,Friday,Fall,Light Snow/Rain,251,178,73
2012-08-10,2012,August,12,Friday,Fall,Cloudy,315,240,75
2012-08-10,2012,August,13,Friday,Fall,Cloudy,290,224,66
2012-08-10,2012,August,14,Friday,Fall,Clear,307,236,71
2012-08-10,2012,August,15,Friday,Fall,Clear,324,224,100
2012-08-10,2012,August,16,Friday,Fall,Clear,467,371,96
2012-08-10,2012,August,17,Friday,Fall,Clear,730,619,111
2012-08-10,2012,August,18,Friday,Fall,Clear,640,552,88
2012-08-10,2012,August,19,Friday,Fall,Clear,492,394,98
2012-08-10,2012,August,20,Friday,Fall,Clear,370,315,55
2012-08-10,2012,August,21,Friday,Fall,Clear,286,236,50
2012-08-10,2012,August,22,Friday,Fall,Clear,218,168,50
2012-08-10,2012,August,23,Friday,Fall,Clear,192,159,33
2012-08-11,2012,August,0,Saturday,Fall,Clear,180,142,38
2012-08-11,2012,August,1,Saturday,Fall,Clear,116,84,32
2012-08-11,2012,August,2,Saturday,Fall,Light Snow/Rain,85,66,19
2012-08-11,2012,August,3,Saturday,Fall,Light Snow/Rain,21,19,2
2012-08-11,2012,August,4,Saturday,Fall,Clear,10,7,3
2012-08-11,2012,August,5,Saturday,Fall,Clear,11,9,2
2012-08-11,2012,August,6,Saturday,Fall,Cloudy,23,18,5
2012-08-11,2012,August,7,Saturday,Fall,Clear,62,54,8
2012-08-11,2012,August,8,Saturday,Fall,Clear,162,132,30
2012-08-11,2012,August,9,Saturday,Fall,Clear,271,217,54
2012-08-11,2012,August,10,Saturday,Fall,Clear,407,282,125
2012-08-11,2012,August,11,Saturday,Fall,Clear,499,296,203
2012-08-11,2012,August,12,Saturday,Fall,Clear,546,332,214
2012-08-11,2012,August,13,Saturday,Fall,Clear,569,341,228
2012-08-11,2012,August,14,Saturday,Fall,Clear,538,290,248
2012-08-11,2012,August,15,Saturday,Fall,Clear,562,316,246
2012-08-11,2012,August,16,Saturday,Fall,Clear,531,304,227
2012-08-11,2012,August,17,Saturday,Fall,Light Snow/Rain,512,292,220
2012-08-11,2012,August,18,Saturday,Fall,Cloudy,300,193,107
2012-08-11,2012,August,19,Saturday,Fall,Cloudy,275,178,97
2012-08-11,2012,August,20,Saturday,Fall,Light Snow/Rain,160,129,31
2012-08-11,2012,August,21,Saturday,Fall,Cloudy,128,102,26
2012-08-11,2012,August,22,Saturday,Fall,Cloudy,168,128,40
2012-08-11,2012,August,23,Saturday,Fall,Light Snow/Rain,163,121,42
2012-08-12,2012,August,0,Sunday,Fall,Cloudy,120,96,24
2012-08-12,2012,August,1,Sunday,Fall,Clear,113,92,21
2012-08-12,2012,August,2,Sunday,Fall,Clear,86,67,19
2012-08-12,2012,August,3,Sunday,Fall,Clear,48,37,11
2012-08-12,2012,August,4,Sunday,Fall,Clear,10,8,2
2012-08-12,2012,August,5,Sunday,Fall,Clear,10,9,1
2012-08-12,2012,August,6,Sunday,Fall,Clear,16,14,2
2012-08-12,2012,August,7,Sunday,Fall,Clear,39,30,9
2012-08-12,2012,August,8,Sunday,Fall,Clear,119,84,35
2012-08-12,2012,August,9,Sunday,Fall,Clear,217,153,64
2012-08-12,2012,August,10,Sunday,Fall,Clear,328,240,88
2012-08-12,2012,August,11,Sunday,Fall,Clear,449,282,167
2012-08-12,2012,August,12,Sunday,Fall,Clear,505,342,163
2012-08-12,2012,August,13,Sunday,Fall,Clear,543,365,178
2012-08-12,2012,August,14,Sunday,Fall,Clear,579,366,213
2012-08-12,2012,August,15,Sunday,Fall,Clear,577,342,235
2012-08-12,2012,August,16,Sunday,Fall,Clear,513,300,213
2012-08-12,2012,August,17,Sunday,Fall,Clear,505,319,186
2012-08-12,2012,August,18,Sunday,Fall,Clear,491,327,164
2012-08-12,2012,August,19,Sunday,Fall,Clear,465,317,148
2012-08-12,2012,August,20,Sunday,Fall,Clear,300,204,96
2012-08-12,2012,August,21,Sunday,Fall,Clear,220,142,78
2012-08-12,2012,August,22,Sunday,Fall,Clear,181,141,40
2012-08-12,2012,August,23,Sunday,Fall,Clear,110,85,25
2012-08-13,2012,August,0,Monday,Fall,Clear,47,33,14
2012-08-13,2012,August,1,Monday,Fall,Clear,14,11,3
2012-08-13,2012,August,2,Monday,Fall,Clear,9,8,1
2012-08-13,2012,August,3,Monday,Fall,Clear,6,5,1
2012-08-13,2012,August,4,Monday,Fall,Clear,11,11,0
2012-08-13,2012,August,5,Monday,Fall,Clear,36,33,3
2012-08-13,2012,August,6,Monday,Fall,Clear,159,155,4
2012-08-13,2012,August,7,Monday,Fall,Clear,436,425,11
2012-08-13,2012,August,8,Monday,Fall,Cloudy,673,648,25
2012-08-13,2012,August,9,Monday,Fall,Cloudy,305,265,40
2012-08-13,2012,August,10,Monday,Fall,Cloudy,199,111,88
2012-08-13,2012,August,11,Monday,Fall,Clear,245,151,94
2012-08-13,2012,August,12,Monday,Fall,Clear,276,180,96
2012-08-13,2012,August,13,Monday,Fall,Clear,254,175,79
2012-08-13,2012,August,14,Monday,Fall,Clear,248,163,85
2012-08-13,2012,August,15,Monday,Fall,Clear,274,194,80
2012-08-13,2012,August,16,Monday,Fall,Clear,464,348,116
2012-08-13,2012,August,17,Monday,Fall,Clear,818,716,102
2012-08-13,2012,August,18,Monday,Fall,Clear,812,709,103
2012-08-13,2012,August,19,Monday,Fall,Clear,555,467,88
2012-08-13,2012,August,20,Monday,Fall,Clear,432,374,58
2012-08-13,2012,August,21,Monday,Fall,Clear,290,246,44
2012-08-13,2012,August,22,Monday,Fall,Clear,192,148,44
2012-08-13,2012,August,23,Monday,Fall,Clear,128,100,28
2012-08-14,2012,August,0,Tuesday,Fall,Clear,60,48,12
2012-08-14,2012,August,1,Tuesday,Fall,Clear,27,19,8
2012-08-14,2012,August,2,Tuesday,Fall,Cloudy,11,9,2
2012-08-14,2012,August,3,Tuesday,Fall,Cloudy,3,3,0
2012-08-14,2012,August,4,Tuesday,Fall,Cloudy,5,5,0
2012-08-14,2012,August,5,Tuesday,Fall,Cloudy,36,35,1
2012-08-14,2012,August,6,Tuesday,Fall,Light Snow/Rain,64,63,1
2012-08-14,2012,August,7,Tuesday,Fall,Cloudy,179,178,1
2012-08-14,2012,August,8,Tuesday,Fall,Cloudy,618,591,27
2012-08-14,2012,August,9,Tuesday,Fall,Cloudy,402,354,48
2012-08-14,2012,August,10,Tuesday,Fall,Clear,208,155,53
2012-08-14,2012,August,11,Tuesday,Fall,Clear,196,127,69
2012-08-14,2012,August,12,Tuesday,Fall,Clear,300,207,93
2012-08-14,2012,August,13,Tuesday,Fall,Clear,286,203,83
2012-08-14,2012,August,14,Tuesday,Fall,Clear,255,175,80
2012-08-14,2012,August,15,Tuesday,Fall,Clear,283,199,84
2012-08-14,2012,August,16,Tuesday,Fall,Clear,458,363,95
2012-08-14,2012,August,17,Tuesday,Fall,Light Snow/Rain,812,734,78
2012-08-14,2012,August,18,Tuesday,Fall,Clear,854,757,97
2012-08-14,2012,August,19,Tuesday,Fall,Clear,627,533,94
2012-08-14,2012,August,20,Tuesday,Fall,Clear,436,371,65
2012-08-14,2012,August,21,Tuesday,Fall,Clear,308,252,56
2012-08-14,2012,August,22,Tuesday,Fall,Clear,189,161,28
2012-08-14,2012,August,23,Tuesday,Fall,Clear,167,114,53
2012-08-15,2012,August,0,Wednesday,Fall,Clear,60,52,8
2012-08-15,2012,August,1,Wednesday,Fall,Clear,37,31,6
2012-08-15,2012,August,2,Wednesday,Fall,Clear,8,7,1
2012-08-15,2012,August,3,Wednesday,Fall,Clear,11,10,1
2012-08-15,2012,August,4,Wednesday,Fall,Clear,4,4,0
2012-08-15,2012,August,5,Wednesday,Fall,Clear,39,35,4
2012-08-15,2012,August,6,Wednesday,Fall,Clear,172,160,12
2012-08-15,2012,August,7,Wednesday,Fall,Cloudy,492,467,25
2012-08-15,2012,August,8,Wednesday,Fall,Cloudy,682,642,40
2012-08-15,2012,August,9,Wednesday,Fall,Cloudy,367,310,57
2012-08-15,2012,August,10,Wednesday,Fall,Cloudy,233,163,70
2012-08-15,2012,August,11,Wednesday,Fall,Cloudy,235,155,80
2012-08-15,2012,August,12,Wednesday,Fall,Clear,307,230,77
2012-08-15,2012,August,13,Wednesday,Fall,Cloudy,294,206,88
2012-08-15,2012,August,14,Wednesday,Fall,Cloudy,255,161,94
2012-08-15,2012,August,15,Wednesday,Fall,Clear,266,196,70
2012-08-15,2012,August,16,Wednesday,Fall,Clear,431,340,91
2012-08-15,2012,August,17,Wednesday,Fall,Clear,851,749,102
2012-08-15,2012,August,18,Wednesday,Fall,Clear,848,768,80
2012-08-15,2012,August,19,Wednesday,Fall,Clear,649,525,124
2012-08-15,2012,August,20,Wednesday,Fall,Clear,427,355,72
2012-08-15,2012,August,21,Wednesday,Fall,Clear,315,266,49
2012-08-15,2012,August,22,Wednesday,Fall,Clear,226,197,29
2012-08-15,2012,August,23,Wednesday,Fall,Clear,138,120,18
2012-08-16,2012,August,0,Thursday,Fall,Clear,76,63,13
2012-08-16,2012,August,1,Thursday,Fall,Clear,21,18,3
2012-08-16,2012,August,2,Thursday,Fall,Clear,15,15,0
2012-08-16,2012,August,3,Thursday,Fall,Clear,4,4,0
2012-08-16,2012,August,4,Thursday,Fall,Clear,5,3,2
2012-08-16,2012,August,5,Thursday,Fall,Clear,37,30,7
2012-08-16,2012,August,6,Thursday,Fall,Clear,165,162,3
2012-08-16,2012,August,7,Thursday,Fall,Clear,464,448,16
2012-08-16,2012,August,8,Thursday,Fall,Clear,682,649,33
2012-08-16,2012,August,9,Thursday,Fall,Clear,337,296,41
2012-08-16,2012,August,10,Thursday,Fall,Clear,199,121,78
2012-08-16,2012,August,11,Thursday,Fall,Clear,274,191,83
2012-08-16,2012,August,12,Thursday,Fall,Clear,343,247,96
2012-08-16,2012,August,13,Thursday,Fall,Clear,300,219,81
2012-08-16,2012,August,14,Thursday,Fall,Clear,248,176,72
2012-08-16,2012,August,15,Thursday,Fall,Clear,260,197,63
2012-08-16,2012,August,16,Thursday,Fall,Clear,419,340,79
2012-08-16,2012,August,17,Thursday,Fall,Clear,897,767,130
2012-08-16,2012,August,18,Thursday,Fall,Clear,832,723,109
2012-08-16,2012,August,19,Thursday,Fall,Clear,677,558,119
2012-08-16,2012,August,20,Thursday,Fall,Clear,514,414,100
2012-08-16,2012,August,21,Thursday,Fall,Clear,356,273,83
2012-08-16,2012,August,22,Thursday,Fall,Clear,254,185,69
2012-08-16,2012,August,23,Thursday,Fall,Clear,226,168,58
2012-08-17,2012,August,0,Friday,Fall,Clear,88,67,21
2012-08-17,2012,August,1,Friday,Fall,Clear,54,38,16
2012-08-17,2012,August,2,Friday,Fall,Clear,19,15,4
2012-08-17,2012,August,3,Friday,Fall,Clear,6,6,0
2012-08-17,2012,August,4,Friday,Fall,Clear,9,9,0
2012-08-17,2012,August,5,Friday,Fall,Clear,36,34,2
2012-08-17,2012,August,6,Friday,Fall,Clear,157,151,6
2012-08-17,2012,August,7,Friday,Fall,Clear,379,368,11
2012-08-17,2012,August,8,Friday,Fall,Clear,668,625,43
2012-08-17,2012,August,9,Friday,Fall,Clear,378,320,58
2012-08-17,2012,August,10,Friday,Fall,Clear,231,149,82
2012-08-17,2012,August,11,Friday,Fall,Clear,303,205,98
2012-08-17,2012,August,12,Friday,Fall,Clear,365,255,110
2012-08-17,2012,August,13,Friday,Fall,Clear,357,254,103
2012-08-17,2012,August,14,Friday,Fall,Clear,328,200,128
2012-08-17,2012,August,15,Friday,Fall,Clear,383,256,127
2012-08-17,2012,August,16,Friday,Fall,Cloudy,488,372,116
2012-08-17,2012,August,17,Friday,Fall,Clear,791,647,144
2012-08-17,2012,August,18,Friday,Fall,Cloudy,669,561,108
2012-08-17,2012,August,19,Friday,Fall,Cloudy,491,403,88
2012-08-17,2012,August,20,Friday,Fall,Cloudy,359,262,97
2012-08-17,2012,August,21,Friday,Fall,Cloudy,255,198,57
2012-08-17,2012,August,22,Friday,Fall,Light Snow/Rain,213,170,43
2012-08-17,2012,August,23,Friday,Fall,Light Snow/Rain,121,100,21
2012-08-18,2012,August,0,Saturday,Fall,Cloudy,105,99,6
2012-08-18,2012,August,1,Saturday,Fall,Light Snow/Rain,92,78,14
2012-08-18,2012,August,2,Saturday,Fall,Light Snow/Rain,43,39,4
2012-08-18,2012,August,3,Saturday,Fall,Clear,30,23,7
2012-08-18,2012,August,4,Saturday,Fall,Clear,13,8,5
2012-08-18,2012,August,5,Saturday,Fall,Clear,9,7,2
2012-08-18,2012,August,6,Saturday,Fall,Clear,27,23,4
2012-08-18,2012,August,7,Saturday,Fall,Clear,64,52,12
2012-08-18,2012,August,8,Saturday,Fall,Clear,189,161,28
2012-08-18,2012,August,9,Saturday,Fall,Clear,292,211,81
2012-08-18,2012,August,10,Saturday,Fall,Clear,480,314,166
2012-08-18,2012,August,11,Saturday,Fall,Clear,536,356,180
2012-08-18,2012,August,12,Saturday,Fall,Clear,654,388,266
2012-08-18,2012,August,13,Saturday,Fall,Clear,644,355,289
2012-08-18,2012,August,14,Saturday,Fall,Clear,598,356,242
2012-08-18,2012,August,15,Saturday,Fall,Clear,596,346,250
2012-08-18,2012,August,16,Saturday,Fall,Clear,641,354,287
2012-08-18,2012,August,17,Saturday,Fall,Clear,635,379,256
2012-08-18,2012,August,18,Saturday,Fall,Clear,554,329,225
2012-08-18,2012,August,19,Saturday,Fall,Clear,488,324,164
2012-08-18,2012,August,20,Saturday,Fall,Clear,341,242,99
2012-08-18,2012,August,21,Saturday,Fall,Clear,338,248,90
2012-08-18,2012,August,22,Saturday,Fall,Clear,261,171,90
2012-08-18,2012,August,23,Saturday,Fall,Clear,235,175,60
2012-08-19,2012,August,0,Sunday,Fall,Clear,187,143,44
2012-08-19,2012,August,1,Sunday,Fall,Clear,131,102,29
2012-08-19,2012,August,2,Sunday,Fall,Cloudy,119,103,16
2012-08-19,2012,August,3,Sunday,Fall,Cloudy,55,34,21
2012-08-19,2012,August,4,Sunday,Fall,Cloudy,26,22,4
2012-08-19,2012,August,5,Sunday,Fall,Cloudy,11,8,3
2012-08-19,2012,August,6,Sunday,Fall,Cloudy,20,15,5
2012-08-19,2012,August,7,Sunday,Fall,Cloudy,41,29,12
2012-08-19,2012,August,8,Sunday,Fall,Cloudy,124,90,34
2012-08-19,2012,August,9,Sunday,Fall,Cloudy,270,184,86
2012-08-19,2012,August,10,Sunday,Fall,Cloudy,425,287,138
2012-08-19,2012,August,11,Sunday,Fall,Light Snow/Rain,272,189,83
2012-08-19,2012,August,12,Sunday,Fall,Light Snow/Rain,298,186,112
2012-08-19,2012,August,13,Sunday,Fall,Light Snow/Rain,162,112,50
2012-08-19,2012,August,14,Sunday,Fall,Light Snow/Rain,149,108,41
2012-08-19,2012,August,15,Sunday,Fall,Cloudy,276,187,89
2012-08-19,2012,August,16,Sunday,Fall,Cloudy,356,259,97
2012-08-19,2012,August,17,Sunday,Fall,Cloudy,343,267,76
2012-08-19,2012,August,18,Sunday,Fall,Cloudy,377,291,86
2012-08-19,2012,August,19,Sunday,Fall,Cloudy,341,269,72
2012-08-19,2012,August,20,Sunday,Fall,Cloudy,274,213,61
2012-08-19,2012,August,21,Sunday,Fall,Light Snow/Rain,190,154,36
2012-08-19,2012,August,22,Sunday,Fall,Cloudy,56,50,6
2012-08-19,2012,August,23,Sunday,Fall,Cloudy,46,39,7
2012-08-20,2012,August,0,Monday,Fall,Cloudy,26,25,1
2012-08-20,2012,August,1,Monday,Fall,Clear,10,10,0
2012-08-20,2012,August,2,Monday,Fall,Clear,5,5,0
2012-08-20,2012,August,3,Monday,Fall,Clear,3,3,0
2012-08-20,2012,August,4,Monday,Fall,Cloudy,7,7,0
2012-08-20,2012,August,5,Monday,Fall,Cloudy,37,35,2
2012-08-20,2012,August,6,Monday,Fall,Cloudy,161,155,6
2012-08-20,2012,August,7,Monday,Fall,Cloudy,442,427,15
2012-08-20,2012,August,8,Monday,Fall,Cloudy,655,618,37
2012-08-20,2012,August,9,Monday,Fall,Cloudy,357,302,55
2012-08-20,2012,August,10,Monday,Fall,Cloudy,193,124,69
2012-08-20,2012,August,11,Monday,Fall,Clear,241,151,90
2012-08-20,2012,August,12,Monday,Fall,Cloudy,282,216,66
2012-08-20,2012,August,13,Monday,Fall,Clear,291,194,97
2012-08-20,2012,August,14,Monday,Fall,Clear,275,188,87
2012-08-20,2012,August,15,Monday,Fall,Clear,309,207,102
2012-08-20,2012,August,16,Monday,Fall,Clear,460,357,103
2012-08-20,2012,August,17,Monday,Fall,Clear,893,810,83
2012-08-20,2012,August,18,Monday,Fall,Cloudy,815,726,89
2012-08-20,2012,August,19,Monday,Fall,Cloudy,299,266,33
2012-08-20,2012,August,20,Monday,Fall,Cloudy,261,231,30
2012-08-20,2012,August,21,Monday,Fall,Clear,245,219,26
2012-08-20,2012,August,22,Monday,Fall,Cloudy,161,136,25
2012-08-20,2012,August,23,Monday,Fall,Cloudy,102,92,10
2012-08-21,2012,August,0,Tuesday,Fall,Cloudy,59,52,7
2012-08-21,2012,August,1,Tuesday,Fall,Cloudy,33,22,11
2012-08-21,2012,August,2,Tuesday,Fall,Cloudy,8,7,1
2012-08-21,2012,August,3,Tuesday,Fall,Clear,3,3,0
2012-08-21,2012,August,4,Tuesday,Fall,Clear,4,4,0
2012-08-21,2012,August,5,Tuesday,Fall,Clear,34,30,4
2012-08-21,2012,August,6,Tuesday,Fall,Clear,169,164,5
2012-08-21,2012,August,7,Tuesday,Fall,Clear,519,500,19
2012-08-21,2012,August,8,Tuesday,Fall,Clear,723,696,27
2012-08-21,2012,August,9,Tuesday,Fall,Clear,328,281,47
2012-08-21,2012,August,10,Tuesday,Fall,Clear,178,120,58
2012-08-21,2012,August,11,Tuesday,Fall,Clear,256,195,61
2012-08-21,2012,August,12,Tuesday,Fall,Clear,305,226,79
2012-08-21,2012,August,13,Tuesday,Fall,Clear,331,255,76
2012-08-21,2012,August,14,Tuesday,Fall,Clear,302,192,110
2012-08-21,2012,August,15,Tuesday,Fall,Clear,302,226,76
2012-08-21,2012,August,16,Tuesday,Fall,Clear,467,358,109
2012-08-21,2012,August,17,Tuesday,Fall,Clear,878,786,92
2012-08-21,2012,August,18,Tuesday,Fall,Clear,625,532,93
2012-08-21,2012,August,19,Tuesday,Fall,Light Snow/Rain,476,420,56
2012-08-21,2012,August,20,Tuesday,Fall,Clear,358,296,62
2012-08-21,2012,August,21,Tuesday,Fall,Clear,280,239,41
2012-08-21,2012,August,22,Tuesday,Fall,Clear,232,208,24
2012-08-21,2012,August,23,Tuesday,Fall,Clear,136,113,23
2012-08-22,2012,August,0,Wednesday,Fall,Clear,55,46,9
2012-08-22,2012,August,1,Wednesday,Fall,Clear,21,20,1
2012-08-22,2012,August,2,Wednesday,Fall,Clear,17,10,7
2012-08-22,2012,August,3,Wednesday,Fall,Clear,7,7,0
2012-08-22,2012,August,4,Wednesday,Fall,Clear,8,7,1
2012-08-22,2012,August,5,Wednesday,Fall,Clear,40,38,2
2012-08-22,2012,August,6,Wednesday,Fall,Clear,187,175,12
2012-08-22,2012,August,7,Wednesday,Fall,Clear,553,537,16
2012-08-22,2012,August,8,Wednesday,Fall,Clear,740,703,37
2012-08-22,2012,August,9,Wednesday,Fall,Clear,376,335,41
2012-08-22,2012,August,10,Wednesday,Fall,Clear,225,159,66
2012-08-22,2012,August,11,Wednesday,Fall,Clear,267,196,71
2012-08-22,2012,August,12,Wednesday,Fall,Clear,312,253,59
2012-08-22,2012,August,13,Wednesday,Fall,Clear,316,242,74
2012-08-22,2012,August,14,Wednesday,Fall,Clear,266,184,82
2012-08-22,2012,August,15,Wednesday,Fall,Clear,316,222,94
2012-08-22,2012,August,16,Wednesday,Fall,Light Snow/Rain,460,358,102
2012-08-22,2012,August,17,Wednesday,Fall,Light Snow/Rain,783,711,72
2012-08-22,2012,August,18,Wednesday,Fall,Light Snow/Rain,683,592,91
2012-08-22,2012,August,19,Wednesday,Fall,Cloudy,580,524,56
2012-08-22,2012,August,20,Wednesday,Fall,Clear,391,332,59
2012-08-22,2012,August,21,Wednesday,Fall,Clear,351,291,60
2012-08-22,2012,August,22,Wednesday,Fall,Clear,281,226,55
2012-08-22,2012,August,23,Wednesday,Fall,Clear,140,113,27
2012-08-23,2012,August,0,Thursday,Fall,Clear,60,51,9
2012-08-23,2012,August,1,Thursday,Fall,Clear,25,15,10
2012-08-23,2012,August,2,Thursday,Fall,Clear,20,11,9
2012-08-23,2012,August,3,Thursday,Fall,Clear,9,6,3
2012-08-23,2012,August,4,Thursday,Fall,Clear,6,6,0
2012-08-23,2012,August,5,Thursday,Fall,Clear,37,36,1
2012-08-23,2012,August,6,Thursday,Fall,Cloudy,192,178,14
2012-08-23,2012,August,7,Thursday,Fall,Cloudy,481,463,18
2012-08-23,2012,August,8,Thursday,Fall,Cloudy,707,662,45
2012-08-23,2012,August,9,Thursday,Fall,Cloudy,412,354,58
2012-08-23,2012,August,10,Thursday,Fall,Clear,233,157,76
2012-08-23,2012,August,11,Thursday,Fall,Clear,278,192,86
2012-08-23,2012,August,12,Thursday,Fall,Clear,332,235,97
2012-08-23,2012,August,13,Thursday,Fall,Clear,346,253,93
2012-08-23,2012,August,14,Thursday,Fall,Clear,305,191,114
2012-08-23,2012,August,15,Thursday,Fall,Clear,305,201,104
2012-08-23,2012,August,16,Thursday,Fall,Clear,465,344,121
2012-08-23,2012,August,17,Thursday,Fall,Clear,820,709,111
2012-08-23,2012,August,18,Thursday,Fall,Clear,941,811,130
2012-08-23,2012,August,19,Thursday,Fall,Clear,633,537,96
2012-08-23,2012,August,20,Thursday,Fall,Clear,474,404,70
2012-08-23,2012,August,21,Thursday,Fall,Clear,329,276,53
2012-08-23,2012,August,22,Thursday,Fall,Cloudy,198,177,21
2012-08-23,2012,August,23,Thursday,Fall,Cloudy,157,133,24
2012-08-24,2012,August,0,Friday,Fall,Cloudy,111,84,27
2012-08-24,2012,August,1,Friday,Fall,Cloudy,42,37,5
2012-08-24,2012,August,2,Friday,Fall,Clear,16,15,1
2012-08-24,2012,August,3,Friday,Fall,Clear,8,6,2
2012-08-24,2012,August,4,Friday,Fall,Cloudy,8,6,2
2012-08-24,2012,August,5,Friday,Fall,Clear,38,37,1
2012-08-24,2012,August,6,Friday,Fall,Cloudy,151,142,9
2012-08-24,2012,August,7,Friday,Fall,Cloudy,425,412,13
2012-08-24,2012,August,8,Friday,Fall,Cloudy,744,703,41
2012-08-24,2012,August,9,Friday,Fall,Cloudy,389,331,58
2012-08-24,2012,August,10,Friday,Fall,Cloudy,262,184,78
2012-08-24,2012,August,11,Friday,Fall,Cloudy,281,212,69
2012-08-24,2012,August,12,Friday,Fall,Cloudy,371,276,95
2012-08-24,2012,August,13,Friday,Fall,Cloudy,351,272,79
2012-08-24,2012,August,14,Friday,Fall,Clear,338,229,109
2012-08-24,2012,August,15,Friday,Fall,Cloudy,350,251,99
2012-08-24,2012,August,16,Friday,Fall,Cloudy,515,414,101
2012-08-24,2012,August,17,Friday,Fall,Cloudy,812,695,117
2012-08-24,2012,August,18,Friday,Fall,Cloudy,736,627,109
2012-08-24,2012,August,19,Friday,Fall,Cloudy,536,430,106
2012-08-24,2012,August,20,Friday,Fall,Cloudy,363,297,66
2012-08-24,2012,August,21,Friday,Fall,Cloudy,306,248,58
2012-08-24,2012,August,22,Friday,Fall,Cloudy,251,209,42
2012-08-24,2012,August,23,Friday,Fall,Cloudy,178,140,38
2012-08-25,2012,August,0,Saturday,Fall,Cloudy,135,114,21
2012-08-25,2012,August,1,Saturday,Fall,Cloudy,115,100,15
2012-08-25,2012,August,2,Saturday,Fall,Cloudy,79,61,18
2012-08-25,2012,August,3,Saturday,Fall,Clear,38,31,7
2012-08-25,2012,August,4,Saturday,Fall,Cloudy,12,9,3
2012-08-25,2012,August,5,Saturday,Fall,Cloudy,14,10,4
2012-08-25,2012,August,6,Saturday,Fall,Cloudy,30,25,5
2012-08-25,2012,August,7,Saturday,Fall,Cloudy,102,88,14
2012-08-25,2012,August,8,Saturday,Fall,Cloudy,162,133,29
2012-08-25,2012,August,9,Saturday,Fall,Cloudy,288,228,60
2012-08-25,2012,August,10,Saturday,Fall,Cloudy,442,294,148
2012-08-25,2012,August,11,Saturday,Fall,Cloudy,457,314,143
2012-08-25,2012,August,12,Saturday,Fall,Light Snow/Rain,584,367,217
2012-08-25,2012,August,13,Saturday,Fall,Cloudy,517,331,186
2012-08-25,2012,August,14,Saturday,Fall,Light Snow/Rain,482,332,150
2012-08-25,2012,August,15,Saturday,Fall,Cloudy,233,154,79
2012-08-25,2012,August,16,Saturday,Fall,Cloudy,434,260,174
2012-08-25,2012,August,17,Saturday,Fall,Cloudy,403,271,132
2012-08-25,2012,August,18,Saturday,Fall,Cloudy,383,261,122
2012-08-25,2012,August,19,Saturday,Fall,Cloudy,354,257,97
2012-08-25,2012,August,20,Saturday,Fall,Light Snow/Rain,241,176,65
2012-08-25,2012,August,21,Saturday,Fall,Clear,208,148,60
2012-08-25,2012,August,22,Saturday,Fall,Clear,182,136,46
2012-08-25,2012,August,23,Saturday,Fall,Cloudy,158,124,34
2012-08-26,2012,August,0,Sunday,Fall,Clear,134,111,23
2012-08-26,2012,August,1,Sunday,Fall,Clear,134,116,18
2012-08-26,2012,August,2,Sunday,Fall,Cloudy,116,104,12
2012-08-26,2012,August,3,Sunday,Fall,Cloudy,53,42,11
2012-08-26,2012,August,4,Sunday,Fall,Cloudy,16,11,5
2012-08-26,2012,August,5,Sunday,Fall,Clear,16,13,3
2012-08-26,2012,August,6,Sunday,Fall,Clear,21,16,5
2012-08-26,2012,August,7,Sunday,Fall,Clear,34,23,11
2012-08-26,2012,August,8,Sunday,Fall,Clear,133,112,21
2012-08-26,2012,August,9,Sunday,Fall,Clear,263,196,67
2012-08-26,2012,August,10,Sunday,Fall,Clear,385,258,127
2012-08-26,2012,August,11,Sunday,Fall,Clear,482,332,150
2012-08-26,2012,August,12,Sunday,Fall,Light Snow/Rain,626,401,225
2012-08-26,2012,August,13,Sunday,Fall,Light Snow/Rain,541,375,166
2012-08-26,2012,August,14,Sunday,Fall,Clear,377,252,125
2012-08-26,2012,August,15,Sunday,Fall,Light Snow/Rain,391,259,132
2012-08-26,2012,August,16,Sunday,Fall,Light Snow/Rain,173,116,57
2012-08-26,2012,August,17,Sunday,Fall,Clear,233,172,61
2012-08-26,2012,August,18,Sunday,Fall,Cloudy,264,187,77
2012-08-26,2012,August,19,Sunday,Fall,Cloudy,292,212,80
2012-08-26,2012,August,20,Sunday,Fall,Clear,211,171,40
2012-08-26,2012,August,21,Sunday,Fall,Clear,166,140,26
2012-08-26,2012,August,22,Sunday,Fall,Clear,114,94,20
2012-08-26,2012,August,23,Sunday,Fall,Clear,80,59,21
2012-08-27,2012,August,0,Monday,Fall,Clear,32,28,4
2012-08-27,2012,August,1,Monday,Fall,Clear,7,4,3
2012-08-27,2012,August,2,Monday,Fall,Clear,8,8,0
2012-08-27,2012,August,3,Monday,Fall,Clear,4,3,1
2012-08-27,2012,August,4,Monday,Fall,Clear,12,11,1
2012-08-27,2012,August,5,Monday,Fall,Clear,36,32,4
2012-08-27,2012,August,6,Monday,Fall,Clear,145,141,4
2012-08-27,2012,August,7,Monday,Fall,Clear,433,418,15
2012-08-27,2012,August,8,Monday,Fall,Clear,699,670,29
2012-08-27,2012,August,9,Monday,Fall,Clear,342,302,40
2012-08-27,2012,August,10,Monday,Fall,Clear,206,143,63
2012-08-27,2012,August,11,Monday,Fall,Clear,229,182,47
2012-08-27,2012,August,12,Monday,Fall,Clear,283,214,69
2012-08-27,2012,August,13,Monday,Fall,Clear,288,211,77
2012-08-27,2012,August,14,Monday,Fall,Clear,246,180,66
2012-08-27,2012,August,15,Monday,Fall,Clear,282,205,77
2012-08-27,2012,August,16,Monday,Fall,Clear,444,367,77
2012-08-27,2012,August,17,Monday,Fall,Clear,845,744,101
2012-08-27,2012,August,18,Monday,Fall,Clear,834,751,83
2012-08-27,2012,August,19,Monday,Fall,Clear,573,499,74
2012-08-27,2012,August,20,Monday,Fall,Clear,416,366,50
2012-08-27,2012,August,21,Monday,Fall,Clear,278,239,39
2012-08-27,2012,August,22,Monday,Fall,Clear,161,131,30
2012-08-27,2012,August,23,Monday,Fall,Clear,114,79,35
2012-08-28,2012,August,0,Tuesday,Fall,Clear,38,29,9
2012-08-28,2012,August,1,Tuesday,Fall,Clear,21,17,4
2012-08-28,2012,August,2,Tuesday,Fall,Clear,15,13,2
2012-08-28,2012,August,3,Tuesday,Fall,Clear,4,4,0
2012-08-28,2012,August,4,Tuesday,Fall,Clear,8,6,2
2012-08-28,2012,August,5,Tuesday,Fall,Cloudy,42,39,3
2012-08-28,2012,August,6,Tuesday,Fall,Cloudy,147,144,3
2012-08-28,2012,August,7,Tuesday,Fall,Cloudy,269,255,14
2012-08-28,2012,August,8,Tuesday,Fall,Cloudy,693,668,25
2012-08-28,2012,August,9,Tuesday,Fall,Cloudy,395,351,44
2012-08-28,2012,August,10,Tuesday,Fall,Clear,204,165,39
2012-08-28,2012,August,11,Tuesday,Fall,Clear,218,171,47
2012-08-28,2012,August,12,Tuesday,Fall,Clear,297,241,56
2012-08-28,2012,August,13,Tuesday,Fall,Clear,288,232,56
2012-08-28,2012,August,14,Tuesday,Fall,Clear,251,179,72
2012-08-28,2012,August,15,Tuesday,Fall,Clear,317,258,59
2012-08-28,2012,August,16,Tuesday,Fall,Clear,480,396,84
2012-08-28,2012,August,17,Tuesday,Fall,Clear,864,774,90
2012-08-28,2012,August,18,Tuesday,Fall,Clear,818,736,82
2012-08-28,2012,August,19,Tuesday,Fall,Clear,597,515,82
2012-08-28,2012,August,20,Tuesday,Fall,Clear,435,348,87
2012-08-28,2012,August,21,Tuesday,Fall,Clear,314,276,38
2012-08-28,2012,August,22,Tuesday,Fall,Clear,216,196,20
2012-08-28,2012,August,23,Tuesday,Fall,Clear,109,92,17
2012-08-29,2012,August,0,Wednesday,Fall,Clear,47,39,8
2012-08-29,2012,August,1,Wednesday,Fall,Clear,14,12,2
2012-08-29,2012,August,2,Wednesday,Fall,Clear,6,4,2
2012-08-29,2012,August,3,Wednesday,Fall,Clear,9,9,0
2012-08-29,2012,August,4,Wednesday,Fall,Clear,10,8,2
2012-08-29,2012,August,5,Wednesday,Fall,Clear,40,37,3
2012-08-29,2012,August,6,Wednesday,Fall,Clear,181,175,6
2012-08-29,2012,August,7,Wednesday,Fall,Clear,554,531,23
2012-08-29,2012,August,8,Wednesday,Fall,Clear,808,780,28
2012-08-29,2012,August,9,Wednesday,Fall,Clear,348,308,40
2012-08-29,2012,August,10,Wednesday,Fall,Clear,178,144,34
2012-08-29,2012,August,11,Wednesday,Fall,Clear,253,186,67
2012-08-29,2012,August,12,Wednesday,Fall,Clear,360,281,79
2012-08-29,2012,August,13,Wednesday,Fall,Clear,300,232,68
2012-08-29,2012,August,14,Wednesday,Fall,Clear,301,214,87
2012-08-29,2012,August,15,Wednesday,Fall,Clear,338,242,96
2012-08-29,2012,August,16,Wednesday,Fall,Clear,493,389,104
2012-08-29,2012,August,17,Wednesday,Fall,Clear,870,762,108
2012-08-29,2012,August,18,Wednesday,Fall,Clear,812,693,119
2012-08-29,2012,August,19,Wednesday,Fall,Clear,643,523,120
2012-08-29,2012,August,20,Wednesday,Fall,Clear,427,378,49
2012-08-29,2012,August,21,Wednesday,Fall,Clear,313,265,48
2012-08-29,2012,August,22,Wednesday,Fall,Clear,235,185,50
2012-08-29,2012,August,23,Wednesday,Fall,Clear,157,123,34
2012-08-30,2012,August,0,Thursday,Fall,Clear,65,51,14
2012-08-30,2012,August,1,Thursday,Fall,Clear,23,17,6
2012-08-30,2012,August,2,Thursday,Fall,Clear,17,14,3
2012-08-30,2012,August,3,Thursday,Fall,Clear,5,5,0
2012-08-30,2012,August,4,Thursday,Fall,Clear,8,4,4
2012-08-30,2012,August,5,Thursday,Fall,Clear,35,33,2
2012-08-30,2012,August,6,Thursday,Fall,Clear,163,155,8
2012-08-30,2012,August,7,Thursday,Fall,Clear,532,501,31
2012-08-30,2012,August,8,Thursday,Fall,Clear,754,701,53
2012-08-30,2012,August,9,Thursday,Fall,Clear,396,339,57
2012-08-30,2012,August,10,Thursday,Fall,Clear,234,161,73
2012-08-30,2012,August,11,Thursday,Fall,Clear,276,191,85
2012-08-30,2012,August,12,Thursday,Fall,Clear,294,221,73
2012-08-30,2012,August,13,Thursday,Fall,Clear,290,214,76
2012-08-30,2012,August,14,Thursday,Fall,Clear,273,199,74
2012-08-30,2012,August,15,Thursday,Fall,Clear,338,239,99
2012-08-30,2012,August,16,Thursday,Fall,Clear,482,405,77
2012-08-30,2012,August,17,Thursday,Fall,Clear,844,751,93
2012-08-30,2012,August,18,Thursday,Fall,Clear,853,744,109
2012-08-30,2012,August,19,Thursday,Fall,Clear,610,532,78
2012-08-30,2012,August,20,Thursday,Fall,Clear,471,403,68
2012-08-30,2012,August,21,Thursday,Fall,Clear,307,275,32
2012-08-30,2012,August,22,Thursday,Fall,Clear,291,253,38
2012-08-30,2012,August,23,Thursday,Fall,Clear,152,133,19
2012-08-31,2012,August,0,Friday,Fall,Clear,82,69,13
2012-08-31,2012,August,1,Friday,Fall,Clear,32,24,8
2012-08-31,2012,August,2,Friday,Fall,Clear,20,11,9
2012-08-31,2012,August,3,Friday,Fall,Clear,5,2,3
2012-08-31,2012,August,4,Friday,Fall,Clear,7,7,0
2012-08-31,2012,August,5,Friday,Fall,Clear,29,27,2
2012-08-31,2012,August,6,Friday,Fall,Cloudy,108,101,7
2012-08-31,2012,August,7,Friday,Fall,Cloudy,421,400,21
2012-08-31,2012,August,8,Friday,Fall,Cloudy,690,654,36
2012-08-31,2012,August,9,Friday,Fall,Clear,398,337,61
2012-08-31,2012,August,10,Friday,Fall,Clear,256,197,59
2012-08-31,2012,August,11,Friday,Fall,Clear,309,221,88
2012-08-31,2012,August,12,Friday,Fall,Clear,410,290,120
2012-08-31,2012,August,13,Friday,Fall,Clear,368,271,97
2012-08-31,2012,August,14,Friday,Fall,Clear,436,324,112
2012-08-31,2012,August,15,Friday,Fall,Clear,526,417,109
2012-08-31,2012,August,16,Friday,Fall,Clear,528,417,111
2012-08-31,2012,August,17,Friday,Fall,Clear,617,488,129
2012-08-31,2012,August,18,Friday,Fall,Clear,546,459,87
2012-08-31,2012,August,19,Friday,Fall,Clear,452,361,91
2012-08-31,2012,August,20,Friday,Fall,Clear,356,254,102
2012-08-31,2012,August,21,Friday,Fall,Clear,303,232,71
2012-08-31,2012,August,22,Friday,Fall,Clear,277,212,65
2012-08-31,2012,August,23,Friday,Fall,Clear,174,142,32
2012-09-01,2012,September,0,Saturday,Fall,Clear,168,146,22
2012-09-01,2012,September,1,Saturday,Fall,Clear,79,68,11
2012-09-01,2012,September,2,Saturday,Fall,Clear,69,61,8
2012-09-01,2012,September,3,Saturday,Fall,Clear,35,29,6
2012-09-01,2012,September,4,Saturday,Fall,Clear,12,9,3
2012-09-01,2012,September,5,Saturday,Fall,Clear,22,20,2
2012-09-01,2012,September,6,Saturday,Fall,Clear,36,23,13
2012-09-01,2012,September,7,Saturday,Fall,Cloudy,66,58,8
2012-09-01,2012,September,8,Saturday,Fall,Cloudy,162,134,28
2012-09-01,2012,September,9,Saturday,Fall,Cloudy,237,175,62
2012-09-01,2012,September,10,Saturday,Fall,Cloudy,417,289,128
2012-09-01,2012,September,11,Saturday,Fall,Cloudy,492,273,219
2012-09-01,2012,September,12,Saturday,Fall,Cloudy,471,284,187
2012-09-01,2012,September,13,Saturday,Fall,Cloudy,504,267,237
2012-09-01,2012,September,14,Saturday,Fall,Cloudy,514,274,240
2012-09-01,2012,September,15,Saturday,Fall,Cloudy,563,306,257
2012-09-01,2012,September,16,Saturday,Fall,Cloudy,462,253,209
2012-09-01,2012,September,17,Saturday,Fall,Cloudy,463,258,205
2012-09-01,2012,September,18,Saturday,Fall,Cloudy,442,258,184
2012-09-01,2012,September,19,Saturday,Fall,Light Snow/Rain,392,235,157
2012-09-01,2012,September,20,Saturday,Fall,Light Snow/Rain,207,140,67
2012-09-01,2012,September,21,Saturday,Fall,Light Snow/Rain,104,83,21
2012-09-01,2012,September,22,Saturday,Fall,Cloudy,78,57,21
2012-09-01,2012,September,23,Saturday,Fall,Clear,145,88,57
2012-09-02,2012,September,0,Sunday,Fall,Cloudy,99,72,27
2012-09-02,2012,September,1,Sunday,Fall,Clear,73,58,15
2012-09-02,2012,September,2,Sunday,Fall,Clear,84,56,28
2012-09-02,2012,September,3,Sunday,Fall,Clear,42,33,9
2012-09-02,2012,September,4,Sunday,Fall,Clear,22,15,7
2012-09-02,2012,September,5,Sunday,Fall,Clear,12,10,2
2012-09-02,2012,September,6,Sunday,Fall,Cloudy,15,13,2
2012-09-02,2012,September,7,Sunday,Fall,Clear,42,29,13
2012-09-02,2012,September,8,Sunday,Fall,Clear,129,99,30
2012-09-02,2012,September,9,Sunday,Fall,Cloudy,232,144,88
2012-09-02,2012,September,10,Sunday,Fall,Cloudy,388,230,158
2012-09-02,2012,September,11,Sunday,Fall,Cloudy,489,263,226
2012-09-02,2012,September,12,Sunday,Fall,Light Snow/Rain,545,297,248
2012-09-02,2012,September,13,Sunday,Fall,Light Snow/Rain,493,230,263
2012-09-02,2012,September,14,Sunday,Fall,Light Snow/Rain,457,208,249
2012-09-02,2012,September,15,Sunday,Fall,Light Snow/Rain,355,176,179
2012-09-02,2012,September,16,Sunday,Fall,Clear,474,252,222
2012-09-02,2012,September,17,Sunday,Fall,Clear,503,284,219
2012-09-02,2012,September,18,Sunday,Fall,Clear,500,273,227
2012-09-02,2012,September,19,Sunday,Fall,Cloudy,292,152,140
2012-09-02,2012,September,20,Sunday,Fall,Cloudy,104,41,63
2012-09-02,2012,September,21,Sunday,Fall,Clear,171,92,79
2012-09-02,2012,September,22,Sunday,Fall,Light Snow/Rain,166,100,66
2012-09-02,2012,September,23,Sunday,Fall,Light Snow/Rain,123,70,53
2012-09-03,2012,September,0,Monday,Fall,Cloudy,104,62,42
2012-09-03,2012,September,1,Monday,Fall,Cloudy,55,37,18
2012-09-03,2012,September,2,Monday,Fall,Clear,40,30,10
2012-09-03,2012,September,3,Monday,Fall,Clear,28,22,6
2012-09-03,2012,September,4,Monday,Fall,Clear,11,5,6
2012-09-03,2012,September,5,Monday,Fall,Clear,4,3,1
2012-09-03,2012,September,6,Monday,Fall,Clear,15,12,3
2012-09-03,2012,September,7,Monday,Fall,Clear,43,37,6
2012-09-03,2012,September,8,Monday,Fall,Cloudy,127,91,36
2012-09-03,2012,September,9,Monday,Fall,Cloudy,229,158,71
2012-09-03,2012,September,10,Monday,Fall,Cloudy,359,224,135
2012-09-03,2012,September,11,Monday,Fall,Cloudy,459,272,187
2012-09-03,2012,September,12,Monday,Fall,Cloudy,543,352,191
2012-09-03,2012,September,13,Monday,Fall,Cloudy,566,357,209
2012-09-03,2012,September,14,Monday,Fall,Clear,512,349,163
2012-09-03,2012,September,15,Monday,Fall,Clear,449,281,168
2012-09-03,2012,September,16,Monday,Fall,Clear,500,335,165
2012-09-03,2012,September,17,Monday,Fall,Clear,498,317,181
2012-09-03,2012,September,18,Monday,Fall,Clear,482,337,145
2012-09-03,2012,September,19,Monday,Fall,Clear,374,301,73
2012-09-03,2012,September,20,Monday,Fall,Clear,261,183,78
2012-09-03,2012,September,21,Monday,Fall,Clear,184,142,42
2012-09-03,2012,September,22,Monday,Fall,Cloudy,121,104,17
2012-09-03,2012,September,23,Monday,Fall,Cloudy,70,58,12
2012-09-04,2012,September,0,Tuesday,Fall,Cloudy,29,19,10
2012-09-04,2012,September,1,Tuesday,Fall,Clear,24,9,15
2012-09-04,2012,September,2,Tuesday,Fall,Clear,5,4,1
2012-09-04,2012,September,3,Tuesday,Fall,Cloudy,10,9,1
2012-09-04,2012,September,4,Tuesday,Fall,Cloudy,8,8,0
2012-09-04,2012,September,5,Tuesday,Fall,Cloudy,38,37,1
2012-09-04,2012,September,6,Tuesday,Fall,Cloudy,172,165,7
2012-09-04,2012,September,7,Tuesday,Fall,Cloudy,493,480,13
2012-09-04,2012,September,8,Tuesday,Fall,Clear,632,617,15
2012-09-04,2012,September,9,Tuesday,Fall,Cloudy,323,293,30
2012-09-04,2012,September,10,Tuesday,Fall,Cloudy,172,130,42
2012-09-04,2012,September,11,Tuesday,Fall,Cloudy,198,159,39
2012-09-04,2012,September,12,Tuesday,Fall,Clear,287,233,54
2012-09-04,2012,September,13,Tuesday,Fall,Clear,275,203,72
2012-09-04,2012,September,14,Tuesday,Fall,Clear,274,202,72
2012-09-04,2012,September,15,Tuesday,Fall,Clear,292,224,68
2012-09-04,2012,September,16,Tuesday,Fall,Clear,458,397,61
2012-09-04,2012,September,17,Tuesday,Fall,Clear,856,746,110
2012-09-04,2012,September,18,Tuesday,Fall,Clear,839,745,94
2012-09-04,2012,September,19,Tuesday,Fall,Clear,552,502,50
2012-09-04,2012,September,20,Tuesday,Fall,Clear,385,338,47
2012-09-04,2012,September,21,Tuesday,Fall,Clear,268,240,28
2012-09-04,2012,September,22,Tuesday,Fall,Clear,179,154,25
2012-09-04,2012,September,23,Tuesday,Fall,Clear,95,83,12
2012-09-05,2012,September,0,Wednesday,Fall,Clear,37,27,10
2012-09-05,2012,September,1,Wednesday,Fall,Clear,13,11,2
2012-09-05,2012,September,2,Wednesday,Fall,Clear,9,9,0
2012-09-05,2012,September,3,Wednesday,Fall,Clear,4,4,0
2012-09-05,2012,September,4,Wednesday,Fall,Clear,5,3,2
2012-09-05,2012,September,5,Wednesday,Fall,Cloudy,40,39,1
2012-09-05,2012,September,6,Wednesday,Fall,Clear,210,203,7
2012-09-05,2012,September,7,Wednesday,Fall,Cloudy,500,489,11
2012-09-05,2012,September,8,Wednesday,Fall,Clear,725,692,33
2012-09-05,2012,September,9,Wednesday,Fall,Clear,290,263,27
2012-09-05,2012,September,10,Wednesday,Fall,Cloudy,235,181,54
2012-09-05,2012,September,11,Wednesday,Fall,Cloudy,217,156,61
2012-09-05,2012,September,12,Wednesday,Fall,Clear,266,217,49
2012-09-05,2012,September,13,Wednesday,Fall,Clear,234,184,50
2012-09-05,2012,September,14,Wednesday,Fall,Clear,211,177,34
2012-09-05,2012,September,15,Wednesday,Fall,Clear,245,204,41
2012-09-05,2012,September,16,Wednesday,Fall,Clear,430,344,86
2012-09-05,2012,September,17,Wednesday,Fall,Clear,863,780,83
2012-09-05,2012,September,18,Wednesday,Fall,Clear,839,757,82
2012-09-05,2012,September,19,Wednesday,Fall,Clear,662,598,64
2012-09-05,2012,September,20,Wednesday,Fall,Clear,412,357,55
2012-09-05,2012,September,21,Wednesday,Fall,Clear,296,278,18
2012-09-05,2012,September,22,Wednesday,Fall,Clear,219,181,38
2012-09-05,2012,September,23,Wednesday,Fall,Clear,150,126,24
2012-09-06,2012,September,0,Thursday,Fall,Cloudy,65,35,30
2012-09-06,2012,September,1,Thursday,Fall,Cloudy,18,16,2
2012-09-06,2012,September,2,Thursday,Fall,Clear,8,7,1
2012-09-06,2012,September,3,Thursday,Fall,Clear,9,9,0
2012-09-06,2012,September,4,Thursday,Fall,Cloudy,8,8,0
2012-09-06,2012,September,5,Thursday,Fall,Cloudy,38,35,3
2012-09-06,2012,September,6,Thursday,Fall,Cloudy,200,189,11
2012-09-06,2012,September,7,Thursday,Fall,Cloudy,482,461,21
2012-09-06,2012,September,8,Thursday,Fall,Light Snow/Rain,646,622,24
2012-09-06,2012,September,9,Thursday,Fall,Light Snow/Rain,123,115,8
2012-09-06,2012,September,10,Thursday,Fall,Light Snow/Rain,49,40,9
2012-09-06,2012,September,11,Thursday,Fall,Light Snow/Rain,62,52,10
2012-09-06,2012,September,12,Thursday,Fall,Cloudy,137,126,11
2012-09-06,2012,September,13,Thursday,Fall,Cloudy,191,152,39
2012-09-06,2012,September,14,Thursday,Fall,Clear,216,178,38
2012-09-06,2012,September,15,Thursday,Fall,Clear,270,228,42
2012-09-06,2012,September,16,Thursday,Fall,Clear,416,374,42
2012-09-06,2012,September,17,Thursday,Fall,Clear,808,741,67
2012-09-06,2012,September,18,Thursday,Fall,Clear,835,761,74
2012-09-06,2012,September,19,Thursday,Fall,Clear,558,504,54
2012-09-06,2012,September,20,Thursday,Fall,Clear,406,356,50
2012-09-06,2012,September,21,Thursday,Fall,Clear,272,240,32
2012-09-06,2012,September,22,Thursday,Fall,Clear,217,193,24
2012-09-06,2012,September,23,Thursday,Fall,Clear,169,150,19
2012-09-07,2012,September,0,Friday,Fall,Clear,96,79,17
2012-09-07,2012,September,1,Friday,Fall,Clear,29,19,10
2012-09-07,2012,September,2,Friday,Fall,Clear,11,10,1
2012-09-07,2012,September,3,Friday,Fall,Clear,9,9,0
2012-09-07,2012,September,4,Friday,Fall,Clear,8,7,1
2012-09-07,2012,September,5,Friday,Fall,Clear,40,39,1
2012-09-07,2012,September,6,Friday,Fall,Clear,140,135,5
2012-09-07,2012,September,7,Friday,Fall,Clear,486,465,21
2012-09-07,2012,September,8,Friday,Fall,Clear,719,690,29
2012-09-07,2012,September,9,Friday,Fall,Clear,344,311,33
2012-09-07,2012,September,10,Friday,Fall,Clear,224,171,53
2012-09-07,2012,September,11,Friday,Fall,Clear,296,215,81
2012-09-07,2012,September,12,Friday,Fall,Clear,323,247,76
2012-09-07,2012,September,13,Friday,Fall,Clear,354,283,71
2012-09-07,2012,September,14,Friday,Fall,Clear,253,187,66
2012-09-07,2012,September,15,Friday,Fall,Clear,331,265,66
2012-09-07,2012,September,16,Friday,Fall,Clear,470,395,75
2012-09-07,2012,September,17,Friday,Fall,Clear,772,684,88
2012-09-07,2012,September,18,Friday,Fall,Clear,792,697,95
2012-09-07,2012,September,19,Friday,Fall,Clear,568,498,70
2012-09-07,2012,September,20,Friday,Fall,Clear,391,340,51
2012-09-07,2012,September,21,Friday,Fall,Clear,301,246,55
2012-09-07,2012,September,22,Friday,Fall,Clear,299,247,52
2012-09-07,2012,September,23,Friday,Fall,Clear,248,220,28
2012-09-08,2012,September,0,Saturday,Fall,Clear,150,130,20
2012-09-08,2012,September,1,Saturday,Fall,Cloudy,117,107,10
2012-09-08,2012,September,2,Saturday,Fall,Clear,77,68,9
2012-09-08,2012,September,3,Saturday,Fall,Cloudy,43,40,3
2012-09-08,2012,September,4,Saturday,Fall,Cloudy,11,8,3
2012-09-08,2012,September,5,Saturday,Fall,Cloudy,15,13,2
2012-09-08,2012,September,6,Saturday,Fall,Cloudy,34,26,8
2012-09-08,2012,September,7,Saturday,Fall,Clear,82,71,11
2012-09-08,2012,September,8,Saturday,Fall,Clear,230,197,33
2012-09-08,2012,September,9,Saturday,Fall,Clear,348,261,87
2012-09-08,2012,September,10,Saturday,Fall,Clear,422,322,100
2012-09-08,2012,September,11,Saturday,Fall,Clear,578,405,173
2012-09-08,2012,September,12,Saturday,Fall,Clear,694,474,220
2012-09-08,2012,September,13,Saturday,Fall,Clear,668,435,233
2012-09-08,2012,September,14,Saturday,Fall,Clear,626,366,260
2012-09-08,2012,September,15,Saturday,Fall,Light Snow/Rain,512,337,175
2012-09-08,2012,September,16,Saturday,Fall,Light Snow/Rain,114,95,19
2012-09-08,2012,September,17,Saturday,Fall,Light Snow/Rain,171,119,52
2012-09-08,2012,September,18,Saturday,Fall,Light Snow/Rain,167,140,27
2012-09-08,2012,September,19,Saturday,Fall,Light Snow/Rain,215,187,28
2012-09-08,2012,September,20,Saturday,Fall,Cloudy,194,166,28
2012-09-08,2012,September,21,Saturday,Fall,Cloudy,181,155,26
2012-09-08,2012,September,22,Saturday,Fall,Cloudy,194,176,18
2012-09-08,2012,September,23,Saturday,Fall,Cloudy,133,121,12
2012-09-09,2012,September,0,Sunday,Fall,Cloudy,124,106,18
2012-09-09,2012,September,1,Sunday,Fall,Clear,124,104,20
2012-09-09,2012,September,2,Sunday,Fall,Clear,96,81,15
2012-09-09,2012,September,3,Sunday,Fall,Clear,46,32,14
2012-09-09,2012,September,4,Sunday,Fall,Clear,28,16,12
2012-09-09,2012,September,5,Sunday,Fall,Clear,55,39,16
2012-09-09,2012,September,6,Sunday,Fall,Clear,35,24,11
2012-09-09,2012,September,7,Sunday,Fall,Clear,70,50,20
2012-09-09,2012,September,8,Sunday,Fall,Clear,170,143,27
2012-09-09,2012,September,9,Sunday,Fall,Clear,299,214,85
2012-09-09,2012,September,10,Sunday,Fall,Clear,495,323,172
2012-09-09,2012,September,11,Sunday,Fall,Clear,585,391,194
2012-09-09,2012,September,12,Sunday,Fall,Clear,757,510,247
2012-09-09,2012,September,13,Sunday,Fall,Clear,729,491,238
2012-09-09,2012,September,14,Sunday,Fall,Clear,647,415,232
2012-09-09,2012,September,15,Sunday,Fall,Clear,696,412,284
2012-09-09,2012,September,16,Sunday,Fall,Clear,701,473,228
2012-09-09,2012,September,17,Sunday,Fall,Clear,671,458,213
2012-09-09,2012,September,18,Sunday,Fall,Clear,560,404,156
2012-09-09,2012,September,19,Sunday,Fall,Clear,496,362,134
2012-09-09,2012,September,20,Sunday,Fall,Clear,356,265,91
2012-09-09,2012,September,21,Sunday,Fall,Clear,206,149,57
2012-09-09,2012,September,22,Sunday,Fall,Clear,189,125,64
2012-09-09,2012,September,23,Sunday,Fall,Clear,92,70,22
2012-09-10,2012,September,0,Monday,Fall,Clear,41,35,6
2012-09-10,2012,September,1,Monday,Fall,Clear,18,11,7
2012-09-10,2012,September,2,Monday,Fall,Clear,17,6,11
2012-09-10,2012,September,3,Monday,Fall,Clear,12,7,5
2012-09-10,2012,September,4,Monday,Fall,Clear,5,4,1
2012-09-10,2012,September,5,Monday,Fall,Clear,40,36,4
2012-09-10,2012,September,6,Monday,Fall,Clear,180,172,8
2012-09-10,2012,September,7,Monday,Fall,Clear,447,427,20
2012-09-10,2012,September,8,Monday,Fall,Clear,730,697,33
2012-09-10,2012,September,9,Monday,Fall,Clear,361,321,40
2012-09-10,2012,September,10,Monday,Fall,Clear,210,168,42
2012-09-10,2012,September,11,Monday,Fall,Clear,236,167,69
2012-09-10,2012,September,12,Monday,Fall,Clear,332,256,76
2012-09-10,2012,September,13,Monday,Fall,Clear,323,251,72
2012-09-10,2012,September,14,Monday,Fall,Clear,340,233,107
2012-09-10,2012,September,15,Monday,Fall,Clear,346,231,115
2012-09-10,2012,September,16,Monday,Fall,Clear,488,380,108
2012-09-10,2012,September,17,Monday,Fall,Clear,871,744,127
2012-09-10,2012,September,18,Monday,Fall,Clear,968,857,111
2012-09-10,2012,September,19,Monday,Fall,Clear,633,562,71
2012-09-10,2012,September,20,Monday,Fall,Clear,390,356,34
2012-09-10,2012,September,21,Monday,Fall,Clear,285,256,29
2012-09-10,2012,September,22,Monday,Fall,Clear,159,144,15
2012-09-10,2012,September,23,Monday,Fall,Clear,93,86,7
2012-09-11,2012,September,0,Tuesday,Fall,Clear,32,27,5
2012-09-11,2012,September,1,Tuesday,Fall,Clear,10,10,0
2012-09-11,2012,September,2,Tuesday,Fall,Clear,6,5,1
2012-09-11,2012,September,3,Tuesday,Fall,Clear,8,7,1
2012-09-11,2012,September,4,Tuesday,Fall,Clear,9,8,1
2012-09-11,2012,September,5,Tuesday,Fall,Clear,44,41,3
2012-09-11,2012,September,6,Tuesday,Fall,Clear,211,200,11
2012-09-11,2012,September,7,Tuesday,Fall,Clear,596,572,24
2012-09-11,2012,September,8,Tuesday,Fall,Clear,750,702,48
2012-09-11,2012,September,9,Tuesday,Fall,Clear,358,323,35
2012-09-11,2012,September,10,Tuesday,Fall,Clear,196,142,54
2012-09-11,2012,September,11,Tuesday,Fall,Clear,247,187,60
2012-09-11,2012,September,12,Tuesday,Fall,Clear,316,254,62
2012-09-11,2012,September,13,Tuesday,Fall,Clear,328,256,72
2012-09-11,2012,September,14,Tuesday,Fall,Clear,255,181,74
2012-09-11,2012,September,15,Tuesday,Fall,Clear,326,253,73
2012-09-11,2012,September,16,Tuesday,Fall,Clear,536,437,99
2012-09-11,2012,September,17,Tuesday,Fall,Clear,970,802,168
2012-09-11,2012,September,18,Tuesday,Fall,Clear,877,767,110
2012-09-11,2012,September,19,Tuesday,Fall,Clear,596,540,56
2012-09-11,2012,September,20,Tuesday,Fall,Clear,461,421,40
2012-09-11,2012,September,21,Tuesday,Fall,Clear,310,282,28
2012-09-11,2012,September,22,Tuesday,Fall,Clear,216,189,27
2012-09-11,2012,September,23,Tuesday,Fall,Clear,109,91,18
2012-09-12,2012,September,0,Wednesday,Fall,Clear,49,41,8
2012-09-12,2012,September,1,Wednesday,Fall,Clear,21,19,2
2012-09-12,2012,September,2,Wednesday,Fall,Clear,11,9,2
2012-09-12,2012,September,3,Wednesday,Fall,Clear,7,7,0
2012-09-12,2012,September,4,Wednesday,Fall,Clear,5,5,0
2012-09-12,2012,September,5,Wednesday,Fall,Clear,48,44,4
2012-09-12,2012,September,6,Wednesday,Fall,Clear,205,199,6
2012-09-12,2012,September,7,Wednesday,Fall,Clear,557,533,24
2012-09-12,2012,September,8,Wednesday,Fall,Clear,770,727,43
2012-09-12,2012,September,9,Wednesday,Fall,Clear,328,278,50
2012-09-12,2012,September,10,Wednesday,Fall,Clear,205,148,57
2012-09-12,2012,September,11,Wednesday,Fall,Clear,232,181,51
2012-09-12,2012,September,12,Wednesday,Fall,Clear,352,264,88
2012-09-12,2012,September,13,Wednesday,Fall,Clear,323,238,85
2012-09-12,2012,September,14,Wednesday,Fall,Clear,278,200,78
2012-09-12,2012,September,15,Wednesday,Fall,Clear,318,243,75
2012-09-12,2012,September,16,Wednesday,Fall,Clear,509,419,90
2012-09-12,2012,September,17,Wednesday,Fall,Clear,925,811,114
2012-09-12,2012,September,18,Wednesday,Fall,Clear,977,886,91
2012-09-12,2012,September,19,Wednesday,Fall,Clear,635,557,78
2012-09-12,2012,September,20,Wednesday,Fall,Clear,470,432,38
2012-09-12,2012,September,21,Wednesday,Fall,Clear,306,279,27
2012-09-12,2012,September,22,Wednesday,Fall,Clear,212,189,23
2012-09-12,2012,September,23,Wednesday,Fall,Clear,127,111,16
2012-09-13,2012,September,0,Thursday,Fall,Clear,57,46,11
2012-09-13,2012,September,1,Thursday,Fall,Clear,28,22,6
2012-09-13,2012,September,2,Thursday,Fall,Clear,9,9,0
2012-09-13,2012,September,3,Thursday,Fall,Clear,11,9,2
2012-09-13,2012,September,4,Thursday,Fall,Clear,6,6,0
2012-09-13,2012,September,5,Thursday,Fall,Clear,57,54,3
2012-09-13,2012,September,6,Thursday,Fall,Clear,195,186,9
2012-09-13,2012,September,7,Thursday,Fall,Clear,571,549,22
2012-09-13,2012,September,8,Thursday,Fall,Clear,758,725,33
2012-09-13,2012,September,9,Thursday,Fall,Clear,338,292,46
2012-09-13,2012,September,10,Thursday,Fall,Clear,212,149,63
2012-09-13,2012,September,11,Thursday,Fall,Clear,254,183,71
2012-09-13,2012,September,12,Thursday,Fall,Clear,297,240,57
2012-09-13,2012,September,13,Thursday,Fall,Clear,283,223,60
2012-09-13,2012,September,14,Thursday,Fall,Clear,274,214,60
2012-09-13,2012,September,15,Thursday,Fall,Clear,352,253,99
2012-09-13,2012,September,16,Thursday,Fall,Clear,491,406,85
2012-09-13,2012,September,17,Thursday,Fall,Clear,884,787,97
2012-09-13,2012,September,18,Thursday,Fall,Clear,852,744,108
2012-09-13,2012,September,19,Thursday,Fall,Clear,674,594,80
2012-09-13,2012,September,20,Thursday,Fall,Clear,463,408,55
2012-09-13,2012,September,21,Thursday,Fall,Clear,317,291,26
2012-09-13,2012,September,22,Thursday,Fall,Clear,251,223,28
2012-09-13,2012,September,23,Thursday,Fall,Clear,170,137,33
2012-09-14,2012,September,0,Friday,Fall,Clear,87,63,24
2012-09-14,2012,September,1,Friday,Fall,Clear,41,35,6
2012-09-14,2012,September,2,Friday,Fall,Clear,30,23,7
2012-09-14,2012,September,3,Friday,Fall,Clear,14,9,5
2012-09-14,2012,September,4,Friday,Fall,Clear,12,11,1
2012-09-14,2012,September,5,Friday,Fall,Clear,41,40,1
2012-09-14,2012,September,6,Friday,Fall,Clear,152,144,8
2012-09-14,2012,September,7,Friday,Fall,Cloudy,454,437,17
2012-09-14,2012,September,8,Friday,Fall,Cloudy,766,715,51
2012-09-14,2012,September,9,Friday,Fall,Cloudy,347,301,46
2012-09-14,2012,September,10,Friday,Fall,Cloudy,246,171,75
2012-09-14,2012,September,11,Friday,Fall,Cloudy,280,196,84
2012-09-14,2012,September,12,Friday,Fall,Cloudy,409,290,119
2012-09-14,2012,September,13,Friday,Fall,Cloudy,408,301,107
2012-09-14,2012,September,14,Friday,Fall,Cloudy,371,258,113
2012-09-14,2012,September,15,Friday,Fall,Cloudy,367,273,94
2012-09-14,2012,September,16,Friday,Fall,Cloudy,563,454,109
2012-09-14,2012,September,17,Friday,Fall,Clear,894,757,137
2012-09-14,2012,September,18,Friday,Fall,Clear,808,692,116
2012-09-14,2012,September,19,Friday,Fall,Clear,579,496,83
2012-09-14,2012,September,20,Friday,Fall,Clear,404,337,67
2012-09-14,2012,September,21,Friday,Fall,Clear,312,270,42
2012-09-14,2012,September,22,Friday,Fall,Clear,229,189,40
2012-09-14,2012,September,23,Friday,Fall,Clear,195,168,27
2012-09-15,2012,September,0,Saturday,Fall,Clear,207,169,38
2012-09-15,2012,September,1,Saturday,Fall,Clear,109,101,8
2012-09-15,2012,September,2,Saturday,Fall,Clear,93,75,18
2012-09-15,2012,September,3,Saturday,Fall,Clear,37,31,6
2012-09-15,2012,September,4,Saturday,Fall,Cloudy,6,3,3
2012-09-15,2012,September,5,Saturday,Fall,Clear,16,15,1
2012-09-15,2012,September,6,Saturday,Fall,Clear,33,27,6
2012-09-15,2012,September,7,Saturday,Fall,Clear,73,63,10
2012-09-15,2012,September,8,Saturday,Fall,Clear,212,169,43
2012-09-15,2012,September,9,Saturday,Fall,Clear,342,263,79
2012-09-15,2012,September,10,Saturday,Fall,Clear,442,323,119
2012-09-15,2012,September,11,Saturday,Fall,Clear,627,399,228
2012-09-15,2012,September,12,Saturday,Fall,Clear,706,419,287
2012-09-15,2012,September,13,Saturday,Fall,Clear,704,377,327
2012-09-15,2012,September,14,Saturday,Fall,Clear,715,390,325
2012-09-15,2012,September,15,Saturday,Fall,Cloudy,654,342,312
2012-09-15,2012,September,16,Saturday,Fall,Cloudy,783,433,350
2012-09-15,2012,September,17,Saturday,Fall,Cloudy,729,434,295
2012-09-15,2012,September,18,Saturday,Fall,Cloudy,614,382,232
2012-09-15,2012,September,19,Saturday,Fall,Clear,478,309,169
2012-09-15,2012,September,20,Saturday,Fall,Clear,330,241,89
2012-09-15,2012,September,21,Saturday,Fall,Clear,296,210,86
2012-09-15,2012,September,22,Saturday,Fall,Clear,279,197,82
2012-09-15,2012,September,23,Saturday,Fall,Clear,229,182,47
2012-09-16,2012,September,0,Sunday,Fall,Clear,151,123,28
2012-09-16,2012,September,1,Sunday,Fall,Clear,117,82,35
2012-09-16,2012,September,2,Sunday,Fall,Clear,89,62,27
2012-09-16,2012,September,3,Sunday,Fall,Clear,48,38,10
2012-09-16,2012,September,4,Sunday,Fall,Clear,8,6,2
2012-09-16,2012,September,5,Sunday,Fall,Clear,13,10,3
2012-09-16,2012,September,6,Sunday,Fall,Clear,35,26,9
2012-09-16,2012,September,7,Sunday,Fall,Clear,71,43,28
2012-09-16,2012,September,8,Sunday,Fall,Clear,128,94,34
2012-09-16,2012,September,9,Sunday,Fall,Clear,296,226,70
2012-09-16,2012,September,10,Sunday,Fall,Clear,490,330,160
2012-09-16,2012,September,11,Sunday,Fall,Clear,559,376,183
2012-09-16,2012,September,12,Sunday,Fall,Clear,656,468,188
2012-09-16,2012,September,13,Sunday,Fall,Clear,694,454,240
2012-09-16,2012,September,14,Sunday,Fall,Clear,635,410,225
2012-09-16,2012,September,15,Sunday,Fall,Clear,557,342,215
2012-09-16,2012,September,16,Sunday,Fall,Clear,596,402,194
2012-09-16,2012,September,17,Sunday,Fall,Clear,570,393,177
2012-09-16,2012,September,18,Sunday,Fall,Clear,481,361,120
2012-09-16,2012,September,19,Sunday,Fall,Clear,403,312,91
2012-09-16,2012,September,20,Sunday,Fall,Clear,324,267,57
2012-09-16,2012,September,21,Sunday,Fall,Clear,191,148,43
2012-09-16,2012,September,22,Sunday,Fall,Clear,127,109,18
2012-09-16,2012,September,23,Sunday,Fall,Clear,94,85,9
2012-09-17,2012,September,0,Monday,Fall,Clear,45,31,14
2012-09-17,2012,September,1,Monday,Fall,Clear,21,12,9
2012-09-17,2012,September,2,Monday,Fall,Clear,13,8,5
2012-09-17,2012,September,3,Monday,Fall,Clear,7,7,0
2012-09-17,2012,September,4,Monday,Fall,Clear,11,9,2
2012-09-17,2012,September,5,Monday,Fall,Clear,45,44,1
2012-09-17,2012,September,6,Monday,Fall,Clear,164,157,7
2012-09-17,2012,September,7,Monday,Fall,Clear,492,474,18
2012-09-17,2012,September,8,Monday,Fall,Clear,683,647,36
2012-09-17,2012,September,9,Monday,Fall,Clear,299,265,34
2012-09-17,2012,September,10,Monday,Fall,Cloudy,202,129,73
2012-09-17,2012,September,11,Monday,Fall,Cloudy,252,191,61
2012-09-17,2012,September,12,Monday,Fall,Cloudy,295,233,62
2012-09-17,2012,September,13,Monday,Fall,Clear,343,231,112
2012-09-17,2012,September,14,Monday,Fall,Cloudy,332,203,129
2012-09-17,2012,September,15,Monday,Fall,Cloudy,338,256,82
2012-09-17,2012,September,16,Monday,Fall,Cloudy,453,379,74
2012-09-17,2012,September,17,Monday,Fall,Cloudy,842,740,102
2012-09-17,2012,September,18,Monday,Fall,Cloudy,774,708,66
2012-09-17,2012,September,19,Monday,Fall,Cloudy,486,435,51
2012-09-17,2012,September,20,Monday,Fall,Cloudy,340,308,32
2012-09-17,2012,September,21,Monday,Fall,Light Snow/Rain,233,205,28
2012-09-17,2012,September,22,Monday,Fall,Light Snow/Rain,129,109,20
2012-09-17,2012,September,23,Monday,Fall,Light Snow/Rain,70,66,4
2012-09-18,2012,September,0,Tuesday,Fall,Light Snow/Rain,13,11,2
2012-09-18,2012,September,1,Tuesday,Fall,Light Snow/Rain,5,5,0
2012-09-18,2012,September,2,Tuesday,Fall,Light Snow/Rain,4,4,0
2012-09-18,2012,September,3,Tuesday,Fall,Cloudy,6,6,0
2012-09-18,2012,September,4,Tuesday,Fall,Cloudy,7,5,2
2012-09-18,2012,September,5,Tuesday,Fall,Cloudy,48,45,3
2012-09-18,2012,September,6,Tuesday,Fall,Cloudy,167,163,4
2012-09-18,2012,September,7,Tuesday,Fall,Cloudy,356,343,13
2012-09-18,2012,September,8,Tuesday,Fall,Cloudy,672,640,32
2012-09-18,2012,September,9,Tuesday,Fall,Cloudy,293,266,27
2012-09-18,2012,September,10,Tuesday,Fall,Light Snow/Rain,160,130,30
2012-09-18,2012,September,11,Tuesday,Fall,Cloudy,151,115,36
2012-09-18,2012,September,12,Tuesday,Fall,Light Snow/Rain,88,72,16
2012-09-18,2012,September,13,Tuesday,Fall,Cloudy,114,97,17
2012-09-18,2012,September,14,Tuesday,Fall,Light Snow/Rain,143,116,27
2012-09-18,2012,September,15,Tuesday,Fall,Light Snow/Rain,36,35,1
2012-09-18,2012,September,16,Tuesday,Fall,Light Snow/Rain,141,122,19
2012-09-18,2012,September,17,Tuesday,Fall,Light Snow/Rain,338,302,36
2012-09-18,2012,September,18,Tuesday,Fall,Cloudy,281,262,19
2012-09-18,2012,September,19,Tuesday,Fall,Cloudy,324,302,22
2012-09-18,2012,September,20,Tuesday,Fall,Cloudy,290,271,19
2012-09-18,2012,September,21,Tuesday,Fall,Cloudy,207,186,21
2012-09-18,2012,September,22,Tuesday,Fall,Light Snow/Rain,151,137,14
2012-09-18,2012,September,23,Tuesday,Fall,Cloudy,78,67,11
2012-09-19,2012,September,0,Wednesday,Fall,Cloudy,26,23,3
2012-09-19,2012,September,1,Wednesday,Fall,Cloudy,12,12,0
2012-09-19,2012,September,2,Wednesday,Fall,Cloudy,3,3,0
2012-09-19,2012,September,3,Wednesday,Fall,Cloudy,5,4,1
2012-09-19,2012,September,4,Wednesday,Fall,Cloudy,10,10,0
2012-09-19,2012,September,5,Wednesday,Fall,Cloudy,56,54,2
2012-09-19,2012,September,6,Wednesday,Fall,Clear,172,166,6
2012-09-19,2012,September,7,Wednesday,Fall,Clear,545,529,16
2012-09-19,2012,September,8,Wednesday,Fall,Clear,797,758,39
2012-09-19,2012,September,9,Wednesday,Fall,Clear,362,336,26
2012-09-19,2012,September,10,Wednesday,Fall,Clear,192,169,23
2012-09-19,2012,September,11,Wednesday,Fall,Clear,247,203,44
2012-09-19,2012,September,12,Wednesday,Fall,Clear,313,260,53
2012-09-19,2012,September,13,Wednesday,Fall,Clear,289,234,55
2012-09-19,2012,September,14,Wednesday,Fall,Clear,286,227,59
2012-09-19,2012,September,15,Wednesday,Fall,Clear,311,254,57
2012-09-19,2012,September,16,Wednesday,Fall,Clear,466,397,69
2012-09-19,2012,September,17,Wednesday,Fall,Clear,886,812,74
2012-09-19,2012,September,18,Wednesday,Fall,Clear,892,807,85
2012-09-19,2012,September,19,Wednesday,Fall,Clear,611,539,72
2012-09-19,2012,September,20,Wednesday,Fall,Clear,409,378,31
2012-09-19,2012,September,21,Wednesday,Fall,Clear,349,324,25
2012-09-19,2012,September,22,Wednesday,Fall,Clear,229,198,31
2012-09-19,2012,September,23,Wednesday,Fall,Clear,123,106,17
2012-09-20,2012,September,0,Thursday,Fall,Clear,58,46,12
2012-09-20,2012,September,1,Thursday,Fall,Clear,18,14,4
2012-09-20,2012,September,2,Thursday,Fall,Clear,11,9,2
2012-09-20,2012,September,3,Thursday,Fall,Clear,6,6,0
2012-09-20,2012,September,4,Thursday,Fall,Clear,6,6,0
2012-09-20,2012,September,5,Thursday,Fall,Clear,56,52,4
2012-09-20,2012,September,6,Thursday,Fall,Clear,170,161,9
2012-09-20,2012,September,7,Thursday,Fall,Clear,534,514,20
2012-09-20,2012,September,8,Thursday,Fall,Clear,790,746,44
2012-09-20,2012,September,9,Thursday,Fall,Clear,355,330,25
2012-09-20,2012,September,10,Thursday,Fall,Clear,190,157,33
2012-09-20,2012,September,11,Thursday,Fall,Clear,243,206,37
2012-09-20,2012,September,12,Thursday,Fall,Clear,290,233,57
2012-09-20,2012,September,13,Thursday,Fall,Clear,336,268,68
2012-09-20,2012,September,14,Thursday,Fall,Clear,298,222,76
2012-09-20,2012,September,15,Thursday,Fall,Clear,291,231,60
2012-09-20,2012,September,16,Thursday,Fall,Clear,457,385,72
2012-09-20,2012,September,17,Thursday,Fall,Clear,976,885,91
2012-09-20,2012,September,18,Thursday,Fall,Clear,900,781,119
2012-09-20,2012,September,19,Thursday,Fall,Clear,603,534,69
2012-09-20,2012,September,20,Thursday,Fall,Clear,417,360,57
2012-09-20,2012,September,21,Thursday,Fall,Clear,274,246,28
2012-09-20,2012,September,22,Thursday,Fall,Clear,287,252,35
2012-09-20,2012,September,23,Thursday,Fall,Clear,154,137,17
2012-09-21,2012,September,0,Friday,Fall,Clear,66,53,13
2012-09-21,2012,September,1,Friday,Fall,Clear,49,38,11
2012-09-21,2012,September,2,Friday,Fall,Clear,14,8,6
2012-09-21,2012,September,3,Friday,Fall,Clear,12,11,1
2012-09-21,2012,September,4,Friday,Fall,Clear,10,9,1
2012-09-21,2012,September,5,Friday,Fall,Clear,49,47,2
2012-09-21,2012,September,6,Friday,Fall,Clear,165,146,19
2012-09-21,2012,September,7,Friday,Fall,Clear,503,468,35
2012-09-21,2012,September,8,Friday,Fall,Clear,757,726,31
2012-09-21,2012,September,9,Friday,Fall,Clear,383,348,35
2012-09-21,2012,September,10,Friday,Fall,Clear,225,181,44
2012-09-21,2012,September,11,Friday,Fall,Clear,321,242,79
2012-09-21,2012,September,12,Friday,Fall,Clear,389,305,84
2012-09-21,2012,September,13,Friday,Fall,Clear,421,316,105
2012-09-21,2012,September,14,Friday,Fall,Clear,412,299,113
2012-09-21,2012,September,15,Friday,Fall,Clear,423,333,90
2012-09-21,2012,September,16,Friday,Fall,Clear,567,464,103
2012-09-21,2012,September,17,Friday,Fall,Clear,846,739,107
2012-09-21,2012,September,18,Friday,Fall,Clear,805,699,106
2012-09-21,2012,September,19,Friday,Fall,Clear,588,493,95
2012-09-21,2012,September,20,Friday,Fall,Clear,369,315,54
2012-09-21,2012,September,21,Friday,Fall,Clear,312,266,46
2012-09-21,2012,September,22,Friday,Fall,Clear,295,248,47
2012-09-21,2012,September,23,Friday,Fall,Clear,186,163,23
2012-09-22,2012,September,0,Saturday,Fall,Clear,172,140,32
2012-09-22,2012,September,1,Saturday,Fall,Clear,124,106,18
2012-09-22,2012,September,2,Saturday,Fall,Clear,83,73,10
2012-09-22,2012,September,3,Saturday,Fall,Clear,45,39,6
2012-09-22,2012,September,4,Saturday,Fall,Clear,15,10,5
2012-09-22,2012,September,5,Saturday,Fall,Clear,17,15,2
2012-09-22,2012,September,6,Saturday,Fall,Clear,41,35,6
2012-09-22,2012,September,7,Saturday,Fall,Clear,77,70,7
2012-09-22,2012,September,8,Saturday,Fall,Clear,218,197,21
2012-09-22,2012,September,9,Saturday,Fall,Clear,377,289,88
2012-09-22,2012,September,10,Saturday,Fall,Clear,474,350,124
2012-09-22,2012,September,11,Saturday,Fall,Clear,626,437,189
2012-09-22,2012,September,12,Saturday,Fall,Clear,688,460,228
2012-09-22,2012,September,13,Saturday,Fall,Clear,707,434,273
2012-09-22,2012,September,14,Saturday,Fall,Clear,654,404,250
2012-09-22,2012,September,15,Saturday,Fall,Clear,750,443,307
2012-09-22,2012,September,16,Saturday,Fall,Clear,680,427,253
2012-09-22,2012,September,17,Saturday,Fall,Clear,646,451,195
2012-09-22,2012,September,18,Saturday,Fall,Clear,598,427,171
2012-09-22,2012,September,19,Saturday,Fall,Clear,407,308,99
2012-09-22,2012,September,20,Saturday,Fall,Clear,325,249,76
2012-09-22,2012,September,21,Saturday,Fall,Clear,261,202,59
2012-09-22,2012,September,22,Saturday,Fall,Clear,239,180,59
2012-09-22,2012,September,23,Saturday,Fall,Clear,171,137,34
2012-09-23,2012,September,0,Sunday,Winter,Clear,180,146,34
2012-09-23,2012,September,1,Sunday,Winter,Clear,142,119,23
2012-09-23,2012,September,2,Sunday,Winter,Clear,95,77,18
2012-09-23,2012,September,3,Sunday,Winter,Clear,54,41,13
2012-09-23,2012,September,4,Sunday,Winter,Clear,10,9,1
2012-09-23,2012,September,5,Sunday,Winter,Clear,6,5,1
2012-09-23,2012,September,6,Sunday,Winter,Clear,16,11,5
2012-09-23,2012,September,7,Sunday,Winter,Clear,57,48,9
2012-09-23,2012,September,8,Sunday,Winter,Clear,175,137,38
2012-09-23,2012,September,9,Sunday,Winter,Clear,276,205,71
2012-09-23,2012,September,10,Sunday,Winter,Clear,489,351,138
2012-09-23,2012,September,11,Sunday,Winter,Clear,570,384,186
2012-09-23,2012,September,12,Sunday,Winter,Clear,776,526,250
2012-09-23,2012,September,13,Sunday,Winter,Clear,702,445,257
2012-09-23,2012,September,14,Sunday,Winter,Clear,666,400,266
2012-09-23,2012,September,15,Sunday,Winter,Clear,640,375,265
2012-09-23,2012,September,16,Sunday,Winter,Clear,691,437,254
2012-09-23,2012,September,17,Sunday,Winter,Clear,723,496,227
2012-09-23,2012,September,18,Sunday,Winter,Clear,540,405,135
2012-09-23,2012,September,19,Sunday,Winter,Clear,413,331,82
2012-09-23,2012,September,20,Sunday,Winter,Clear,252,192,60
2012-09-23,2012,September,21,Sunday,Winter,Cloudy,196,145,51
2012-09-23,2012,September,22,Sunday,Winter,Clear,138,98,40
2012-09-23,2012,September,23,Sunday,Winter,Cloudy,100,70,30
2012-09-24,2012,September,0,Monday,Winter,Clear,64,54,10
2012-09-24,2012,September,1,Monday,Winter,Clear,18,12,6
2012-09-24,2012,September,2,Monday,Winter,Cloudy,8,8,0
2012-09-24,2012,September,3,Monday,Winter,Clear,5,5,0
2012-09-24,2012,September,4,Monday,Winter,Clear,8,8,0
2012-09-24,2012,September,5,Monday,Winter,Clear,37,35,2
2012-09-24,2012,September,6,Monday,Winter,Clear,168,162,6
2012-09-24,2012,September,7,Monday,Winter,Clear,530,513,17
2012-09-24,2012,September,8,Monday,Winter,Clear,750,719,31
2012-09-24,2012,September,9,Monday,Winter,Clear,328,286,42
2012-09-24,2012,September,10,Monday,Winter,Clear,198,146,52
2012-09-24,2012,September,11,Monday,Winter,Clear,238,167,71
2012-09-24,2012,September,12,Monday,Winter,Clear,342,265,77
2012-09-24,2012,September,13,Monday,Winter,Clear,328,248,80
2012-09-24,2012,September,14,Monday,Winter,Clear,303,226,77
2012-09-24,2012,September,15,Monday,Winter,Clear,300,216,84
2012-09-24,2012,September,16,Monday,Winter,Clear,516,417,99
2012-09-24,2012,September,17,Monday,Winter,Clear,898,809,89
2012-09-24,2012,September,18,Monday,Winter,Clear,853,758,95
2012-09-24,2012,September,19,Monday,Winter,Clear,590,534,56
2012-09-24,2012,September,20,Monday,Winter,Clear,432,380,52
2012-09-24,2012,September,21,Monday,Winter,Clear,256,230,26
2012-09-24,2012,September,22,Monday,Winter,Clear,172,154,18
2012-09-24,2012,September,23,Monday,Winter,Clear,94,83,11
2012-09-25,2012,September,0,Tuesday,Winter,Clear,64,56,8
2012-09-25,2012,September,1,Tuesday,Winter,Clear,13,11,2
2012-09-25,2012,September,2,Tuesday,Winter,Clear,14,9,5
2012-09-25,2012,September,3,Tuesday,Winter,Clear,5,3,2
2012-09-25,2012,September,4,Tuesday,Winter,Clear,9,7,2
2012-09-25,2012,September,5,Tuesday,Winter,Clear,47,46,1
2012-09-25,2012,September,6,Tuesday,Winter,Clear,194,189,5
2012-09-25,2012,September,7,Tuesday,Winter,Clear,556,539,17
2012-09-25,2012,September,8,Tuesday,Winter,Clear,805,764,41
2012-09-25,2012,September,9,Tuesday,Winter,Clear,409,381,28
2012-09-25,2012,September,10,Tuesday,Winter,Clear,170,125,45
2012-09-25,2012,September,11,Tuesday,Winter,Clear,218,155,63
2012-09-25,2012,September,12,Tuesday,Winter,Clear,302,233,69
2012-09-25,2012,September,13,Tuesday,Winter,Clear,305,257,48
2012-09-25,2012,September,14,Tuesday,Winter,Clear,293,213,80
2012-09-25,2012,September,15,Tuesday,Winter,Clear,303,247,56
2012-09-25,2012,September,16,Tuesday,Winter,Clear,495,436,59
2012-09-25,2012,September,17,Tuesday,Winter,Clear,967,860,107
2012-09-25,2012,September,18,Tuesday,Winter,Clear,822,758,64
2012-09-25,2012,September,19,Tuesday,Winter,Clear,539,490,49
2012-09-25,2012,September,20,Tuesday,Winter,Clear,425,388,37
2012-09-25,2012,September,21,Tuesday,Winter,Clear,297,263,34
2012-09-25,2012,September,22,Tuesday,Winter,Clear,188,174,14
2012-09-25,2012,September,23,Tuesday,Winter,Clear,98,89,9
2012-09-26,2012,September,0,Wednesday,Winter,Clear,40,34,6
2012-09-26,2012,September,1,Wednesday,Winter,Clear,29,19,10
2012-09-26,2012,September,2,Wednesday,Winter,Cloudy,17,15,2
2012-09-26,2012,September,3,Wednesday,Winter,Cloudy,10,6,4
2012-09-26,2012,September,4,Wednesday,Winter,Clear,14,12,2
2012-09-26,2012,September,5,Wednesday,Winter,Clear,36,35,1
2012-09-26,2012,September,6,Wednesday,Winter,Clear,182,179,3
2012-09-26,2012,September,7,Wednesday,Winter,Clear,532,523,9
2012-09-26,2012,September,8,Wednesday,Winter,Clear,838,808,30
2012-09-26,2012,September,9,Wednesday,Winter,Clear,334,307,27
2012-09-26,2012,September,10,Wednesday,Winter,Clear,185,156,29
2012-09-26,2012,September,11,Wednesday,Winter,Clear,227,181,46
2012-09-26,2012,September,12,Wednesday,Winter,Clear,316,260,56
2012-09-26,2012,September,13,Wednesday,Winter,Clear,340,273,67
2012-09-26,2012,September,14,Wednesday,Winter,Clear,277,217,60
2012-09-26,2012,September,15,Wednesday,Winter,Clear,300,231,69
2012-09-26,2012,September,16,Wednesday,Winter,Clear,468,397,71
2012-09-26,2012,September,17,Wednesday,Winter,Clear,953,876,77
2012-09-26,2012,September,18,Wednesday,Winter,Clear,884,815,69
2012-09-26,2012,September,19,Wednesday,Winter,Clear,627,589,38
2012-09-26,2012,September,20,Wednesday,Winter,Clear,434,389,45
2012-09-26,2012,September,21,Wednesday,Winter,Clear,360,328,32
2012-09-26,2012,September,22,Wednesday,Winter,Light Snow/Rain,215,194,21
2012-09-26,2012,September,23,Wednesday,Winter,Cloudy,115,102,13
2012-09-27,2012,September,0,Thursday,Winter,Clear,65,60,5
2012-09-27,2012,September,1,Thursday,Winter,Clear,21,16,5
2012-09-27,2012,September,2,Thursday,Winter,Clear,16,13,3
2012-09-27,2012,September,3,Thursday,Winter,Clear,7,7,0
2012-09-27,2012,September,4,Thursday,Winter,Clear,8,6,2
2012-09-27,2012,September,5,Thursday,Winter,Clear,66,64,2
2012-09-27,2012,September,6,Thursday,Winter,Clear,169,164,5
2012-09-27,2012,September,7,Thursday,Winter,Clear,558,546,12
2012-09-27,2012,September,8,Thursday,Winter,Clear,794,774,20
2012-09-27,2012,September,9,Thursday,Winter,Clear,335,305,30
2012-09-27,2012,September,10,Thursday,Winter,Cloudy,208,168,40
2012-09-27,2012,September,11,Thursday,Winter,Cloudy,294,227,67
2012-09-27,2012,September,12,Thursday,Winter,Cloudy,335,272,63
2012-09-27,2012,September,13,Thursday,Winter,Cloudy,326,265,61
2012-09-27,2012,September,14,Thursday,Winter,Cloudy,258,214,44
2012-09-27,2012,September,15,Thursday,Winter,Cloudy,296,255,41
2012-09-27,2012,September,16,Thursday,Winter,Cloudy,472,399,73
2012-09-27,2012,September,17,Thursday,Winter,Cloudy,905,818,87
2012-09-27,2012,September,18,Thursday,Winter,Cloudy,899,822,77
2012-09-27,2012,September,19,Thursday,Winter,Clear,559,511,48
2012-09-27,2012,September,20,Thursday,Winter,Cloudy,457,412,45
2012-09-27,2012,September,21,Thursday,Winter,Light Snow/Rain,253,235,18
2012-09-27,2012,September,22,Thursday,Winter,Light Snow/Rain,47,45,2
2012-09-27,2012,September,23,Thursday,Winter,Light Snow/Rain,45,44,1
2012-09-28,2012,September,0,Friday,Winter,Light Snow/Rain,17,15,2
2012-09-28,2012,September,1,Friday,Winter,Light Snow/Rain,13,13,0
2012-09-28,2012,September,2,Friday,Winter,Light Snow/Rain,10,9,1
2012-09-28,2012,September,3,Friday,Winter,Cloudy,7,7,0
2012-09-28,2012,September,4,Friday,Winter,Light Snow/Rain,12,10,2
2012-09-28,2012,September,5,Friday,Winter,Clear,38,37,1
2012-09-28,2012,September,6,Friday,Winter,Cloudy,138,136,2
2012-09-28,2012,September,7,Friday,Winter,Cloudy,394,384,10
2012-09-28,2012,September,8,Friday,Winter,Clear,705,674,31
2012-09-28,2012,September,9,Friday,Winter,Cloudy,426,399,27
2012-09-28,2012,September,10,Friday,Winter,Cloudy,245,194,51
2012-09-28,2012,September,11,Friday,Winter,Cloudy,361,252,109
2012-09-28,2012,September,12,Friday,Winter,Cloudy,380,286,94
2012-09-28,2012,September,13,Friday,Winter,Cloudy,410,304,106
2012-09-28,2012,September,14,Friday,Winter,Cloudy,399,294,105
2012-09-28,2012,September,15,Friday,Winter,Cloudy,392,288,104
2012-09-28,2012,September,16,Friday,Winter,Cloudy,502,419,83
2012-09-28,2012,September,17,Friday,Winter,Cloudy,808,707,101
2012-09-28,2012,September,18,Friday,Winter,Cloudy,667,609,58
2012-09-28,2012,September,19,Friday,Winter,Light Snow/Rain,508,470,38
2012-09-28,2012,September,20,Friday,Winter,Light Snow/Rain,336,304,32
2012-09-28,2012,September,21,Friday,Winter,Light Snow/Rain,237,205,32
2012-09-28,2012,September,22,Friday,Winter,Cloudy,220,190,30
2012-09-28,2012,September,23,Friday,Winter,Cloudy,190,164,26
2012-09-29,2012,September,0,Saturday,Winter,Clear,149,134,15
2012-09-29,2012,September,1,Saturday,Winter,Clear,101,89,12
2012-09-29,2012,September,2,Saturday,Winter,Cloudy,92,80,12
2012-09-29,2012,September,3,Saturday,Winter,Cloudy,29,25,4
2012-09-29,2012,September,4,Saturday,Winter,Clear,14,8,6
2012-09-29,2012,September,5,Saturday,Winter,Clear,15,13,2
2012-09-29,2012,September,6,Saturday,Winter,Clear,37,33,4
2012-09-29,2012,September,7,Saturday,Winter,Clear,73,61,12
2012-09-29,2012,September,8,Saturday,Winter,Clear,211,174,37
2012-09-29,2012,September,9,Saturday,Winter,Clear,332,263,69
2012-09-29,2012,September,10,Saturday,Winter,Clear,472,338,134
2012-09-29,2012,September,11,Saturday,Winter,Clear,663,446,217
2012-09-29,2012,September,12,Saturday,Winter,Clear,682,491,191
2012-09-29,2012,September,13,Saturday,Winter,Clear,686,453,233
2012-09-29,2012,September,14,Saturday,Winter,Clear,750,448,302
2012-09-29,2012,September,15,Saturday,Winter,Clear,727,456,271
2012-09-29,2012,September,16,Saturday,Winter,Clear,722,447,275
2012-09-29,2012,September,17,Saturday,Winter,Clear,712,456,256
2012-09-29,2012,September,18,Saturday,Winter,Clear,594,420,174
2012-09-29,2012,September,19,Saturday,Winter,Clear,470,351,119
2012-09-29,2012,September,20,Saturday,Winter,Clear,315,227,88
2012-09-29,2012,September,21,Saturday,Winter,Clear,292,219,73
2012-09-29,2012,September,22,Saturday,Winter,Clear,221,173,48
2012-09-29,2012,September,23,Saturday,Winter,Clear,196,161,35
2012-09-30,2012,September,0,Sunday,Winter,Clear,147,112,35
2012-09-30,2012,September,1,Sunday,Winter,Clear,116,85,31
2012-09-30,2012,September,2,Sunday,Winter,Clear,92,71,21
2012-09-30,2012,September,3,Sunday,Winter,Clear,58,41,17
2012-09-30,2012,September,4,Sunday,Winter,Clear,7,6,1
2012-09-30,2012,September,5,Sunday,Winter,Clear,10,9,1
2012-09-30,2012,September,6,Sunday,Winter,Clear,22,20,2
2012-09-30,2012,September,7,Sunday,Winter,Clear,57,43,14
2012-09-30,2012,September,8,Sunday,Winter,Clear,144,126,18
2012-09-30,2012,September,9,Sunday,Winter,Clear,285,211,74
2012-09-30,2012,September,10,Sunday,Winter,Clear,479,319,160
2012-09-30,2012,September,11,Sunday,Winter,Clear,591,369,222
2012-09-30,2012,September,12,Sunday,Winter,Clear,680,474,206
2012-09-30,2012,September,13,Sunday,Winter,Clear,594,414,180
2012-09-30,2012,September,14,Sunday,Winter,Clear,612,404,208
2012-09-30,2012,September,15,Sunday,Winter,Clear,649,419,230
2012-09-30,2012,September,16,Sunday,Winter,Clear,648,446,202
2012-09-30,2012,September,17,Sunday,Winter,Clear,575,380,195
2012-09-30,2012,September,18,Sunday,Winter,Clear,401,310,91
2012-09-30,2012,September,19,Sunday,Winter,Light Snow/Rain,257,223,34
2012-09-30,2012,September,20,Sunday,Winter,Light Snow/Rain,194,163,31
2012-09-30,2012,September,21,Sunday,Winter,Clear,123,104,19
2012-09-30,2012,September,22,Sunday,Winter,Clear,91,76,15
2012-09-30,2012,September,23,Sunday,Winter,Clear,57,49,8
2012-10-01,2012,October,0,Monday,Winter,Clear,45,39,6
2012-10-01,2012,October,1,Monday,Winter,Clear,18,13,5
2012-10-01,2012,October,2,Monday,Winter,Clear,12,6,6
2012-10-01,2012,October,3,Monday,Winter,Clear,7,6,1
2012-10-01,2012,October,4,Monday,Winter,Clear,10,10,0
2012-10-01,2012,October,5,Monday,Winter,Clear,36,34,2
2012-10-01,2012,October,6,Monday,Winter,Clear,155,147,8
2012-10-01,2012,October,7,Monday,Winter,Clear,483,470,13
2012-10-01,2012,October,8,Monday,Winter,Cloudy,784,744,40
2012-10-01,2012,October,9,Monday,Winter,Cloudy,340,314,26
2012-10-01,2012,October,10,Monday,Winter,Clear,179,135,44
2012-10-01,2012,October,11,Monday,Winter,Clear,272,196,76
2012-10-01,2012,October,12,Monday,Winter,Cloudy,323,262,61
2012-10-01,2012,October,13,Monday,Winter,Cloudy,305,225,80
2012-10-01,2012,October,14,Monday,Winter,Cloudy,244,193,51
2012-10-01,2012,October,15,Monday,Winter,Cloudy,329,234,95
2012-10-01,2012,October,16,Monday,Winter,Cloudy,459,408,51
2012-10-01,2012,October,17,Monday,Winter,Light Snow/Rain,856,791,65
2012-10-01,2012,October,18,Monday,Winter,Light Snow/Rain,613,571,42
2012-10-01,2012,October,19,Monday,Winter,Cloudy,516,483,33
2012-10-01,2012,October,20,Monday,Winter,Light Snow/Rain,262,251,11
2012-10-01,2012,October,21,Monday,Winter,Cloudy,218,205,13
2012-10-01,2012,October,22,Monday,Winter,Light Snow/Rain,207,190,17
2012-10-01,2012,October,23,Monday,Winter,Light Snow/Rain,105,88,17
2012-10-02,2012,October,0,Tuesday,Winter,Cloudy,31,30,1
2012-10-02,2012,October,1,Tuesday,Winter,Cloudy,11,11,0
2012-10-02,2012,October,2,Tuesday,Winter,Cloudy,2,2,0
2012-10-02,2012,October,3,Tuesday,Winter,Cloudy,5,4,1
2012-10-02,2012,October,4,Tuesday,Winter,Cloudy,10,8,2
2012-10-02,2012,October,5,Tuesday,Winter,Cloudy,43,42,1
2012-10-02,2012,October,6,Tuesday,Winter,Light Snow/Rain,179,176,3
2012-10-02,2012,October,7,Tuesday,Winter,Light Snow/Rain,260,256,4
2012-10-02,2012,October,8,Tuesday,Winter,Light Snow/Rain,134,128,6
2012-10-02,2012,October,9,Tuesday,Winter,Light Snow/Rain,86,83,3
2012-10-02,2012,October,10,Tuesday,Winter,Light Snow/Rain,45,42,3
2012-10-02,2012,October,11,Tuesday,Winter,Light Snow/Rain,99,92,7
2012-10-02,2012,October,12,Tuesday,Winter,Cloudy,104,98,6
2012-10-02,2012,October,13,Tuesday,Winter,Cloudy,154,148,6
2012-10-02,2012,October,14,Tuesday,Winter,Light Snow/Rain,163,147,16
2012-10-02,2012,October,15,Tuesday,Winter,Light Snow/Rain,209,195,14
2012-10-02,2012,October,16,Tuesday,Winter,Light Snow/Rain,374,328,46
2012-10-02,2012,October,17,Tuesday,Winter,Light Snow/Rain,715,677,38
2012-10-02,2012,October,18,Tuesday,Winter,Light Snow/Rain,687,639,48
2012-10-02,2012,October,19,Tuesday,Winter,Light Snow/Rain,395,368,27
2012-10-02,2012,October,20,Tuesday,Winter,Light Snow/Rain,306,286,20
2012-10-02,2012,October,21,Tuesday,Winter,Light Snow/Rain,289,265,24
2012-10-02,2012,October,22,Tuesday,Winter,Cloudy,240,212,28
2012-10-02,2012,October,23,Tuesday,Winter,Cloudy,98,87,11
2012-10-03,2012,October,0,Wednesday,Winter,Light Snow/Rain,52,47,5
2012-10-03,2012,October,1,Wednesday,Winter,Cloudy,19,16,3
2012-10-03,2012,October,2,Wednesday,Winter,Cloudy,9,7,2
2012-10-03,2012,October,3,Wednesday,Winter,Cloudy,7,7,0
2012-10-03,2012,October,4,Wednesday,Winter,Cloudy,11,9,2
2012-10-03,2012,October,5,Wednesday,Winter,Cloudy,34,32,2
2012-10-03,2012,October,6,Wednesday,Winter,Cloudy,177,173,4
2012-10-03,2012,October,7,Wednesday,Winter,Cloudy,515,504,11
2012-10-03,2012,October,8,Wednesday,Winter,Cloudy,809,781,28
2012-10-03,2012,October,9,Wednesday,Winter,Cloudy,362,332,30
2012-10-03,2012,October,10,Wednesday,Winter,Clear,175,146,29
2012-10-03,2012,October,11,Wednesday,Winter,Clear,230,178,52
2012-10-03,2012,October,12,Wednesday,Winter,Cloudy,358,289,69
2012-10-03,2012,October,13,Wednesday,Winter,Cloudy,279,224,55
2012-10-03,2012,October,14,Wednesday,Winter,Cloudy,251,195,56
2012-10-03,2012,October,15,Wednesday,Winter,Cloudy,319,260,59
2012-10-03,2012,October,16,Wednesday,Winter,Cloudy,478,436,42
2012-10-03,2012,October,17,Wednesday,Winter,Clear,917,833,84
2012-10-03,2012,October,18,Wednesday,Winter,Clear,810,756,54
2012-10-03,2012,October,19,Wednesday,Winter,Clear,593,544,49
2012-10-03,2012,October,20,Wednesday,Winter,Clear,497,449,48
2012-10-03,2012,October,21,Wednesday,Winter,Cloudy,209,195,14
2012-10-03,2012,October,22,Wednesday,Winter,Clear,241,232,9
2012-10-03,2012,October,23,Wednesday,Winter,Cloudy,220,199,21
2012-10-04,2012,October,0,Thursday,Winter,Light Snow/Rain,76,65,11
2012-10-04,2012,October,1,Thursday,Winter,Cloudy,25,23,2
2012-10-04,2012,October,2,Thursday,Winter,Clear,13,10,3
2012-10-04,2012,October,3,Thursday,Winter,Cloudy,11,6,5
2012-10-04,2012,October,4,Thursday,Winter,Cloudy,10,10,0
2012-10-04,2012,October,5,Thursday,Winter,Light Snow/Rain,39,37,2
2012-10-04,2012,October,6,Thursday,Winter,Light Snow/Rain,133,132,1
2012-10-04,2012,October,7,Thursday,Winter,Cloudy,391,379,12
2012-10-04,2012,October,8,Thursday,Winter,Clear,738,711,27
2012-10-04,2012,October,9,Thursday,Winter,Cloudy,359,319,40
2012-10-04,2012,October,10,Thursday,Winter,Cloudy,177,150,27
2012-10-04,2012,October,11,Thursday,Winter,Cloudy,214,176,38
2012-10-04,2012,October,12,Thursday,Winter,Cloudy,288,231,57
2012-10-04,2012,October,13,Thursday,Winter,Cloudy,294,231,63
2012-10-04,2012,October,14,Thursday,Winter,Clear,267,211,56
2012-10-04,2012,October,15,Thursday,Winter,Clear,325,248,77
2012-10-04,2012,October,16,Thursday,Winter,Clear,497,411,86
2012-10-04,2012,October,17,Thursday,Winter,Clear,901,789,112
2012-10-04,2012,October,18,Thursday,Winter,Clear,887,812,75
2012-10-04,2012,October,19,Thursday,Winter,Clear,534,467,67
2012-10-04,2012,October,20,Thursday,Winter,Clear,441,391,50
2012-10-04,2012,October,21,Thursday,Winter,Clear,321,288,33
2012-10-04,2012,October,22,Thursday,Winter,Clear,232,203,29
2012-10-04,2012,October,23,Thursday,Winter,Clear,155,137,18
2012-10-05,2012,October,0,Friday,Winter,Clear,102,86,16
2012-10-05,2012,October,1,Friday,Winter,Clear,46,43,3
2012-10-05,2012,October,2,Friday,Winter,Clear,11,10,1
2012-10-05,2012,October,3,Friday,Winter,Clear,16,11,5
2012-10-05,2012,October,4,Friday,Winter,Clear,11,11,0
2012-10-05,2012,October,5,Friday,Winter,Clear,41,41,0
2012-10-05,2012,October,6,Friday,Winter,Clear,137,133,4
2012-10-05,2012,October,7,Friday,Winter,Clear,428,417,11
2012-10-05,2012,October,8,Friday,Winter,Clear,785,749,36
2012-10-05,2012,October,9,Friday,Winter,Clear,384,326,58
2012-10-05,2012,October,10,Friday,Winter,Clear,260,192,68
2012-10-05,2012,October,11,Friday,Winter,Clear,304,214,90
2012-10-05,2012,October,12,Friday,Winter,Clear,468,307,161
2012-10-05,2012,October,13,Friday,Winter,Clear,424,307,117
2012-10-05,2012,October,14,Friday,Winter,Clear,400,287,113
2012-10-05,2012,October,15,Friday,Winter,Clear,470,320,150
2012-10-05,2012,October,16,Friday,Winter,Clear,634,481,153
2012-10-05,2012,October,17,Friday,Winter,Clear,900,742,158
2012-10-05,2012,October,18,Friday,Winter,Clear,761,655,106
2012-10-05,2012,October,19,Friday,Winter,Clear,500,433,67
2012-10-05,2012,October,20,Friday,Winter,Clear,372,306,66
2012-10-05,2012,October,21,Friday,Winter,Clear,267,220,47
2012-10-05,2012,October,22,Friday,Winter,Clear,264,201,63
2012-10-05,2012,October,23,Friday,Winter,Clear,171,148,23
2012-10-06,2012,October,0,Saturday,Winter,Clear,191,154,37
2012-10-06,2012,October,1,Saturday,Winter,Clear,141,116,25
2012-10-06,2012,October,2,Saturday,Winter,Clear,75,62,13
2012-10-06,2012,October,3,Saturday,Winter,Clear,56,54,2
2012-10-06,2012,October,4,Saturday,Winter,Clear,11,7,4
2012-10-06,2012,October,5,Saturday,Winter,Clear,10,8,2
2012-10-06,2012,October,6,Saturday,Winter,Clear,30,28,2
2012-10-06,2012,October,7,Saturday,Winter,Clear,84,71,13
2012-10-06,2012,October,8,Saturday,Winter,Clear,206,184,22
2012-10-06,2012,October,9,Saturday,Winter,Clear,395,265,130
2012-10-06,2012,October,10,Saturday,Winter,Clear,539,341,198
2012-10-06,2012,October,11,Saturday,Winter,Clear,647,389,258
2012-10-06,2012,October,12,Saturday,Winter,Clear,743,381,362
2012-10-06,2012,October,13,Saturday,Winter,Cloudy,710,400,310
2012-10-06,2012,October,14,Saturday,Winter,Cloudy,576,307,269
2012-10-06,2012,October,15,Saturday,Winter,Clear,620,341,279
2012-10-06,2012,October,16,Saturday,Winter,Clear,659,342,317
2012-10-06,2012,October,17,Saturday,Winter,Clear,610,342,268
2012-10-06,2012,October,18,Saturday,Winter,Clear,495,312,183
2012-10-06,2012,October,19,Saturday,Winter,Clear,341,239,102
2012-10-06,2012,October,20,Saturday,Winter,Clear,247,172,75
2012-10-06,2012,October,21,Saturday,Winter,Clear,215,137,78
2012-10-06,2012,October,22,Saturday,Winter,Clear,185,140,45
2012-10-06,2012,October,23,Saturday,Winter,Clear,179,142,37
2012-10-07,2012,October,0,Sunday,Winter,Clear,127,99,28
2012-10-07,2012,October,1,Sunday,Winter,Clear,109,80,29
2012-10-07,2012,October,2,Sunday,Winter,Clear,74,64,10
2012-10-07,2012,October,3,Sunday,Winter,Cloudy,22,17,5
2012-10-07,2012,October,4,Sunday,Winter,Cloudy,11,6,5
2012-10-07,2012,October,5,Sunday,Winter,Cloudy,10,8,2
2012-10-07,2012,October,6,Sunday,Winter,Cloudy,23,19,4
2012-10-07,2012,October,7,Sunday,Winter,Light Snow/Rain,35,29,6
2012-10-07,2012,October,8,Sunday,Winter,Light Snow/Rain,62,51,11
2012-10-07,2012,October,9,Sunday,Winter,Light Snow/Rain,86,70,16
2012-10-07,2012,October,10,Sunday,Winter,Cloudy,185,144,41
2012-10-07,2012,October,11,Sunday,Winter,Cloudy,336,260,76
2012-10-07,2012,October,12,Sunday,Winter,Cloudy,392,292,100
2012-10-07,2012,October,13,Sunday,Winter,Cloudy,320,240,80
2012-10-07,2012,October,14,Sunday,Winter,Cloudy,314,243,71
2012-10-07,2012,October,15,Sunday,Winter,Light Snow/Rain,306,232,74
2012-10-07,2012,October,16,Sunday,Winter,Light Snow/Rain,333,246,87
2012-10-07,2012,October,17,Sunday,Winter,Light Snow/Rain,157,122,35
2012-10-07,2012,October,18,Sunday,Winter,Light Snow/Rain,106,82,24
2012-10-07,2012,October,19,Sunday,Winter,Cloudy,114,97,17
2012-10-07,2012,October,20,Sunday,Winter,Clear,116,97,19
2012-10-07,2012,October,21,Sunday,Winter,Clear,113,91,22
2012-10-07,2012,October,22,Sunday,Winter,Clear,79,72,7
2012-10-07,2012,October,23,Sunday,Winter,Clear,80,68,12
2012-10-08,2012,October,0,Monday,Winter,Clear,51,44,7
2012-10-08,2012,October,1,Monday,Winter,Clear,37,35,2
2012-10-08,2012,October,2,Monday,Winter,Clear,15,12,3
2012-10-08,2012,October,3,Monday,Winter,Clear,10,8,2
2012-10-08,2012,October,4,Monday,Winter,Clear,7,6,1
2012-10-08,2012,October,5,Monday,Winter,Clear,19,17,2
2012-10-08,2012,October,6,Monday,Winter,Clear,59,54,5
2012-10-08,2012,October,7,Monday,Winter,Cloudy,154,151,3
2012-10-08,2012,October,8,Monday,Winter,Cloudy,397,374,23
2012-10-08,2012,October,9,Monday,Winter,Cloudy,332,273,59
2012-10-08,2012,October,10,Monday,Winter,Cloudy,298,229,69
2012-10-08,2012,October,11,Monday,Winter,Cloudy,308,236,72
2012-10-08,2012,October,12,Monday,Winter,Cloudy,341,267,74
2012-10-08,2012,October,13,Monday,Winter,Cloudy,405,323,82
2012-10-08,2012,October,14,Monday,Winter,Cloudy,420,299,121
2012-10-08,2012,October,15,Monday,Winter,Light Snow/Rain,370,294,76
2012-10-08,2012,October,16,Monday,Winter,Light Snow/Rain,377,316,61
2012-10-08,2012,October,17,Monday,Winter,Cloudy,497,416,81
2012-10-08,2012,October,18,Monday,Winter,Cloudy,456,415,41
2012-10-08,2012,October,19,Monday,Winter,Cloudy,371,333,38
2012-10-08,2012,October,20,Monday,Winter,Light Snow/Rain,227,207,20
2012-10-08,2012,October,21,Monday,Winter,Cloudy,151,134,17
2012-10-08,2012,October,22,Monday,Winter,Light Snow/Rain,107,101,6
2012-10-08,2012,October,23,Monday,Winter,Cloudy,69,60,9
2012-10-09,2012,October,0,Tuesday,Winter,Cloudy,31,22,9
2012-10-09,2012,October,1,Tuesday,Winter,Light Snow/Rain,13,13,0
2012-10-09,2012,October,2,Tuesday,Winter,Light Snow/Rain,7,5,2
2012-10-09,2012,October,3,Tuesday,Winter,Light Snow/Rain,3,3,0
2012-10-09,2012,October,4,Tuesday,Winter,Light Snow/Rain,7,6,1
2012-10-09,2012,October,5,Tuesday,Winter,Cloudy,19,19,0
2012-10-09,2012,October,6,Tuesday,Winter,Cloudy,143,141,2
2012-10-09,2012,October,7,Tuesday,Winter,Clear,362,357,5
2012-10-09,2012,October,8,Tuesday,Winter,Cloudy,713,698,15
2012-10-09,2012,October,9,Tuesday,Winter,Cloudy,382,345,37
2012-10-09,2012,October,10,Tuesday,Winter,Cloudy,164,131,33
2012-10-09,2012,October,11,Tuesday,Winter,Cloudy,193,156,37
2012-10-09,2012,October,12,Tuesday,Winter,Cloudy,260,217,43
2012-10-09,2012,October,13,Tuesday,Winter,Cloudy,238,184,54
2012-10-09,2012,October,14,Tuesday,Winter,Cloudy,244,201,43
2012-10-09,2012,October,15,Tuesday,Winter,Cloudy,254,195,59
2012-10-09,2012,October,16,Tuesday,Winter,Cloudy,424,354,70
2012-10-09,2012,October,17,Tuesday,Winter,Cloudy,806,733,73
2012-10-09,2012,October,18,Tuesday,Winter,Cloudy,784,758,26
2012-10-09,2012,October,19,Tuesday,Winter,Cloudy,514,483,31
2012-10-09,2012,October,20,Tuesday,Winter,Cloudy,360,330,30
2012-10-09,2012,October,21,Tuesday,Winter,Cloudy,225,209,16
2012-10-09,2012,October,22,Tuesday,Winter,Cloudy,162,155,7
2012-10-09,2012,October,23,Tuesday,Winter,Cloudy,84,76,8
2012-10-10,2012,October,0,Wednesday,Winter,Cloudy,33,33,0
2012-10-10,2012,October,1,Wednesday,Winter,Cloudy,8,6,2
2012-10-10,2012,October,2,Wednesday,Winter,Cloudy,8,6,2
2012-10-10,2012,October,3,Wednesday,Winter,Cloudy,6,6,0
2012-10-10,2012,October,4,Wednesday,Winter,Cloudy,6,6,0
2012-10-10,2012,October,5,Wednesday,Winter,Cloudy,40,38,2
2012-10-10,2012,October,6,Wednesday,Winter,Cloudy,175,172,3
2012-10-10,2012,October,7,Wednesday,Winter,Clear,507,498,9
2012-10-10,2012,October,8,Wednesday,Winter,Clear,839,806,33
2012-10-10,2012,October,9,Wednesday,Winter,Clear,366,331,35
2012-10-10,2012,October,10,Wednesday,Winter,Clear,217,190,27
2012-10-10,2012,October,11,Wednesday,Winter,Clear,291,238,53
2012-10-10,2012,October,12,Wednesday,Winter,Clear,390,312,78
2012-10-10,2012,October,13,Wednesday,Winter,Clear,297,237,60
2012-10-10,2012,October,14,Wednesday,Winter,Clear,271,208,63
2012-10-10,2012,October,15,Wednesday,Winter,Clear,319,261,58
2012-10-10,2012,October,16,Wednesday,Winter,Clear,566,474,92
2012-10-10,2012,October,17,Wednesday,Winter,Clear,948,857,91
2012-10-10,2012,October,18,Wednesday,Winter,Cloudy,844,787,57
2012-10-10,2012,October,19,Wednesday,Winter,Cloudy,566,534,32
2012-10-10,2012,October,20,Wednesday,Winter,Clear,392,371,21
2012-10-10,2012,October,21,Wednesday,Winter,Clear,269,251,18
2012-10-10,2012,October,22,Wednesday,Winter,Clear,197,170,27
2012-10-10,2012,October,23,Wednesday,Winter,Clear,136,119,17
2012-10-11,2012,October,0,Thursday,Winter,Clear,42,41,1
2012-10-11,2012,October,1,Thursday,Winter,Clear,11,10,1
2012-10-11,2012,October,2,Thursday,Winter,Clear,11,7,4
2012-10-11,2012,October,3,Thursday,Winter,Clear,3,3,0
2012-10-11,2012,October,4,Thursday,Winter,Clear,10,10,0
2012-10-11,2012,October,5,Thursday,Winter,Clear,42,42,0
2012-10-11,2012,October,6,Thursday,Winter,Clear,159,158,1
2012-10-11,2012,October,7,Thursday,Winter,Clear,478,467,11
2012-10-11,2012,October,8,Thursday,Winter,Clear,798,773,25
2012-10-11,2012,October,9,Thursday,Winter,Clear,355,328,27
2012-10-11,2012,October,10,Thursday,Winter,Clear,204,165,39
2012-10-11,2012,October,11,Thursday,Winter,Clear,251,175,76
2012-10-11,2012,October,12,Thursday,Winter,Clear,326,279,47
2012-10-11,2012,October,13,Thursday,Winter,Clear,291,243,48
2012-10-11,2012,October,14,Thursday,Winter,Clear,348,270,78
2012-10-11,2012,October,15,Thursday,Winter,Clear,460,358,102
2012-10-11,2012,October,16,Thursday,Winter,Clear,481,413,68
2012-10-11,2012,October,17,Thursday,Winter,Clear,827,737,90
2012-10-11,2012,October,18,Thursday,Winter,Clear,692,628,64
2012-10-11,2012,October,19,Thursday,Winter,Clear,743,662,81
2012-10-11,2012,October,20,Thursday,Winter,Clear,415,388,27
2012-10-11,2012,October,21,Thursday,Winter,Clear,260,236,24
2012-10-11,2012,October,22,Thursday,Winter,Clear,177,167,10
2012-10-11,2012,October,23,Thursday,Winter,Clear,186,176,10
2012-10-12,2012,October,0,Friday,Winter,Clear,68,60,8
2012-10-12,2012,October,1,Friday,Winter,Clear,37,29,8
2012-10-12,2012,October,2,Friday,Winter,Clear,16,16,0
2012-10-12,2012,October,3,Friday,Winter,Clear,6,6,0
2012-10-12,2012,October,4,Friday,Winter,Clear,8,8,0
2012-10-12,2012,October,5,Friday,Winter,Clear,35,33,2
2012-10-12,2012,October,6,Friday,Winter,Clear,143,140,3
2012-10-12,2012,October,7,Friday,Winter,Clear,392,384,8
2012-10-12,2012,October,8,Friday,Winter,Clear,745,711,34
2012-10-12,2012,October,9,Friday,Winter,Clear,400,374,26
2012-10-12,2012,October,10,Friday,Winter,Clear,275,200,75
2012-10-12,2012,October,11,Friday,Winter,Clear,313,252,61
2012-10-12,2012,October,12,Friday,Winter,Clear,387,312,75
2012-10-12,2012,October,13,Friday,Winter,Clear,381,300,81
2012-10-12,2012,October,14,Friday,Winter,Clear,371,262,109
2012-10-12,2012,October,15,Friday,Winter,Clear,455,317,138
2012-10-12,2012,October,16,Friday,Winter,Clear,520,412,108
2012-10-12,2012,October,17,Friday,Winter,Clear,837,706,131
2012-10-12,2012,October,18,Friday,Winter,Clear,642,566,76
2012-10-12,2012,October,19,Friday,Winter,Clear,493,453,40
2012-10-12,2012,October,20,Friday,Winter,Clear,308,280,28
2012-10-12,2012,October,21,Friday,Winter,Clear,190,169,21
2012-10-12,2012,October,22,Friday,Winter,Clear,160,143,17
2012-10-12,2012,October,23,Friday,Winter,Clear,100,89,11
2012-10-13,2012,October,0,Saturday,Winter,Clear,249,218,31
2012-10-13,2012,October,1,Saturday,Winter,Clear,146,123,23
2012-10-13,2012,October,2,Saturday,Winter,Clear,67,60,7
2012-10-13,2012,October,3,Saturday,Winter,Clear,15,13,2
2012-10-13,2012,October,4,Saturday,Winter,Clear,11,9,2
2012-10-13,2012,October,5,Saturday,Winter,Clear,11,11,0
2012-10-13,2012,October,6,Saturday,Winter,Clear,28,23,5
2012-10-13,2012,October,7,Saturday,Winter,Clear,70,60,10
2012-10-13,2012,October,8,Saturday,Winter,Clear,174,151,23
2012-10-13,2012,October,9,Saturday,Winter,Clear,266,220,46
2012-10-13,2012,October,10,Saturday,Winter,Clear,347,265,82
2012-10-13,2012,October,11,Saturday,Winter,Clear,527,335,192
2012-10-13,2012,October,12,Saturday,Winter,Clear,573,371,202
2012-10-13,2012,October,13,Saturday,Winter,Clear,670,435,235
2012-10-13,2012,October,14,Saturday,Winter,Clear,597,354,243
2012-10-13,2012,October,15,Saturday,Winter,Clear,615,364,251
2012-10-13,2012,October,16,Saturday,Winter,Clear,637,343,294
2012-10-13,2012,October,17,Saturday,Winter,Clear,528,335,193
2012-10-13,2012,October,18,Saturday,Winter,Clear,473,299,174
2012-10-13,2012,October,19,Saturday,Winter,Clear,332,259,73
2012-10-13,2012,October,20,Saturday,Winter,Clear,255,198,57
2012-10-13,2012,October,21,Saturday,Winter,Clear,204,157,47
2012-10-13,2012,October,22,Saturday,Winter,Clear,189,156,33
2012-10-13,2012,October,23,Saturday,Winter,Clear,125,98,27
2012-10-14,2012,October,0,Sunday,Winter,Clear,111,103,8
2012-10-14,2012,October,1,Sunday,Winter,Clear,112,96,16
2012-10-14,2012,October,2,Sunday,Winter,Clear,66,58,8
2012-10-14,2012,October,3,Sunday,Winter,Clear,28,25,3
2012-10-14,2012,October,4,Sunday,Winter,Clear,12,10,2
2012-10-14,2012,October,5,Sunday,Winter,Clear,11,6,5
2012-10-14,2012,October,6,Sunday,Winter,Clear,24,20,4
2012-10-14,2012,October,7,Sunday,Winter,Clear,51,44,7
2012-10-14,2012,October,8,Sunday,Winter,Clear,132,104,28
2012-10-14,2012,October,9,Sunday,Winter,Cloudy,223,161,62
2012-10-14,2012,October,10,Sunday,Winter,Clear,428,278,150
2012-10-14,2012,October,11,Sunday,Winter,Clear,494,338,156
2012-10-14,2012,October,12,Sunday,Winter,Clear,562,362,200
2012-10-14,2012,October,13,Sunday,Winter,Clear,619,401,218
2012-10-14,2012,October,14,Sunday,Winter,Clear,617,368,249
2012-10-14,2012,October,15,Sunday,Winter,Clear,568,355,213
2012-10-14,2012,October,16,Sunday,Winter,Clear,581,378,203
2012-10-14,2012,October,17,Sunday,Winter,Clear,539,346,193
2012-10-14,2012,October,18,Sunday,Winter,Clear,453,319,134
2012-10-14,2012,October,19,Sunday,Winter,Clear,336,268,68
2012-10-14,2012,October,20,Sunday,Winter,Clear,246,198,48
2012-10-14,2012,October,21,Sunday,Winter,Clear,196,156,40
2012-10-14,2012,October,22,Sunday,Winter,Clear,125,87,38
2012-10-14,2012,October,23,Sunday,Winter,Cloudy,105,78,27
2012-10-15,2012,October,0,Monday,Winter,Cloudy,48,31,17
2012-10-15,2012,October,1,Monday,Winter,Cloudy,29,24,5
2012-10-15,2012,October,2,Monday,Winter,Cloudy,6,5,1
2012-10-15,2012,October,3,Monday,Winter,Cloudy,4,2,2
2012-10-15,2012,October,4,Monday,Winter,Cloudy,10,9,1
2012-10-15,2012,October,5,Monday,Winter,Cloudy,40,38,2
2012-10-15,2012,October,6,Monday,Winter,Cloudy,147,141,6
2012-10-15,2012,October,7,Monday,Winter,Cloudy,476,461,15
2012-10-15,2012,October,8,Monday,Winter,Cloudy,737,713,24
2012-10-15,2012,October,9,Monday,Winter,Light Snow/Rain,359,328,31
2012-10-15,2012,October,10,Monday,Winter,Cloudy,168,125,43
2012-10-15,2012,October,11,Monday,Winter,Cloudy,263,175,88
2012-10-15,2012,October,12,Monday,Winter,Light Snow/Rain,284,211,73
2012-10-15,2012,October,13,Monday,Winter,Cloudy,146,109,37
2012-10-15,2012,October,14,Monday,Winter,Cloudy,185,128,57
2012-10-15,2012,October,15,Monday,Winter,Clear,260,190,70
2012-10-15,2012,October,16,Monday,Winter,Clear,447,371,76
2012-10-15,2012,October,17,Monday,Winter,Clear,766,670,96
2012-10-15,2012,October,18,Monday,Winter,Light Snow/Rain,592,540,52
2012-10-15,2012,October,19,Monday,Winter,Light Snow/Rain,239,227,12
2012-10-15,2012,October,20,Monday,Winter,Cloudy,256,237,19
2012-10-15,2012,October,21,Monday,Winter,Clear,206,190,16
2012-10-15,2012,October,22,Monday,Winter,Clear,126,118,8
2012-10-15,2012,October,23,Monday,Winter,Clear,81,72,9
2012-10-16,2012,October,0,Tuesday,Winter,Clear,48,45,3
2012-10-16,2012,October,1,Tuesday,Winter,Clear,13,9,4
2012-10-16,2012,October,2,Tuesday,Winter,Clear,3,1,2
2012-10-16,2012,October,3,Tuesday,Winter,Clear,2,2,0
2012-10-16,2012,October,4,Tuesday,Winter,Clear,7,7,0
2012-10-16,2012,October,5,Tuesday,Winter,Clear,52,47,5
2012-10-16,2012,October,6,Tuesday,Winter,Clear,172,168,4
2012-10-16,2012,October,7,Tuesday,Winter,Clear,525,505,20
2012-10-16,2012,October,8,Tuesday,Winter,Clear,835,800,35
2012-10-16,2012,October,9,Tuesday,Winter,Clear,355,323,32
2012-10-16,2012,October,10,Tuesday,Winter,Clear,222,157,65
2012-10-16,2012,October,11,Tuesday,Winter,Clear,228,172,56
2012-10-16,2012,October,12,Tuesday,Winter,Cloudy,325,256,69
2012-10-16,2012,October,13,Tuesday,Winter,Clear,328,260,68
2012-10-16,2012,October,14,Tuesday,Winter,Clear,308,214,94
2012-10-16,2012,October,15,Tuesday,Winter,Clear,346,270,76
2012-10-16,2012,October,16,Tuesday,Winter,Clear,446,367,79
2012-10-16,2012,October,17,Tuesday,Winter,Clear,943,839,104
2012-10-16,2012,October,18,Tuesday,Winter,Clear,838,767,71
2012-10-16,2012,October,19,Tuesday,Winter,Clear,531,491,40
2012-10-16,2012,October,20,Tuesday,Winter,Clear,432,397,35
2012-10-16,2012,October,21,Tuesday,Winter,Clear,195,176,19
2012-10-16,2012,October,22,Tuesday,Winter,Clear,181,163,18
2012-10-16,2012,October,23,Tuesday,Winter,Clear,199,176,23
2012-10-17,2012,October,0,Wednesday,Winter,Clear,49,48,1
2012-10-17,2012,October,1,Wednesday,Winter,Clear,17,14,3
2012-10-17,2012,October,2,Wednesday,Winter,Clear,16,12,4
2012-10-17,2012,October,3,Wednesday,Winter,Clear,7,7,0
2012-10-17,2012,October,4,Wednesday,Winter,Clear,4,4,0
2012-10-17,2012,October,5,Wednesday,Winter,Cloudy,41,39,2
2012-10-17,2012,October,6,Wednesday,Winter,Clear,178,171,7
2012-10-17,2012,October,7,Wednesday,Winter,Clear,464,449,15
2012-10-17,2012,October,8,Wednesday,Winter,Cloudy,817,779,38
2012-10-17,2012,October,9,Wednesday,Winter,Cloudy,382,344,38
2012-10-17,2012,October,10,Wednesday,Winter,Cloudy,228,168,60
2012-10-17,2012,October,11,Wednesday,Winter,Cloudy,234,156,78
2012-10-17,2012,October,12,Wednesday,Winter,Cloudy,332,261,71
2012-10-17,2012,October,13,Wednesday,Winter,Cloudy,310,237,73
2012-10-17,2012,October,14,Wednesday,Winter,Cloudy,270,188,82
2012-10-17,2012,October,15,Wednesday,Winter,Cloudy,301,239,62
2012-10-17,2012,October,16,Wednesday,Winter,Clear,466,396,70
2012-10-17,2012,October,17,Wednesday,Winter,Clear,888,766,122
2012-10-17,2012,October,18,Wednesday,Winter,Clear,884,794,90
2012-10-17,2012,October,19,Wednesday,Winter,Clear,516,467,49
2012-10-17,2012,October,20,Wednesday,Winter,Clear,414,360,54
2012-10-17,2012,October,21,Wednesday,Winter,Clear,329,301,28
2012-10-17,2012,October,22,Wednesday,Winter,Clear,215,198,17
2012-10-17,2012,October,23,Wednesday,Winter,Clear,99,84,15
2012-10-18,2012,October,0,Thursday,Winter,Clear,57,53,4
2012-10-18,2012,October,1,Thursday,Winter,Clear,14,14,0
2012-10-18,2012,October,2,Thursday,Winter,Clear,14,13,1
2012-10-18,2012,October,3,Thursday,Winter,Clear,5,5,0
2012-10-18,2012,October,4,Thursday,Winter,Clear,5,5,0
2012-10-18,2012,October,5,Thursday,Winter,Clear,42,41,1
2012-10-18,2012,October,6,Thursday,Winter,Clear,153,150,3
2012-10-18,2012,October,7,Thursday,Winter,Clear,508,488,20
2012-10-18,2012,October,8,Thursday,Winter,Clear,834,803,31
2012-10-18,2012,October,9,Thursday,Winter,Cloudy,387,346,41
2012-10-18,2012,October,10,Thursday,Winter,Cloudy,218,158,60
2012-10-18,2012,October,11,Thursday,Winter,Cloudy,268,189,79
2012-10-18,2012,October,12,Thursday,Winter,Cloudy,377,284,93
2012-10-18,2012,October,13,Thursday,Winter,Clear,332,236,96
2012-10-18,2012,October,14,Thursday,Winter,Cloudy,285,191,94
2012-10-18,2012,October,15,Thursday,Winter,Cloudy,353,284,69
2012-10-18,2012,October,16,Thursday,Winter,Clear,450,356,94
2012-10-18,2012,October,17,Thursday,Winter,Cloudy,890,788,102
2012-10-18,2012,October,18,Thursday,Winter,Cloudy,788,720,68
2012-10-18,2012,October,19,Thursday,Winter,Cloudy,513,471,42
2012-10-18,2012,October,20,Thursday,Winter,Cloudy,387,348,39
2012-10-18,2012,October,21,Thursday,Winter,Cloudy,283,245,38
2012-10-18,2012,October,22,Thursday,Winter,Cloudy,229,202,27
2012-10-18,2012,October,23,Thursday,Winter,Cloudy,117,111,6
2012-10-19,2012,October,0,Friday,Winter,Cloudy,56,51,5
2012-10-19,2012,October,1,Friday,Winter,Light Snow/Rain,16,12,4
2012-10-19,2012,October,2,Friday,Winter,Cloudy,10,9,1
2012-10-19,2012,October,3,Friday,Winter,Cloudy,5,5,0
2012-10-19,2012,October,4,Friday,Winter,Cloudy,6,5,1
2012-10-19,2012,October,5,Friday,Winter,Cloudy,36,35,1
2012-10-19,2012,October,6,Friday,Winter,Light Snow/Rain,131,126,5
2012-10-19,2012,October,7,Friday,Winter,Light Snow/Rain,154,149,5
2012-10-19,2012,October,8,Friday,Winter,Cloudy,467,447,20
2012-10-19,2012,October,9,Friday,Winter,Cloudy,389,363,26
2012-10-19,2012,October,10,Friday,Winter,Cloudy,224,198,26
2012-10-19,2012,October,11,Friday,Winter,Clear,252,211,41
2012-10-19,2012,October,12,Friday,Winter,Clear,332,258,74
2012-10-19,2012,October,13,Friday,Winter,Clear,375,288,87
2012-10-19,2012,October,14,Friday,Winter,Clear,365,277,88
2012-10-19,2012,October,15,Friday,Winter,Clear,395,302,93
2012-10-19,2012,October,16,Friday,Winter,Light Snow/Rain,565,434,131
2012-10-19,2012,October,17,Friday,Winter,Light Snow/Rain,425,377,48
2012-10-19,2012,October,18,Friday,Winter,Clear,233,212,21
2012-10-19,2012,October,19,Friday,Winter,Clear,232,213,19
2012-10-19,2012,October,20,Friday,Winter,Clear,229,216,13
2012-10-19,2012,October,21,Friday,Winter,Clear,206,189,17
2012-10-19,2012,October,22,Friday,Winter,Clear,190,176,14
2012-10-19,2012,October,23,Friday,Winter,Clear,131,118,13
2012-10-20,2012,October,0,Saturday,Winter,Clear,123,110,13
2012-10-20,2012,October,1,Saturday,Winter,Clear,95,93,2
2012-10-20,2012,October,2,Saturday,Winter,Clear,78,69,9
2012-10-20,2012,October,3,Saturday,Winter,Clear,29,27,2
2012-10-20,2012,October,4,Saturday,Winter,Clear,18,9,9
2012-10-20,2012,October,5,Saturday,Winter,Clear,13,7,6
2012-10-20,2012,October,6,Saturday,Winter,Clear,31,26,5
2012-10-20,2012,October,7,Saturday,Winter,Clear,65,59,6
2012-10-20,2012,October,8,Saturday,Winter,Clear,193,164,29
2012-10-20,2012,October,9,Saturday,Winter,Clear,363,257,106
2012-10-20,2012,October,10,Saturday,Winter,Clear,423,312,111
2012-10-20,2012,October,11,Saturday,Winter,Clear,612,408,204
2012-10-20,2012,October,12,Saturday,Winter,Clear,703,436,267
2012-10-20,2012,October,13,Saturday,Winter,Clear,714,441,273
2012-10-20,2012,October,14,Saturday,Winter,Clear,711,376,335
2012-10-20,2012,October,15,Saturday,Winter,Clear,711,403,308
2012-10-20,2012,October,16,Saturday,Winter,Clear,691,366,325
2012-10-20,2012,October,17,Saturday,Winter,Clear,731,384,347
2012-10-20,2012,October,18,Saturday,Winter,Clear,521,356,165
2012-10-20,2012,October,19,Saturday,Winter,Clear,345,268,77
2012-10-20,2012,October,20,Saturday,Winter,Clear,259,198,61
2012-10-20,2012,October,21,Saturday,Winter,Clear,296,224,72
2012-10-20,2012,October,22,Saturday,Winter,Clear,202,155,47
2012-10-20,2012,October,23,Saturday,Winter,Clear,163,136,27
2012-10-21,2012,October,0,Sunday,Winter,Clear,154,119,35
2012-10-21,2012,October,1,Sunday,Winter,Clear,117,97,20
2012-10-21,2012,October,2,Sunday,Winter,Clear,132,88,44
2012-10-21,2012,October,3,Sunday,Winter,Clear,41,29,12
2012-10-21,2012,October,4,Sunday,Winter,Clear,21,13,8
2012-10-21,2012,October,5,Sunday,Winter,Clear,10,4,6
2012-10-21,2012,October,6,Sunday,Winter,Clear,26,18,8
2012-10-21,2012,October,7,Sunday,Winter,Clear,56,43,13
2012-10-21,2012,October,8,Sunday,Winter,Clear,143,104,39
2012-10-21,2012,October,9,Sunday,Winter,Clear,269,192,77
2012-10-21,2012,October,10,Sunday,Winter,Clear,443,276,167
2012-10-21,2012,October,11,Sunday,Winter,Clear,547,356,191
2012-10-21,2012,October,12,Sunday,Winter,Clear,675,439,236
2012-10-21,2012,October,13,Sunday,Winter,Clear,626,383,243
2012-10-21,2012,October,14,Sunday,Winter,Clear,640,405,235
2012-10-21,2012,October,15,Sunday,Winter,Clear,623,383,240
2012-10-21,2012,October,16,Sunday,Winter,Clear,591,409,182
2012-10-21,2012,October,17,Sunday,Winter,Clear,491,338,153
2012-10-21,2012,October,18,Sunday,Winter,Clear,413,342,71
2012-10-21,2012,October,19,Sunday,Winter,Clear,266,216,50
2012-10-21,2012,October,20,Sunday,Winter,Clear,195,160,35
2012-10-21,2012,October,21,Sunday,Winter,Clear,166,124,42
2012-10-21,2012,October,22,Sunday,Winter,Clear,113,95,18
2012-10-21,2012,October,23,Sunday,Winter,Clear,66,59,7
2012-10-22,2012,October,0,Monday,Winter,Clear,31,28,3
2012-10-22,2012,October,1,Monday,Winter,Clear,11,11,0
2012-10-22,2012,October,2,Monday,Winter,Clear,5,4,1
2012-10-22,2012,October,3,Monday,Winter,Clear,6,5,1
2012-10-22,2012,October,4,Monday,Winter,Clear,7,6,1
2012-10-22,2012,October,5,Monday,Winter,Clear,46,44,2
2012-10-22,2012,October,6,Monday,Winter,Clear,144,140,4
2012-10-22,2012,October,7,Monday,Winter,Clear,452,437,15
2012-10-22,2012,October,8,Monday,Winter,Clear,728,696,32
2012-10-22,2012,October,9,Monday,Winter,Clear,360,335,25
2012-10-22,2012,October,10,Monday,Winter,Clear,212,161,51
2012-10-22,2012,October,11,Monday,Winter,Clear,211,148,63
2012-10-22,2012,October,12,Monday,Winter,Clear,283,231,52
2012-10-22,2012,October,13,Monday,Winter,Clear,315,227,88
2012-10-22,2012,October,14,Monday,Winter,Clear,282,209,73
2012-10-22,2012,October,15,Monday,Winter,Clear,296,222,74
2012-10-22,2012,October,16,Monday,Winter,Clear,524,444,80
2012-10-22,2012,October,17,Monday,Winter,Clear,922,838,84
2012-10-22,2012,October,18,Monday,Winter,Clear,786,726,60
2012-10-22,2012,October,19,Monday,Winter,Clear,514,478,36
2012-10-22,2012,October,20,Monday,Winter,Clear,403,382,21
2012-10-22,2012,October,21,Monday,Winter,Clear,174,155,19
2012-10-22,2012,October,22,Monday,Winter,Clear,183,158,25
2012-10-22,2012,October,23,Monday,Winter,Clear,163,143,20
2012-10-23,2012,October,0,Tuesday,Winter,Clear,37,32,5
2012-10-23,2012,October,1,Tuesday,Winter,Clear,17,16,1
2012-10-23,2012,October,2,Tuesday,Winter,Clear,7,6,1
2012-10-23,2012,October,3,Tuesday,Winter,Clear,1,1,0
2012-10-23,2012,October,4,Tuesday,Winter,Clear,7,6,1
2012-10-23,2012,October,5,Tuesday,Winter,Clear,50,49,1
2012-10-23,2012,October,6,Tuesday,Winter,Clear,158,152,6
2012-10-23,2012,October,7,Tuesday,Winter,Cloudy,531,519,12
2012-10-23,2012,October,8,Tuesday,Winter,Cloudy,761,733,28
2012-10-23,2012,October,9,Tuesday,Winter,Cloudy,334,305,29
2012-10-23,2012,October,10,Tuesday,Winter,Clear,221,171,50
2012-10-23,2012,October,11,Tuesday,Winter,Clear,253,201,52
2012-10-23,2012,October,12,Tuesday,Winter,Cloudy,378,298,80
2012-10-23,2012,October,13,Tuesday,Winter,Cloudy,303,244,59
2012-10-23,2012,October,14,Tuesday,Winter,Clear,296,229,67
2012-10-23,2012,October,15,Tuesday,Winter,Clear,346,270,76
2012-10-23,2012,October,16,Tuesday,Winter,Clear,541,433,108
2012-10-23,2012,October,17,Tuesday,Winter,Clear,938,871,67
2012-10-23,2012,October,18,Tuesday,Winter,Clear,826,762,64
2012-10-23,2012,October,19,Tuesday,Winter,Clear,482,457,25
2012-10-23,2012,October,20,Tuesday,Winter,Clear,379,334,45
2012-10-23,2012,October,21,Tuesday,Winter,Clear,295,260,35
2012-10-23,2012,October,22,Tuesday,Winter,Clear,194,174,20
2012-10-23,2012,October,23,Tuesday,Winter,Clear,111,102,9
2012-10-24,2012,October,0,Wednesday,Winter,Clear,46,39,7
2012-10-24,2012,October,1,Wednesday,Winter,Clear,27,23,4
2012-10-24,2012,October,2,Wednesday,Winter,Clear,6,6,0
2012-10-24,2012,October,3,Wednesday,Winter,Clear,4,4,0
2012-10-24,2012,October,4,Wednesday,Winter,Clear,6,5,1
2012-10-24,2012,October,5,Wednesday,Winter,Clear,53,52,1
2012-10-24,2012,October,6,Wednesday,Winter,Clear,173,162,11
2012-10-24,2012,October,7,Wednesday,Winter,Clear,526,506,20
2012-10-24,2012,October,8,Wednesday,Winter,Cloudy,801,777,24
2012-10-24,2012,October,9,Wednesday,Winter,Cloudy,373,349,24
2012-10-24,2012,October,10,Wednesday,Winter,Cloudy,171,142,29
2012-10-24,2012,October,11,Wednesday,Winter,Clear,236,189,47
2012-10-24,2012,October,12,Wednesday,Winter,Clear,316,268,48
2012-10-24,2012,October,13,Wednesday,Winter,Clear,306,241,65
2012-10-24,2012,October,14,Wednesday,Winter,Clear,301,237,64
2012-10-24,2012,October,15,Wednesday,Winter,Clear,308,245,63
2012-10-24,2012,October,16,Wednesday,Winter,Clear,532,465,67
2012-10-24,2012,October,17,Wednesday,Winter,Clear,963,876,87
2012-10-24,2012,October,18,Wednesday,Winter,Clear,858,795,63
2012-10-24,2012,October,19,Wednesday,Winter,Cloudy,572,522,50
2012-10-24,2012,October,20,Wednesday,Winter,Cloudy,441,396,45
2012-10-24,2012,October,21,Wednesday,Winter,Cloudy,313,280,33
2012-10-24,2012,October,22,Wednesday,Winter,Cloudy,238,208,30
2012-10-24,2012,October,23,Wednesday,Winter,Cloudy,123,111,12
2012-10-25,2012,October,0,Thursday,Winter,Cloudy,76,57,19
2012-10-25,2012,October,1,Thursday,Winter,Clear,28,22,6
2012-10-25,2012,October,2,Thursday,Winter,Clear,18,15,3
2012-10-25,2012,October,3,Thursday,Winter,Cloudy,8,8,0
2012-10-25,2012,October,4,Thursday,Winter,Cloudy,5,4,1
2012-10-25,2012,October,5,Thursday,Winter,Cloudy,55,53,2
2012-10-25,2012,October,6,Thursday,Winter,Cloudy,171,168,3
2012-10-25,2012,October,7,Thursday,Winter,Cloudy,495,477,18
2012-10-25,2012,October,8,Thursday,Winter,Cloudy,779,746,33
2012-10-25,2012,October,9,Thursday,Winter,Cloudy,343,320,23
2012-10-25,2012,October,10,Thursday,Winter,Cloudy,225,172,53
2012-10-25,2012,October,11,Thursday,Winter,Cloudy,238,181,57
2012-10-25,2012,October,12,Thursday,Winter,Cloudy,319,258,61
2012-10-25,2012,October,13,Thursday,Winter,Cloudy,313,264,49
2012-10-25,2012,October,14,Thursday,Winter,Clear,285,214,71
2012-10-25,2012,October,15,Thursday,Winter,Clear,305,242,63
2012-10-25,2012,October,16,Thursday,Winter,Clear,499,407,92
2012-10-25,2012,October,17,Thursday,Winter,Clear,886,774,112
2012-10-25,2012,October,18,Thursday,Winter,Clear,809,732,77
2012-10-25,2012,October,19,Thursday,Winter,Clear,542,497,45
2012-10-25,2012,October,20,Thursday,Winter,Cloudy,347,319,28
2012-10-25,2012,October,21,Thursday,Winter,Cloudy,271,247,24
2012-10-25,2012,October,22,Thursday,Winter,Cloudy,207,185,22
2012-10-25,2012,October,23,Thursday,Winter,Cloudy,135,122,13
2012-10-26,2012,October,0,Friday,Winter,Cloudy,71,65,6
2012-10-26,2012,October,1,Friday,Winter,Cloudy,36,32,4
2012-10-26,2012,October,2,Friday,Winter,Cloudy,19,15,4
2012-10-26,2012,October,3,Friday,Winter,Cloudy,13,8,5
2012-10-26,2012,October,4,Friday,Winter,Cloudy,5,4,1
2012-10-26,2012,October,5,Friday,Winter,Cloudy,50,47,3
2012-10-26,2012,October,6,Friday,Winter,Cloudy,144,142,2
2012-10-26,2012,October,7,Friday,Winter,Cloudy,421,408,13
2012-10-26,2012,October,8,Friday,Winter,Cloudy,734,714,20
2012-10-26,2012,October,9,Friday,Winter,Cloudy,403,347,56
2012-10-26,2012,October,10,Friday,Winter,Cloudy,197,156,41
2012-10-26,2012,October,11,Friday,Winter,Cloudy,290,222,68
2012-10-26,2012,October,12,Friday,Winter,Cloudy,392,302,90
2012-10-26,2012,October,13,Friday,Winter,Cloudy,337,260,77
2012-10-26,2012,October,14,Friday,Winter,Cloudy,351,252,99
2012-10-26,2012,October,15,Friday,Winter,Cloudy,448,306,142
2012-10-26,2012,October,16,Friday,Winter,Cloudy,582,445,137
2012-10-26,2012,October,17,Friday,Winter,Cloudy,817,692,125
2012-10-26,2012,October,18,Friday,Winter,Cloudy,665,584,81
2012-10-26,2012,October,19,Friday,Winter,Cloudy,471,399,72
2012-10-26,2012,October,20,Friday,Winter,Cloudy,311,271,40
2012-10-26,2012,October,21,Friday,Winter,Cloudy,292,252,40
2012-10-26,2012,October,22,Friday,Winter,Cloudy,217,180,37
2012-10-26,2012,October,23,Friday,Winter,Clear,178,159,19
2012-10-27,2012,October,0,Saturday,Winter,Clear,142,132,10
2012-10-27,2012,October,1,Saturday,Winter,Cloudy,146,123,23
2012-10-27,2012,October,2,Saturday,Winter,Cloudy,90,71,19
2012-10-27,2012,October,3,Saturday,Winter,Clear,26,21,5
2012-10-27,2012,October,4,Saturday,Winter,Cloudy,13,12,1
2012-10-27,2012,October,5,Saturday,Winter,Cloudy,9,7,2
2012-10-27,2012,October,6,Saturday,Winter,Cloudy,31,29,2
2012-10-27,2012,October,7,Saturday,Winter,Clear,86,79,7
2012-10-27,2012,October,8,Saturday,Winter,Clear,213,187,26
2012-10-27,2012,October,9,Saturday,Winter,Clear,328,240,88
2012-10-27,2012,October,10,Saturday,Winter,Clear,479,314,165
2012-10-27,2012,October,11,Saturday,Winter,Clear,585,388,197
2012-10-27,2012,October,12,Saturday,Winter,Clear,668,404,264
2012-10-27,2012,October,13,Saturday,Winter,Clear,760,450,310
2012-10-27,2012,October,14,Saturday,Winter,Clear,750,425,325
2012-10-27,2012,October,15,Saturday,Winter,Cloudy,711,401,310
2012-10-27,2012,October,16,Saturday,Winter,Cloudy,612,355,257
2012-10-27,2012,October,17,Saturday,Winter,Cloudy,618,370,248
2012-10-27,2012,October,18,Saturday,Winter,Cloudy,456,318,138
2012-10-27,2012,October,19,Saturday,Winter,Cloudy,300,233,67
2012-10-27,2012,October,20,Saturday,Winter,Cloudy,296,238,58
2012-10-27,2012,October,21,Saturday,Winter,Cloudy,209,160,49
2012-10-27,2012,October,22,Saturday,Winter,Cloudy,157,116,41
2012-10-27,2012,October,23,Saturday,Winter,Cloudy,167,136,31
2012-10-28,2012,October,0,Sunday,Winter,Light Snow/Rain,117,97,20
2012-10-28,2012,October,1,Sunday,Winter,Cloudy,133,111,22
2012-10-28,2012,October,2,Sunday,Winter,Cloudy,116,99,17
2012-10-28,2012,October,3,Sunday,Winter,Cloudy,79,61,18
2012-10-28,2012,October,4,Sunday,Winter,Cloudy,20,19,1
2012-10-28,2012,October,5,Sunday,Winter,Cloudy,28,22,6
2012-10-28,2012,October,6,Sunday,Winter,Cloudy,39,32,7
2012-10-28,2012,October,7,Sunday,Winter,Cloudy,65,48,17
2012-10-28,2012,October,8,Sunday,Winter,Cloudy,173,118,55
2012-10-28,2012,October,9,Sunday,Winter,Cloudy,330,206,124
2012-10-28,2012,October,10,Sunday,Winter,Cloudy,434,314,120
2012-10-28,2012,October,11,Sunday,Winter,Cloudy,462,352,110
2012-10-28,2012,October,12,Sunday,Winter,Cloudy,491,373,118
2012-10-28,2012,October,13,Sunday,Winter,Cloudy,391,316,75
2012-10-28,2012,October,14,Sunday,Winter,Cloudy,402,304,98
2012-10-28,2012,October,15,Sunday,Winter,Cloudy,301,225,76
2012-10-28,2012,October,16,Sunday,Winter,Light Snow/Rain,293,251,42
2012-10-28,2012,October,17,Sunday,Winter,Light Snow/Rain,225,188,37
2012-10-28,2012,October,18,Sunday,Winter,Light Snow/Rain,154,136,18
2012-10-28,2012,October,19,Sunday,Winter,Light Snow/Rain,54,47,7
2012-10-28,2012,October,20,Sunday,Winter,Light Snow/Rain,55,51,4
2012-10-28,2012,October,21,Sunday,Winter,Light Snow/Rain,46,44,2
2012-10-28,2012,October,22,Sunday,Winter,Light Snow/Rain,37,35,2
2012-10-28,2012,October,23,Sunday,Winter,Light Snow/Rain,14,12,2
2012-10-29,2012,October,0,Monday,Winter,Light Snow/Rain,22,20,2
2012-10-30,2012,October,13,Tuesday,Winter,Light Snow/Rain,116,105,11
2012-10-30,2012,October,14,Tuesday,Winter,Light Snow/Rain,126,118,8
2012-10-30,2012,October,15,Tuesday,Winter,Light Snow/Rain,124,114,10
2012-10-30,2012,October,16,Tuesday,Winter,Light Snow/Rain,98,83,15
2012-10-30,2012,October,17,Tuesday,Winter,Light Snow/Rain,124,105,19
2012-10-30,2012,October,18,Tuesday,Winter,Light Snow/Rain,143,139,4
2012-10-30,2012,October,19,Tuesday,Winter,Cloudy,115,109,6
2012-10-30,2012,October,20,Tuesday,Winter,Cloudy,81,76,5
2012-10-30,2012,October,21,Tuesday,Winter,Cloudy,64,60,4
2012-10-30,2012,October,22,Tuesday,Winter,Clear,66,64,2
2012-10-30,2012,October,23,Tuesday,Winter,Clear,39,36,3
2012-10-31,2012,October,0,Wednesday,Winter,Cloudy,16,16,0
2012-10-31,2012,October,1,Wednesday,Winter,Cloudy,8,8,0
2012-10-31,2012,October,2,Wednesday,Winter,Cloudy,7,7,0
2012-10-31,2012,October,3,Wednesday,Winter,Cloudy,3,3,0
2012-10-31,2012,October,4,Wednesday,Winter,Cloudy,5,5,0
2012-10-31,2012,October,5,Wednesday,Winter,Cloudy,24,24,0
2012-10-31,2012,October,6,Wednesday,Winter,Clear,116,116,0
2012-10-31,2012,October,7,Wednesday,Winter,Cloudy,337,334,3
2012-10-31,2012,October,8,Wednesday,Winter,Clear,621,615,6
2012-10-31,2012,October,9,Wednesday,Winter,Clear,297,280,17
2012-10-31,2012,October,10,Wednesday,Winter,Clear,168,147,21
2012-10-31,2012,October,11,Wednesday,Winter,Cloudy,189,152,37
2012-10-31,2012,October,12,Wednesday,Winter,Clear,241,197,44
2012-10-31,2012,October,13,Wednesday,Winter,Clear,213,191,22
2012-10-31,2012,October,14,Wednesday,Winter,Cloudy,224,179,45
2012-10-31,2012,October,15,Wednesday,Winter,Clear,230,197,33
2012-10-31,2012,October,16,Wednesday,Winter,Cloudy,424,373,51
2012-10-31,2012,October,17,Wednesday,Winter,Cloudy,723,684,39
2012-10-31,2012,October,18,Wednesday,Winter,Cloudy,584,556,28
2012-10-31,2012,October,19,Wednesday,Winter,Cloudy,410,383,27
2012-10-31,2012,October,20,Wednesday,Winter,Cloudy,268,259,9
2012-10-31,2012,October,21,Wednesday,Winter,Cloudy,192,180,12
2012-10-31,2012,October,22,Wednesday,Winter,Clear,165,147,18
2012-10-31,2012,October,23,Wednesday,Winter,Clear,101,94,7
2012-11-01,2012,November,0,Thursday,Winter,Clear,60,52,8
2012-11-01,2012,November,1,Thursday,Winter,Clear,30,22,8
2012-11-01,2012,November,2,Thursday,Winter,Clear,20,10,10
2012-11-01,2012,November,3,Thursday,Winter,Clear,15,10,5
2012-11-01,2012,November,4,Thursday,Winter,Cloudy,10,8,2
2012-11-01,2012,November,5,Thursday,Winter,Clear,40,39,1
2012-11-01,2012,November,6,Thursday,Winter,Clear,148,146,2
2012-11-01,2012,November,7,Thursday,Winter,Cloudy,420,414,6
2012-11-01,2012,November,8,Thursday,Winter,Cloudy,680,668,12
2012-11-01,2012,November,9,Thursday,Winter,Light Snow/Rain,331,310,21
2012-11-01,2012,November,10,Thursday,Winter,Light Snow/Rain,146,133,13
2012-11-01,2012,November,11,Thursday,Winter,Light Snow/Rain,170,156,14
2012-11-01,2012,November,12,Thursday,Winter,Light Snow/Rain,221,198,23
2012-11-01,2012,November,13,Thursday,Winter,Cloudy,248,199,49
2012-11-01,2012,November,14,Thursday,Winter,Cloudy,185,154,31
2012-11-01,2012,November,15,Thursday,Winter,Cloudy,214,179,35
2012-11-01,2012,November,16,Thursday,Winter,Cloudy,344,313,31
2012-11-01,2012,November,17,Thursday,Winter,Light Snow/Rain,689,652,37
2012-11-01,2012,November,18,Thursday,Winter,Cloudy,678,628,50
2012-11-01,2012,November,19,Thursday,Winter,Cloudy,452,424,28
2012-11-01,2012,November,20,Thursday,Winter,Cloudy,296,280,16
2012-11-01,2012,November,21,Thursday,Winter,Cloudy,267,238,29
2012-11-01,2012,November,22,Thursday,Winter,Clear,202,175,27
2012-11-01,2012,November,23,Thursday,Winter,Clear,120,112,8
2012-11-02,2012,November,0,Friday,Winter,Clear,50,40,10
2012-11-02,2012,November,1,Friday,Winter,Clear,24,19,5
2012-11-02,2012,November,2,Friday,Winter,Clear,10,7,3
2012-11-02,2012,November,3,Friday,Winter,Clear,3,3,0
2012-11-02,2012,November,4,Friday,Winter,Clear,7,6,1
2012-11-02,2012,November,5,Friday,Winter,Cloudy,26,25,1
2012-11-02,2012,November,6,Friday,Winter,Clear,122,120,2
2012-11-02,2012,November,7,Friday,Winter,Cloudy,357,349,8
2012-11-02,2012,November,8,Friday,Winter,Clear,687,656,31
2012-11-02,2012,November,9,Friday,Winter,Clear,382,355,27
2012-11-02,2012,November,10,Friday,Winter,Clear,204,183,21
2012-11-02,2012,November,11,Friday,Winter,Clear,221,179,42
2012-11-02,2012,November,12,Friday,Winter,Clear,292,240,52
2012-11-02,2012,November,13,Friday,Winter,Clear,294,230,64
2012-11-02,2012,November,14,Friday,Winter,Cloudy,262,199,63
2012-11-02,2012,November,15,Friday,Winter,Cloudy,306,255,51
2012-11-02,2012,November,16,Friday,Winter,Clear,421,373,48
2012-11-02,2012,November,17,Friday,Winter,Clear,638,581,57
2012-11-02,2012,November,18,Friday,Winter,Cloudy,522,490,32
2012-11-02,2012,November,19,Friday,Winter,Cloudy,374,336,38
2012-11-02,2012,November,20,Friday,Winter,Cloudy,221,207,14
2012-11-02,2012,November,21,Friday,Winter,Cloudy,156,133,23
2012-11-02,2012,November,22,Friday,Winter,Clear,149,135,14
2012-11-02,2012,November,23,Friday,Winter,Clear,119,108,11
2012-11-03,2012,November,0,Saturday,Winter,Clear,108,99,9
2012-11-03,2012,November,1,Saturday,Winter,Cloudy,89,83,6
2012-11-03,2012,November,2,Saturday,Winter,Cloudy,46,36,10
2012-11-03,2012,November,3,Saturday,Winter,Cloudy,28,22,6
2012-11-03,2012,November,4,Saturday,Winter,Cloudy,16,8,8
2012-11-03,2012,November,5,Saturday,Winter,Cloudy,9,8,1
2012-11-03,2012,November,6,Saturday,Winter,Cloudy,21,17,4
2012-11-03,2012,November,7,Saturday,Winter,Cloudy,59,58,1
2012-11-03,2012,November,8,Saturday,Winter,Cloudy,142,132,10
2012-11-03,2012,November,9,Saturday,Winter,Cloudy,219,188,31
2012-11-03,2012,November,10,Saturday,Winter,Clear,328,260,68
2012-11-03,2012,November,11,Saturday,Winter,Cloudy,340,284,56
2012-11-03,2012,November,12,Saturday,Winter,Cloudy,394,320,74
2012-11-03,2012,November,13,Saturday,Winter,Cloudy,449,339,110
2012-11-03,2012,November,14,Saturday,Winter,Cloudy,455,319,136
2012-11-03,2012,November,15,Saturday,Winter,Cloudy,448,331,117
2012-11-03,2012,November,16,Saturday,Winter,Cloudy,400,292,108
2012-11-03,2012,November,17,Saturday,Winter,Cloudy,410,298,112
2012-11-03,2012,November,18,Saturday,Winter,Cloudy,297,239,58
2012-11-03,2012,November,19,Saturday,Winter,Clear,239,217,22
2012-11-03,2012,November,20,Saturday,Winter,Clear,181,158,23
2012-11-03,2012,November,21,Saturday,Winter,Clear,166,135,31
2012-11-03,2012,November,22,Saturday,Winter,Clear,146,133,13
2012-11-03,2012,November,23,Saturday,Winter,Clear,148,133,15
2012-11-04,2012,November,0,Sunday,Winter,Clear,102,97,5
2012-11-04,2012,November,1,Sunday,Winter,Clear,165,139,26
2012-11-04,2012,November,2,Sunday,Winter,Clear,37,31,6
2012-11-04,2012,November,3,Sunday,Winter,Clear,11,10,1
2012-11-04,2012,November,4,Sunday,Winter,Clear,9,7,2
2012-11-04,2012,November,5,Sunday,Winter,Clear,5,5,0
2012-11-04,2012,November,6,Sunday,Winter,Clear,16,14,2
2012-11-04,2012,November,7,Sunday,Winter,Clear,50,39,11
2012-11-04,2012,November,8,Sunday,Winter,Clear,149,115,34
2012-11-04,2012,November,9,Sunday,Winter,Clear,217,161,56
2012-11-04,2012,November,10,Sunday,Winter,Clear,360,287,73
2012-11-04,2012,November,11,Sunday,Winter,Clear,445,311,134
2012-11-04,2012,November,12,Sunday,Winter,Clear,504,354,150
2012-11-04,2012,November,13,Sunday,Winter,Clear,493,371,122
2012-11-04,2012,November,14,Sunday,Winter,Clear,509,360,149
2012-11-04,2012,November,15,Sunday,Winter,Clear,449,300,149
2012-11-04,2012,November,16,Sunday,Winter,Clear,435,316,119
2012-11-04,2012,November,17,Sunday,Winter,Clear,327,270,57
2012-11-04,2012,November,18,Sunday,Winter,Clear,237,206,31
2012-11-04,2012,November,19,Sunday,Winter,Clear,227,203,24
2012-11-04,2012,November,20,Sunday,Winter,Clear,141,134,7
2012-11-04,2012,November,21,Sunday,Winter,Clear,87,71,16
2012-11-04,2012,November,22,Sunday,Winter,Clear,79,64,15
2012-11-04,2012,November,23,Sunday,Winter,Cloudy,53,41,12
2012-11-05,2012,November,0,Monday,Winter,Cloudy,23,20,3
2012-11-05,2012,November,1,Monday,Winter,Cloudy,8,8,0
2012-11-05,2012,November,2,Monday,Winter,Cloudy,6,4,2
2012-11-05,2012,November,3,Monday,Winter,Cloudy,4,3,1
2012-11-05,2012,November,4,Monday,Winter,Cloudy,16,11,5
2012-11-05,2012,November,5,Monday,Winter,Cloudy,39,38,1
2012-11-05,2012,November,6,Monday,Winter,Cloudy,139,135,4
2012-11-05,2012,November,7,Monday,Winter,Cloudy,461,453,8
2012-11-05,2012,November,8,Monday,Winter,Cloudy,648,629,19
2012-11-05,2012,November,9,Monday,Winter,Cloudy,257,239,18
2012-11-05,2012,November,10,Monday,Winter,Clear,142,112,30
2012-11-05,2012,November,11,Monday,Winter,Clear,150,119,31
2012-11-05,2012,November,12,Monday,Winter,Clear,244,206,38
2012-11-05,2012,November,13,Monday,Winter,Clear,222,183,39
2012-11-05,2012,November,14,Monday,Winter,Clear,196,165,31
2012-11-05,2012,November,15,Monday,Winter,Clear,231,207,24
2012-11-05,2012,November,16,Monday,Winter,Clear,360,325,35
2012-11-05,2012,November,17,Monday,Winter,Clear,638,604,34
2012-11-05,2012,November,18,Monday,Winter,Clear,542,523,19
2012-11-05,2012,November,19,Monday,Winter,Clear,372,361,11
2012-11-05,2012,November,20,Monday,Winter,Clear,241,228,13
2012-11-05,2012,November,21,Monday,Winter,Clear,152,144,8
2012-11-05,2012,November,22,Monday,Winter,Clear,115,111,4
2012-11-05,2012,November,23,Monday,Winter,Clear,53,53,0
2012-11-06,2012,November,0,Tuesday,Winter,Clear,19,18,1
2012-11-06,2012,November,1,Tuesday,Winter,Clear,8,8,0
2012-11-06,2012,November,2,Tuesday,Winter,Clear,2,2,0
2012-11-06,2012,November,3,Tuesday,Winter,Clear,4,4,0
2012-11-06,2012,November,4,Tuesday,Winter,Clear,7,7,0
2012-11-06,2012,November,5,Tuesday,Winter,Cloudy,41,40,1
2012-11-06,2012,November,6,Tuesday,Winter,Clear,149,143,6
2012-11-06,2012,November,7,Tuesday,Winter,Clear,387,378,9
2012-11-06,2012,November,8,Tuesday,Winter,Clear,588,568,20
2012-11-06,2012,November,9,Tuesday,Winter,Clear,363,338,25
2012-11-06,2012,November,10,Tuesday,Winter,Clear,230,189,41
2012-11-06,2012,November,11,Tuesday,Winter,Clear,216,177,39
2012-11-06,2012,November,12,Tuesday,Winter,Clear,248,217,31
2012-11-06,2012,November,13,Tuesday,Winter,Clear,278,232,46
2012-11-06,2012,November,14,Tuesday,Winter,Clear,240,196,44
2012-11-06,2012,November,15,Tuesday,Winter,Clear,272,227,45
2012-11-06,2012,November,16,Tuesday,Winter,Clear,402,369,33
2012-11-06,2012,November,17,Tuesday,Winter,Clear,627,597,30
2012-11-06,2012,November,18,Tuesday,Winter,Clear,497,477,20
2012-11-06,2012,November,19,Tuesday,Winter,Clear,371,356,15
2012-11-06,2012,November,20,Tuesday,Winter,Clear,228,218,10
2012-11-06,2012,November,21,Tuesday,Winter,Cloudy,151,137,14
2012-11-06,2012,November,22,Tuesday,Winter,Cloudy,153,136,17
2012-11-06,2012,November,23,Tuesday,Winter,Clear,205,186,19
2012-11-07,2012,November,0,Wednesday,Winter,Cloudy,283,234,49
2012-11-07,2012,November,1,Wednesday,Winter,Cloudy,92,86,6
2012-11-07,2012,November,2,Wednesday,Winter,Cloudy,74,68,6
2012-11-07,2012,November,3,Wednesday,Winter,Cloudy,11,9,2
2012-11-07,2012,November,4,Wednesday,Winter,Cloudy,9,9,0
2012-11-07,2012,November,5,Wednesday,Winter,Cloudy,27,27,0
2012-11-07,2012,November,6,Wednesday,Winter,Cloudy,118,115,3
2012-11-07,2012,November,7,Wednesday,Winter,Cloudy,319,314,5
2012-11-07,2012,November,8,Wednesday,Winter,Cloudy,601,583,18
2012-11-07,2012,November,9,Wednesday,Winter,Cloudy,368,351,17
2012-11-07,2012,November,10,Wednesday,Winter,Cloudy,178,151,27
2012-11-07,2012,November,11,Wednesday,Winter,Cloudy,147,132,15
2012-11-07,2012,November,12,Wednesday,Winter,Cloudy,212,188,24
2012-11-07,2012,November,13,Wednesday,Winter,Cloudy,181,158,23
2012-11-07,2012,November,14,Wednesday,Winter,Cloudy,161,142,19
2012-11-07,2012,November,15,Wednesday,Winter,Cloudy,198,178,20
2012-11-07,2012,November,16,Wednesday,Winter,Cloudy,273,250,23
2012-11-07,2012,November,17,Wednesday,Winter,Cloudy,517,501,16
2012-11-07,2012,November,18,Wednesday,Winter,Cloudy,465,448,17
2012-11-07,2012,November,19,Wednesday,Winter,Cloudy,319,302,17
2012-11-07,2012,November,20,Wednesday,Winter,Cloudy,256,249,7
2012-11-07,2012,November,21,Wednesday,Winter,Cloudy,126,121,5
2012-11-07,2012,November,22,Wednesday,Winter,Light Snow/Rain,60,56,4
2012-11-07,2012,November,23,Wednesday,Winter,Light Snow/Rain,40,37,3
2012-11-08,2012,November,0,Thursday,Winter,Light Snow/Rain,15,14,1
2012-11-08,2012,November,1,Thursday,Winter,Light Snow/Rain,12,11,1
2012-11-08,2012,November,2,Thursday,Winter,Cloudy,6,5,1
2012-11-08,2012,November,4,Thursday,Winter,Cloudy,10,9,1
2012-11-08,2012,November,5,Thursday,Winter,Cloudy,35,35,0
2012-11-08,2012,November,6,Thursday,Winter,Clear,124,122,2
2012-11-08,2012,November,7,Thursday,Winter,Clear,423,411,12
2012-11-08,2012,November,8,Thursday,Winter,Clear,668,652,16
2012-11-08,2012,November,9,Thursday,Winter,Clear,275,253,22
2012-11-08,2012,November,10,Thursday,Winter,Clear,161,148,13
2012-11-08,2012,November,11,Thursday,Winter,Clear,171,155,16
2012-11-08,2012,November,12,Thursday,Winter,Clear,235,202,33
2012-11-08,2012,November,13,Thursday,Winter,Clear,228,195,33
2012-11-08,2012,November,14,Thursday,Winter,Clear,182,149,33
2012-11-08,2012,November,15,Thursday,Winter,Clear,233,201,32
2012-11-08,2012,November,16,Thursday,Winter,Clear,339,321,18
2012-11-08,2012,November,17,Thursday,Winter,Clear,592,556,36
2012-11-08,2012,November,18,Thursday,Winter,Clear,507,491,16
2012-11-08,2012,November,19,Thursday,Winter,Clear,373,359,14
2012-11-08,2012,November,20,Thursday,Winter,Clear,245,235,10
2012-11-08,2012,November,21,Thursday,Winter,Clear,233,222,11
2012-11-08,2012,November,22,Thursday,Winter,Clear,161,147,14
2012-11-08,2012,November,23,Thursday,Winter,Clear,87,82,5
2012-11-09,2012,November,0,Friday,Winter,Clear,55,46,9
2012-11-09,2012,November,1,Friday,Winter,Clear,20,17,3
2012-11-09,2012,November,2,Friday,Winter,Clear,12,11,1
2012-11-09,2012,November,3,Friday,Winter,Clear,9,6,3
2012-11-09,2012,November,4,Friday,Winter,Clear,14,14,0
2012-11-09,2012,November,5,Friday,Winter,Clear,27,25,2
2012-11-09,2012,November,6,Friday,Winter,Clear,131,126,5
2012-11-09,2012,November,7,Friday,Winter,Clear,341,332,9
2012-11-09,2012,November,8,Friday,Winter,Clear,693,668,25
2012-11-09,2012,November,9,Friday,Winter,Clear,327,304,23
2012-11-09,2012,November,10,Friday,Winter,Clear,197,163,34
2012-11-09,2012,November,11,Friday,Winter,Clear,251,185,66
2012-11-09,2012,November,12,Friday,Winter,Clear,262,214,48
2012-11-09,2012,November,13,Friday,Winter,Clear,299,237,62
2012-11-09,2012,November,14,Friday,Winter,Clear,274,207,67
2012-11-09,2012,November,15,Friday,Winter,Clear,356,278,78
2012-11-09,2012,November,16,Friday,Winter,Clear,434,377,57
2012-11-09,2012,November,17,Friday,Winter,Clear,654,593,61
2012-11-09,2012,November,18,Friday,Winter,Clear,496,450,46
2012-11-09,2012,November,19,Friday,Winter,Clear,361,331,30
2012-11-09,2012,November,20,Friday,Winter,Clear,255,235,20
2012-11-09,2012,November,21,Friday,Winter,Clear,199,176,23
2012-11-09,2012,November,22,Friday,Winter,Clear,163,146,17
2012-11-09,2012,November,23,Friday,Winter,Clear,162,142,20
2012-11-10,2012,November,0,Saturday,Winter,Clear,122,106,16
2012-11-10,2012,November,1,Saturday,Winter,Clear,76,68,8
2012-11-10,2012,November,2,Saturday,Winter,Clear,44,42,2
2012-11-10,2012,November,3,Saturday,Winter,Clear,20,11,9
2012-11-10,2012,November,4,Saturday,Winter,Clear,6,4,2
2012-11-10,2012,November,5,Saturday,Winter,Clear,10,9,1
2012-11-10,2012,November,6,Saturday,Winter,Clear,16,11,5
2012-11-10,2012,November,7,Saturday,Winter,Clear,71,57,14
2012-11-10,2012,November,8,Saturday,Winter,Clear,146,130,16
2012-11-10,2012,November,9,Saturday,Winter,Clear,259,216,43
2012-11-10,2012,November,10,Saturday,Winter,Clear,350,264,86
2012-11-10,2012,November,11,Saturday,Winter,Clear,466,323,143
2012-11-10,2012,November,12,Saturday,Winter,Clear,606,348,258
2012-11-10,2012,November,13,Saturday,Winter,Clear,651,383,268
2012-11-10,2012,November,14,Saturday,Winter,Clear,627,347,280
2012-11-10,2012,November,15,Saturday,Winter,Clear,567,351,216
2012-11-10,2012,November,16,Saturday,Winter,Clear,605,378,227
2012-11-10,2012,November,17,Saturday,Winter,Clear,501,318,183
2012-11-10,2012,November,18,Saturday,Winter,Clear,359,256,103
2012-11-10,2012,November,19,Saturday,Winter,Clear,283,228,55
2012-11-10,2012,November,20,Saturday,Winter,Clear,192,153,39
2012-11-10,2012,November,21,Saturday,Winter,Clear,220,169,51
2012-11-10,2012,November,22,Saturday,Winter,Clear,193,154,39
2012-11-10,2012,November,23,Saturday,Winter,Clear,146,120,26
2012-11-11,2012,November,0,Sunday,Winter,Clear,124,110,14
2012-11-11,2012,November,1,Sunday,Winter,Clear,108,82,26
2012-11-11,2012,November,2,Sunday,Winter,Clear,70,58,12
2012-11-11,2012,November,3,Sunday,Winter,Clear,48,39,9
2012-11-11,2012,November,4,Sunday,Winter,Clear,11,6,5
2012-11-11,2012,November,5,Sunday,Winter,Clear,12,12,0
2012-11-11,2012,November,6,Sunday,Winter,Clear,19,16,3
2012-11-11,2012,November,7,Sunday,Winter,Clear,68,56,12
2012-11-11,2012,November,8,Sunday,Winter,Clear,119,87,32
2012-11-11,2012,November,9,Sunday,Winter,Clear,273,179,94
2012-11-11,2012,November,10,Sunday,Winter,Clear,405,272,133
2012-11-11,2012,November,11,Sunday,Winter,Clear,504,324,180
2012-11-11,2012,November,12,Sunday,Winter,Clear,585,390,195
2012-11-11,2012,November,13,Sunday,Winter,Clear,686,424,262
2012-11-11,2012,November,14,Sunday,Winter,Clear,654,362,292
2012-11-11,2012,November,15,Sunday,Winter,Clear,724,420,304
2012-11-11,2012,November,16,Sunday,Winter,Clear,653,393,260
2012-11-11,2012,November,17,Sunday,Winter,Clear,493,342,151
2012-11-11,2012,November,18,Sunday,Winter,Clear,405,303,102
2012-11-11,2012,November,19,Sunday,Winter,Clear,277,208,69
2012-11-11,2012,November,20,Sunday,Winter,Clear,200,146,54
2012-11-11,2012,November,21,Sunday,Winter,Clear,171,127,44
2012-11-11,2012,November,22,Sunday,Winter,Clear,134,113,21
2012-11-11,2012,November,23,Sunday,Winter,Clear,109,93,16
2012-11-12,2012,November,0,Monday,Winter,Clear,49,43,6
2012-11-12,2012,November,1,Monday,Winter,Clear,30,26,4
2012-11-12,2012,November,2,Monday,Winter,Clear,20,14,6
2012-11-12,2012,November,3,Monday,Winter,Clear,4,3,1
2012-11-12,2012,November,4,Monday,Winter,Clear,4,3,1
2012-11-12,2012,November,5,Monday,Winter,Clear,24,23,1
2012-11-12,2012,November,6,Monday,Winter,Clear,71,64,7
2012-11-12,2012,November,7,Monday,Winter,Clear,264,248,16
2012-11-12,2012,November,8,Monday,Winter,Clear,540,490,50
2012-11-12,2012,November,9,Monday,Winter,Clear,397,337,60
2012-11-12,2012,November,10,Monday,Winter,Clear,266,184,82
2012-11-12,2012,November,11,Monday,Winter,Clear,367,255,112
2012-11-12,2012,November,12,Monday,Winter,Clear,419,314,105
2012-11-12,2012,November,13,Monday,Winter,Clear,420,312,108
2012-11-12,2012,November,14,Monday,Winter,Clear,444,310,134
2012-11-12,2012,November,15,Monday,Winter,Clear,382,280,102
2012-11-12,2012,November,16,Monday,Winter,Clear,434,347,87
2012-11-12,2012,November,17,Monday,Winter,Clear,596,530,66
2012-11-12,2012,November,18,Monday,Winter,Clear,551,486,65
2012-11-12,2012,November,19,Monday,Winter,Clear,353,323,30
2012-11-12,2012,November,20,Monday,Winter,Cloudy,304,273,31
2012-11-12,2012,November,21,Monday,Winter,Light Snow/Rain,155,145,10
2012-11-12,2012,November,22,Monday,Winter,Clear,112,100,12
2012-11-12,2012,November,23,Monday,Winter,Cloudy,63,62,1
2012-11-13,2012,November,0,Tuesday,Winter,Cloudy,23,18,5
2012-11-13,2012,November,1,Tuesday,Winter,Light Snow/Rain,5,5,0
2012-11-13,2012,November,2,Tuesday,Winter,Light Snow/Rain,11,4,7
2012-11-13,2012,November,3,Tuesday,Winter,Light Snow/Rain,5,3,2
2012-11-13,2012,November,4,Tuesday,Winter,Cloudy,9,9,0
2012-11-13,2012,November,5,Tuesday,Winter,Cloudy,18,18,0
2012-11-13,2012,November,6,Tuesday,Winter,Light Snow/Rain,50,48,2
2012-11-13,2012,November,7,Tuesday,Winter,Light Snow/Rain,107,106,1
2012-11-13,2012,November,8,Tuesday,Winter,Light Snow/Rain,211,207,4
2012-11-13,2012,November,9,Tuesday,Winter,Light Snow/Rain,110,109,1
2012-11-13,2012,November,10,Tuesday,Winter,Light Snow/Rain,94,84,10
2012-11-13,2012,November,11,Tuesday,Winter,Clear,155,133,22
2012-11-13,2012,November,12,Tuesday,Winter,Clear,196,180,16
2012-11-13,2012,November,13,Tuesday,Winter,Clear,218,188,30
2012-11-13,2012,November,14,Tuesday,Winter,Clear,203,169,34
2012-11-13,2012,November,15,Tuesday,Winter,Clear,217,184,33
2012-11-13,2012,November,16,Tuesday,Winter,Clear,310,282,28
2012-11-13,2012,November,17,Tuesday,Winter,Clear,608,575,33
2012-11-13,2012,November,18,Tuesday,Winter,Clear,559,514,45
2012-11-13,2012,November,19,Tuesday,Winter,Clear,356,344,12
2012-11-13,2012,November,20,Tuesday,Winter,Clear,223,211,12
2012-11-13,2012,November,21,Tuesday,Winter,Clear,187,178,9
2012-11-13,2012,November,22,Tuesday,Winter,Clear,135,120,15
2012-11-13,2012,November,23,Tuesday,Winter,Clear,84,78,6
2012-11-14,2012,November,0,Wednesday,Winter,Clear,24,20,4
2012-11-14,2012,November,1,Wednesday,Winter,Clear,12,10,2
2012-11-14,2012,November,2,Wednesday,Winter,Clear,1,1,0
2012-11-14,2012,November,3,Wednesday,Winter,Clear,5,5,0
2012-11-14,2012,November,4,Wednesday,Winter,Clear,6,6,0
2012-11-14,2012,November,5,Wednesday,Winter,Clear,39,39,0
2012-11-14,2012,November,6,Wednesday,Winter,Clear,146,142,4
2012-11-14,2012,November,7,Wednesday,Winter,Clear,415,405,10
2012-11-14,2012,November,8,Wednesday,Winter,Clear,691,664,27
2012-11-14,2012,November,9,Wednesday,Winter,Clear,332,310,22
2012-11-14,2012,November,10,Wednesday,Winter,Clear,171,153,18
2012-11-14,2012,November,11,Wednesday,Winter,Clear,151,126,25
2012-11-14,2012,November,12,Wednesday,Winter,Clear,240,200,40
2012-11-14,2012,November,13,Wednesday,Winter,Clear,214,182,32
2012-11-14,2012,November,14,Wednesday,Winter,Clear,181,161,20
2012-11-14,2012,November,15,Wednesday,Winter,Clear,260,228,32
2012-11-14,2012,November,16,Wednesday,Winter,Clear,321,290,31
2012-11-14,2012,November,17,Wednesday,Winter,Clear,583,564,19
2012-11-14,2012,November,18,Wednesday,Winter,Clear,567,543,24
2012-11-14,2012,November,19,Wednesday,Winter,Clear,396,368,28
2012-11-14,2012,November,20,Wednesday,Winter,Clear,267,252,15
2012-11-14,2012,November,21,Wednesday,Winter,Clear,213,208,5
2012-11-14,2012,November,22,Wednesday,Winter,Clear,173,167,6
2012-11-14,2012,November,23,Wednesday,Winter,Clear,87,78,9
2012-11-15,2012,November,0,Thursday,Winter,Cloudy,34,33,1
2012-11-15,2012,November,1,Thursday,Winter,Cloudy,16,14,2
2012-11-15,2012,November,2,Thursday,Winter,Cloudy,7,7,0
2012-11-15,2012,November,3,Thursday,Winter,Cloudy,2,2,0
2012-11-15,2012,November,4,Thursday,Winter,Cloudy,5,5,0
2012-11-15,2012,November,5,Thursday,Winter,Cloudy,37,34,3
2012-11-15,2012,November,6,Thursday,Winter,Cloudy,147,146,1
2012-11-15,2012,November,7,Thursday,Winter,Cloudy,410,403,7
2012-11-15,2012,November,8,Thursday,Winter,Cloudy,646,625,21
2012-11-15,2012,November,9,Thursday,Winter,Cloudy,323,306,17
2012-11-15,2012,November,10,Thursday,Winter,Cloudy,153,142,11
2012-11-15,2012,November,11,Thursday,Winter,Cloudy,166,138,28
2012-11-15,2012,November,12,Thursday,Winter,Cloudy,213,184,29
2012-11-15,2012,November,13,Thursday,Winter,Cloudy,217,197,20
2012-11-15,2012,November,14,Thursday,Winter,Cloudy,201,174,27
2012-11-15,2012,November,15,Thursday,Winter,Cloudy,217,191,26
2012-11-15,2012,November,16,Thursday,Winter,Cloudy,342,318,24
2012-11-15,2012,November,17,Thursday,Winter,Cloudy,563,541,22
2012-11-15,2012,November,18,Thursday,Winter,Cloudy,573,563,10
2012-11-15,2012,November,19,Thursday,Winter,Cloudy,386,375,11
2012-11-15,2012,November,20,Thursday,Winter,Clear,285,262,23
2012-11-15,2012,November,21,Thursday,Winter,Cloudy,224,204,20
2012-11-15,2012,November,22,Thursday,Winter,Cloudy,153,143,10
2012-11-15,2012,November,23,Thursday,Winter,Cloudy,125,118,7
2012-11-16,2012,November,0,Friday,Winter,Cloudy,65,58,7
2012-11-16,2012,November,1,Friday,Winter,Cloudy,21,16,5
2012-11-16,2012,November,2,Friday,Winter,Cloudy,9,9,0
2012-11-16,2012,November,3,Friday,Winter,Cloudy,6,6,0
2012-11-16,2012,November,4,Friday,Winter,Cloudy,5,5,0
2012-11-16,2012,November,5,Friday,Winter,Cloudy,36,34,2
2012-11-16,2012,November,6,Friday,Winter,Cloudy,130,126,4
2012-11-16,2012,November,7,Friday,Winter,Cloudy,367,362,5
2012-11-16,2012,November,8,Friday,Winter,Cloudy,711,694,17
2012-11-16,2012,November,9,Friday,Winter,Clear,351,330,21
2012-11-16,2012,November,10,Friday,Winter,Clear,198,165,33
2012-11-16,2012,November,11,Friday,Winter,Clear,218,185,33
2012-11-16,2012,November,12,Friday,Winter,Clear,290,262,28
2012-11-16,2012,November,13,Friday,Winter,Clear,278,226,52
2012-11-16,2012,November,14,Friday,Winter,Clear,251,204,47
2012-11-16,2012,November,15,Friday,Winter,Clear,267,237,30
2012-11-16,2012,November,16,Friday,Winter,Clear,383,350,33
2012-11-16,2012,November,17,Friday,Winter,Clear,580,539,41
2012-11-16,2012,November,18,Friday,Winter,Clear,505,483,22
2012-11-16,2012,November,19,Friday,Winter,Clear,332,306,26
2012-11-16,2012,November,20,Friday,Winter,Clear,227,207,20
2012-11-16,2012,November,21,Friday,Winter,Clear,178,157,21
2012-11-16,2012,November,22,Friday,Winter,Clear,162,139,23
2012-11-16,2012,November,23,Friday,Winter,Clear,128,114,14
2012-11-17,2012,November,0,Saturday,Winter,Clear,106,95,11
2012-11-17,2012,November,1,Saturday,Winter,Clear,87,74,13
2012-11-17,2012,November,2,Saturday,Winter,Clear,49,41,8
2012-11-17,2012,November,3,Saturday,Winter,Clear,21,19,2
2012-11-17,2012,November,4,Saturday,Winter,Clear,7,6,1
2012-11-17,2012,November,5,Saturday,Winter,Clear,11,10,1
2012-11-17,2012,November,6,Saturday,Winter,Clear,21,21,0
2012-11-17,2012,November,7,Saturday,Winter,Clear,78,70,8
2012-11-17,2012,November,8,Saturday,Winter,Clear,168,138,30
2012-11-17,2012,November,9,Saturday,Winter,Clear,248,200,48
2012-11-17,2012,November,10,Saturday,Winter,Clear,320,258,62
2012-11-17,2012,November,11,Saturday,Winter,Clear,423,343,80
2012-11-17,2012,November,12,Saturday,Winter,Clear,476,359,117
2012-11-17,2012,November,13,Saturday,Winter,Clear,525,346,179
2012-11-17,2012,November,14,Saturday,Winter,Clear,555,380,175
2012-11-17,2012,November,15,Saturday,Winter,Clear,549,374,175
2012-11-17,2012,November,16,Saturday,Winter,Clear,469,325,144
2012-11-17,2012,November,17,Saturday,Winter,Clear,403,302,101
2012-11-17,2012,November,18,Saturday,Winter,Clear,271,237,34
2012-11-17,2012,November,19,Saturday,Winter,Clear,253,208,45
2012-11-17,2012,November,20,Saturday,Winter,Cloudy,172,142,30
2012-11-17,2012,November,21,Saturday,Winter,Cloudy,139,124,15
2012-11-17,2012,November,22,Saturday,Winter,Cloudy,145,130,15
2012-11-17,2012,November,23,Saturday,Winter,Cloudy,133,114,19
2012-11-18,2012,November,0,Sunday,Winter,Cloudy,129,118,11
2012-11-18,2012,November,1,Sunday,Winter,Clear,95,81,14
2012-11-18,2012,November,2,Sunday,Winter,Clear,73,65,8
2012-11-18,2012,November,3,Sunday,Winter,Cloudy,46,37,9
2012-11-18,2012,November,4,Sunday,Winter,Cloudy,12,8,4
2012-11-18,2012,November,5,Sunday,Winter,Clear,12,7,5
2012-11-18,2012,November,6,Sunday,Winter,Clear,15,13,2
2012-11-18,2012,November,7,Sunday,Winter,Clear,42,39,3
2012-11-18,2012,November,8,Sunday,Winter,Clear,119,100,19
2012-11-18,2012,November,9,Sunday,Winter,Clear,204,155,49
2012-11-18,2012,November,10,Sunday,Winter,Clear,329,250,79
2012-11-18,2012,November,11,Sunday,Winter,Clear,359,267,92
2012-11-18,2012,November,12,Sunday,Winter,Clear,442,341,101
2012-11-18,2012,November,13,Sunday,Winter,Clear,447,334,113
2012-11-18,2012,November,14,Sunday,Winter,Clear,428,303,125
2012-11-18,2012,November,15,Sunday,Winter,Clear,407,318,89
2012-11-18,2012,November,16,Sunday,Winter,Cloudy,372,313,59
2012-11-18,2012,November,17,Sunday,Winter,Cloudy,280,232,48
2012-11-18,2012,November,18,Sunday,Winter,Clear,276,240,36
2012-11-18,2012,November,19,Sunday,Winter,Clear,210,194,16
2012-11-18,2012,November,20,Sunday,Winter,Clear,129,120,9
2012-11-18,2012,November,21,Sunday,Winter,Clear,110,93,17
2012-11-18,2012,November,22,Sunday,Winter,Cloudy,74,66,8
2012-11-18,2012,November,23,Sunday,Winter,Clear,59,53,6
2012-11-19,2012,November,0,Monday,Winter,Clear,27,22,5
2012-11-19,2012,November,1,Monday,Winter,Cloudy,19,19,0
2012-11-19,2012,November,2,Monday,Winter,Cloudy,5,5,0
2012-11-19,2012,November,3,Monday,Winter,Cloudy,2,2,0
2012-11-19,2012,November,4,Monday,Winter,Cloudy,12,11,1
2012-11-19,2012,November,5,Monday,Winter,Cloudy,39,38,1
2012-11-19,2012,November,6,Monday,Winter,Cloudy,131,128,3
2012-11-19,2012,November,7,Monday,Winter,Cloudy,386,381,5
2012-11-19,2012,November,8,Monday,Winter,Cloudy,663,650,13
2012-11-19,2012,November,9,Monday,Winter,Cloudy,278,260,18
2012-11-19,2012,November,10,Monday,Winter,Cloudy,139,106,33
2012-11-19,2012,November,11,Monday,Winter,Cloudy,197,164,33
2012-11-19,2012,November,12,Monday,Winter,Cloudy,242,207,35
2012-11-19,2012,November,13,Monday,Winter,Clear,251,205,46
2012-11-19,2012,November,14,Monday,Winter,Clear,217,170,47
2012-11-19,2012,November,15,Monday,Winter,Clear,257,213,44
2012-11-19,2012,November,16,Monday,Winter,Clear,380,325,55
2012-11-19,2012,November,17,Monday,Winter,Cloudy,619,586,33
2012-11-19,2012,November,18,Monday,Winter,Cloudy,580,559,21
2012-11-19,2012,November,19,Monday,Winter,Cloudy,406,381,25
2012-11-19,2012,November,20,Monday,Winter,Cloudy,259,252,7
2012-11-19,2012,November,21,Monday,Winter,Cloudy,203,188,15
2012-11-19,2012,November,22,Monday,Winter,Clear,113,106,7
2012-11-19,2012,November,23,Monday,Winter,Clear,74,72,2
2012-11-20,2012,November,0,Tuesday,Winter,Clear,29,26,3
2012-11-20,2012,November,1,Tuesday,Winter,Clear,13,10,3
2012-11-20,2012,November,2,Tuesday,Winter,Cloudy,5,5,0
2012-11-20,2012,November,3,Tuesday,Winter,Cloudy,2,2,0
2012-11-20,2012,November,4,Tuesday,Winter,Cloudy,6,6,0
2012-11-20,2012,November,5,Tuesday,Winter,Cloudy,34,32,2
2012-11-20,2012,November,6,Tuesday,Winter,Cloudy,148,146,2
2012-11-20,2012,November,7,Tuesday,Winter,Clear,418,411,7
2012-11-20,2012,November,8,Tuesday,Winter,Clear,665,649,16
2012-11-20,2012,November,9,Tuesday,Winter,Cloudy,326,298,28
2012-11-20,2012,November,10,Tuesday,Winter,Cloudy,176,144,32
2012-11-20,2012,November,11,Tuesday,Winter,Cloudy,205,160,45
2012-11-20,2012,November,12,Tuesday,Winter,Cloudy,313,243,70
2012-11-20,2012,November,13,Tuesday,Winter,Cloudy,267,218,49
2012-11-20,2012,November,14,Tuesday,Winter,Cloudy,224,177,47
2012-11-20,2012,November,15,Tuesday,Winter,Cloudy,287,226,61
2012-11-20,2012,November,16,Tuesday,Winter,Cloudy,395,335,60
2012-11-20,2012,November,17,Tuesday,Winter,Cloudy,590,553,37
2012-11-20,2012,November,18,Tuesday,Winter,Cloudy,550,534,16
2012-11-20,2012,November,19,Tuesday,Winter,Cloudy,384,361,23
2012-11-20,2012,November,20,Tuesday,Winter,Cloudy,235,224,11
2012-11-20,2012,November,21,Tuesday,Winter,Clear,157,143,14
2012-11-20,2012,November,22,Tuesday,Winter,Clear,122,115,7
2012-11-20,2012,November,23,Tuesday,Winter,Clear,83,82,1
2012-11-21,2012,November,0,Wednesday,Winter,Clear,26,25,1
2012-11-21,2012,November,1,Wednesday,Winter,Clear,14,13,1
2012-11-21,2012,November,2,Wednesday,Winter,Clear,8,6,2
2012-11-21,2012,November,3,Wednesday,Winter,Clear,2,2,0
2012-11-21,2012,November,4,Wednesday,Winter,Clear,10,10,0
2012-11-21,2012,November,5,Wednesday,Winter,Clear,29,28,1
2012-11-21,2012,November,6,Wednesday,Winter,Clear,101,99,2
2012-11-21,2012,November,7,Wednesday,Winter,Clear,273,262,11
2012-11-21,2012,November,8,Wednesday,Winter,Cloudy,551,539,12
2012-11-21,2012,November,9,Wednesday,Winter,Clear,365,320,45
2012-11-21,2012,November,10,Wednesday,Winter,Clear,172,150,22
2012-11-21,2012,November,11,Wednesday,Winter,Clear,241,198,43
2012-11-21,2012,November,12,Wednesday,Winter,Clear,344,270,74
2012-11-21,2012,November,13,Wednesday,Winter,Clear,365,295,70
2012-11-21,2012,November,14,Wednesday,Winter,Clear,413,329,84
2012-11-21,2012,November,15,Wednesday,Winter,Clear,449,381,68
2012-11-21,2012,November,16,Wednesday,Winter,Clear,469,410,59
2012-11-21,2012,November,17,Wednesday,Winter,Clear,374,333,41
2012-11-21,2012,November,18,Wednesday,Winter,Clear,311,287,24
2012-11-21,2012,November,19,Wednesday,Winter,Clear,243,220,23
2012-11-21,2012,November,20,Wednesday,Winter,Clear,136,125,11
2012-11-21,2012,November,21,Wednesday,Winter,Clear,105,97,8
2012-11-21,2012,November,22,Wednesday,Winter,Clear,88,82,6
2012-11-21,2012,November,23,Wednesday,Winter,Clear,57,50,7
2012-11-22,2012,November,0,Thursday,Winter,Clear,46,43,3
2012-11-22,2012,November,1,Thursday,Winter,Clear,42,37,5
2012-11-22,2012,November,2,Thursday,Winter,Clear,18,15,3
2012-11-22,2012,November,3,Thursday,Winter,Clear,6,6,0
2012-11-22,2012,November,4,Thursday,Winter,Clear,3,2,1
2012-11-22,2012,November,5,Thursday,Winter,Clear,8,6,2
2012-11-22,2012,November,6,Thursday,Winter,Clear,17,15,2
2012-11-22,2012,November,7,Thursday,Winter,Clear,56,49,7
2012-11-22,2012,November,8,Thursday,Winter,Clear,97,77,20
2012-11-22,2012,November,9,Thursday,Winter,Clear,119,94,25
2012-11-22,2012,November,10,Thursday,Winter,Clear,219,154,65
2012-11-22,2012,November,11,Thursday,Winter,Clear,232,143,89
2012-11-22,2012,November,12,Thursday,Winter,Clear,262,145,117
2012-11-22,2012,November,13,Thursday,Winter,Clear,269,144,125
2012-11-22,2012,November,14,Thursday,Winter,Clear,220,95,125
2012-11-22,2012,November,15,Thursday,Winter,Clear,228,96,132
2012-11-22,2012,November,16,Thursday,Winter,Clear,182,81,101
2012-11-22,2012,November,17,Thursday,Winter,Clear,109,43,66
2012-11-22,2012,November,18,Thursday,Winter,Clear,70,54,16
2012-11-22,2012,November,19,Thursday,Winter,Clear,44,31,13
2012-11-22,2012,November,20,Thursday,Winter,Clear,52,37,15
2012-11-22,2012,November,21,Thursday,Winter,Clear,46,39,7
2012-11-22,2012,November,22,Thursday,Winter,Clear,44,36,8
2012-11-22,2012,November,23,Thursday,Winter,Clear,36,28,8
2012-11-23,2012,November,0,Friday,Winter,Clear,32,32,0
2012-11-23,2012,November,1,Friday,Winter,Clear,13,11,2
2012-11-23,2012,November,2,Friday,Winter,Clear,5,4,1
2012-11-23,2012,November,3,Friday,Winter,Clear,1,0,1
2012-11-23,2012,November,4,Friday,Winter,Clear,4,3,1
2012-11-23,2012,November,5,Friday,Winter,Clear,10,10,0
2012-11-23,2012,November,6,Friday,Winter,Clear,20,20,0
2012-11-23,2012,November,7,Friday,Winter,Clear,77,72,5
2012-11-23,2012,November,8,Friday,Winter,Clear,94,83,11
2012-11-23,2012,November,9,Friday,Winter,Clear,112,80,32
2012-11-23,2012,November,10,Friday,Winter,Clear,201,114,87
2012-11-23,2012,November,11,Friday,Winter,Clear,251,130,121
2012-11-23,2012,November,12,Friday,Winter,Clear,379,193,186
2012-11-23,2012,November,13,Friday,Winter,Clear,424,200,224
2012-11-23,2012,November,14,Friday,Winter,Clear,435,195,240
2012-11-23,2012,November,15,Friday,Winter,Clear,447,214,233
2012-11-23,2012,November,16,Friday,Winter,Cloudy,357,199,158
2012-11-23,2012,November,17,Friday,Winter,Cloudy,300,183,117
2012-11-23,2012,November,18,Friday,Winter,Cloudy,208,158,50
2012-11-23,2012,November,19,Friday,Winter,Cloudy,154,121,33
2012-11-23,2012,November,20,Friday,Winter,Clear,142,100,42
2012-11-23,2012,November,21,Friday,Winter,Clear,98,75,23
2012-11-23,2012,November,22,Friday,Winter,Clear,79,63,16
2012-11-23,2012,November,23,Friday,Winter,Clear,67,47,20
2012-11-24,2012,November,0,Saturday,Winter,Clear,42,33,9
2012-11-24,2012,November,1,Saturday,Winter,Clear,20,19,1
2012-11-24,2012,November,2,Saturday,Winter,Clear,32,22,10
2012-11-24,2012,November,3,Saturday,Winter,Clear,11,5,6
2012-11-24,2012,November,4,Saturday,Winter,Clear,3,2,1
2012-11-24,2012,November,5,Saturday,Winter,Clear,3,2,1
2012-11-24,2012,November,6,Saturday,Winter,Clear,10,9,1
2012-11-24,2012,November,7,Saturday,Winter,Cloudy,25,21,4
2012-11-24,2012,November,8,Saturday,Winter,Cloudy,62,55,7
2012-11-24,2012,November,9,Saturday,Winter,Cloudy,122,96,26
2012-11-24,2012,November,10,Saturday,Winter,Cloudy,142,96,46
2012-11-24,2012,November,11,Saturday,Winter,Cloudy,186,131,55
2012-11-24,2012,November,12,Saturday,Winter,Cloudy,199,146,53
2012-11-24,2012,November,13,Saturday,Winter,Clear,225,161,64
2012-11-24,2012,November,14,Saturday,Winter,Clear,207,149,58
2012-11-24,2012,November,15,Saturday,Winter,Clear,198,139,59
2012-11-24,2012,November,16,Saturday,Winter,Clear,170,127,43
2012-11-24,2012,November,17,Saturday,Winter,Clear,126,97,29
2012-11-24,2012,November,18,Saturday,Winter,Clear,145,123,22
2012-11-24,2012,November,19,Saturday,Winter,Clear,83,74,9
2012-11-24,2012,November,20,Saturday,Winter,Clear,58,55,3
2012-11-24,2012,November,21,Saturday,Winter,Clear,75,66,9
2012-11-24,2012,November,22,Saturday,Winter,Clear,76,69,7
2012-11-24,2012,November,23,Saturday,Winter,Clear,57,48,9
2012-11-25,2012,November,0,Sunday,Winter,Clear,34,31,3
2012-11-25,2012,November,1,Sunday,Winter,Clear,36,32,4
2012-11-25,2012,November,2,Sunday,Winter,Clear,28,27,1
2012-11-25,2012,November,3,Sunday,Winter,Clear,8,8,0
2012-11-25,2012,November,4,Sunday,Winter,Clear,2,1,1
2012-11-25,2012,November,5,Sunday,Winter,Cloudy,3,3,0
2012-11-25,2012,November,6,Sunday,Winter,Cloudy,11,10,1
2012-11-25,2012,November,7,Sunday,Winter,Cloudy,21,19,2
2012-11-25,2012,November,8,Sunday,Winter,Cloudy,34,32,2
2012-11-25,2012,November,9,Sunday,Winter,Cloudy,96,83,13
2012-11-25,2012,November,10,Sunday,Winter,Clear,139,124,15
2012-11-25,2012,November,11,Sunday,Winter,Cloudy,204,155,49
2012-11-25,2012,November,12,Sunday,Winter,Cloudy,202,165,37
2012-11-25,2012,November,13,Sunday,Winter,Cloudy,195,158,37
2012-11-25,2012,November,14,Sunday,Winter,Cloudy,203,170,33
2012-11-25,2012,November,15,Sunday,Winter,Clear,245,209,36
2012-11-25,2012,November,16,Sunday,Winter,Clear,228,203,25
2012-11-25,2012,November,17,Sunday,Winter,Clear,181,170,11
2012-11-25,2012,November,18,Sunday,Winter,Clear,141,132,9
2012-11-25,2012,November,19,Sunday,Winter,Clear,127,114,13
2012-11-25,2012,November,20,Sunday,Winter,Clear,119,110,9
2012-11-25,2012,November,21,Sunday,Winter,Clear,64,60,4
2012-11-25,2012,November,22,Sunday,Winter,Clear,62,59,3
2012-11-25,2012,November,23,Sunday,Winter,Clear,41,40,1
2012-11-26,2012,November,0,Monday,Winter,Clear,23,19,4
2012-11-26,2012,November,1,Monday,Winter,Clear,10,9,1
2012-11-26,2012,November,2,Monday,Winter,Clear,5,5,0
2012-11-26,2012,November,3,Monday,Winter,Clear,5,4,1
2012-11-26,2012,November,4,Monday,Winter,Clear,10,10,0
2012-11-26,2012,November,5,Monday,Winter,Clear,41,41,0
2012-11-26,2012,November,6,Monday,Winter,Clear,124,123,1
2012-11-26,2012,November,7,Monday,Winter,Clear,365,363,2
2012-11-26,2012,November,8,Monday,Winter,Clear,638,629,9
2012-11-26,2012,November,9,Monday,Winter,Clear,286,276,10
2012-11-26,2012,November,10,Monday,Winter,Clear,147,127,20
2012-11-26,2012,November,11,Monday,Winter,Clear,130,112,18
2012-11-26,2012,November,12,Monday,Winter,Clear,210,188,22
2012-11-26,2012,November,13,Monday,Winter,Clear,217,197,20
2012-11-26,2012,November,14,Monday,Winter,Clear,228,177,51
2012-11-26,2012,November,15,Monday,Winter,Clear,230,181,49
2012-11-26,2012,November,16,Monday,Winter,Clear,346,297,49
2012-11-26,2012,November,17,Monday,Winter,Clear,553,540,13
2012-11-26,2012,November,18,Monday,Winter,Clear,521,502,19
2012-11-26,2012,November,19,Monday,Winter,Clear,371,355,16
2012-11-26,2012,November,20,Monday,Winter,Clear,277,265,12
2012-11-26,2012,November,21,Monday,Winter,Clear,181,172,9
2012-11-26,2012,November,22,Monday,Winter,Clear,104,101,3
2012-11-26,2012,November,23,Monday,Winter,Cloudy,65,57,8
2012-11-27,2012,November,0,Tuesday,Winter,Cloudy,26,24,2
2012-11-27,2012,November,1,Tuesday,Winter,Cloudy,6,6,0
2012-11-27,2012,November,2,Tuesday,Winter,Cloudy,5,5,0
2012-11-27,2012,November,3,Tuesday,Winter,Light Snow/Rain,4,3,1
2012-11-27,2012,November,4,Tuesday,Winter,Light Snow/Rain,5,5,0
2012-11-27,2012,November,5,Tuesday,Winter,Cloudy,31,31,0
2012-11-27,2012,November,6,Tuesday,Winter,Cloudy,100,97,3
2012-11-27,2012,November,7,Tuesday,Winter,Light Snow/Rain,293,289,4
2012-11-27,2012,November,8,Tuesday,Winter,Light Snow/Rain,500,494,6
2012-11-27,2012,November,9,Tuesday,Winter,Cloudy,268,257,11
2012-11-27,2012,November,10,Tuesday,Winter,Light Snow/Rain,57,52,5
2012-11-27,2012,November,11,Tuesday,Winter,Light Snow/Rain,65,59,6
2012-11-27,2012,November,12,Tuesday,Winter,Light Snow/Rain,76,70,6
2012-11-27,2012,November,13,Tuesday,Winter,Light Snow/Rain,77,73,4
2012-11-27,2012,November,14,Tuesday,Winter,Light Snow/Rain,94,86,8
2012-11-27,2012,November,15,Tuesday,Winter,Cloudy,155,146,9
2012-11-27,2012,November,16,Tuesday,Winter,Cloudy,257,252,5
2012-11-27,2012,November,17,Tuesday,Winter,Cloudy,527,514,13
2012-11-27,2012,November,18,Tuesday,Winter,Clear,482,469,13
2012-11-27,2012,November,19,Tuesday,Winter,Clear,350,338,12
2012-11-27,2012,November,20,Tuesday,Winter,Clear,232,228,4
2012-11-27,2012,November,21,Tuesday,Winter,Clear,185,179,6
2012-11-27,2012,November,22,Tuesday,Winter,Clear,97,95,2
2012-11-27,2012,November,23,Tuesday,Winter,Cloudy,67,64,3
2012-11-28,2012,November,0,Wednesday,Winter,Cloudy,23,22,1
2012-11-28,2012,November,1,Wednesday,Winter,Cloudy,12,12,0
2012-11-28,2012,November,2,Wednesday,Winter,Cloudy,1,1,0
2012-11-28,2012,November,3,Wednesday,Winter,Cloudy,3,3,0
2012-11-28,2012,November,4,Wednesday,Winter,Cloudy,4,4,0
2012-11-28,2012,November,5,Wednesday,Winter,Cloudy,39,39,0
2012-11-28,2012,November,6,Wednesday,Winter,Cloudy,136,132,4
2012-11-28,2012,November,7,Wednesday,Winter,Cloudy,409,403,6
2012-11-28,2012,November,8,Wednesday,Winter,Clear,692,683,9
2012-11-28,2012,November,9,Wednesday,Winter,Clear,322,309,13
2012-11-28,2012,November,10,Wednesday,Winter,Clear,161,144,17
2012-11-28,2012,November,11,Wednesday,Winter,Clear,146,127,19
2012-11-28,2012,November,12,Wednesday,Winter,Clear,208,189,19
2012-11-28,2012,November,13,Wednesday,Winter,Clear,214,193,21
2012-11-28,2012,November,14,Wednesday,Winter,Clear,176,161,15
2012-11-28,2012,November,15,Wednesday,Winter,Clear,179,172,7
2012-11-28,2012,November,16,Wednesday,Winter,Clear,325,316,9
2012-11-28,2012,November,17,Wednesday,Winter,Clear,563,546,17
2012-11-28,2012,November,18,Wednesday,Winter,Clear,542,530,12
2012-11-28,2012,November,19,Wednesday,Winter,Clear,387,378,9
2012-11-28,2012,November,20,Wednesday,Winter,Clear,263,258,5
2012-11-28,2012,November,21,Wednesday,Winter,Clear,223,219,4
2012-11-28,2012,November,22,Wednesday,Winter,Clear,154,148,6
2012-11-28,2012,November,23,Wednesday,Winter,Clear,78,73,5
2012-11-29,2012,November,0,Thursday,Winter,Clear,29,25,4
2012-11-29,2012,November,1,Thursday,Winter,Clear,16,15,1
2012-11-29,2012,November,2,Thursday,Winter,Clear,7,6,1
2012-11-29,2012,November,4,Thursday,Winter,Clear,7,7,0
2012-11-29,2012,November,5,Thursday,Winter,Clear,42,42,0
2012-11-29,2012,November,6,Thursday,Winter,Clear,121,120,1
2012-11-29,2012,November,7,Thursday,Winter,Clear,362,354,8
2012-11-29,2012,November,8,Thursday,Winter,Clear,679,664,15
2012-11-29,2012,November,9,Thursday,Winter,Clear,299,286,13
2012-11-29,2012,November,10,Thursday,Winter,Clear,178,153,25
2012-11-29,2012,November,11,Thursday,Winter,Clear,163,150,13
2012-11-29,2012,November,12,Thursday,Winter,Clear,236,225,11
2012-11-29,2012,November,13,Thursday,Winter,Clear,224,209,15
2012-11-29,2012,November,14,Thursday,Winter,Clear,187,174,13
2012-11-29,2012,November,15,Thursday,Winter,Clear,220,201,19
2012-11-29,2012,November,16,Thursday,Winter,Clear,370,346,24
2012-11-29,2012,November,17,Thursday,Winter,Clear,561,544,17
2012-11-29,2012,November,18,Thursday,Winter,Clear,537,520,17
2012-11-29,2012,November,19,Thursday,Winter,Clear,344,326,18
2012-11-29,2012,November,20,Thursday,Winter,Clear,252,241,11
2012-11-29,2012,November,21,Thursday,Winter,Clear,208,201,7
2012-11-29,2012,November,22,Thursday,Winter,Clear,151,147,4
2012-11-29,2012,November,23,Thursday,Winter,Clear,130,124,6
2012-11-30,2012,November,0,Friday,Winter,Clear,52,48,4
2012-11-30,2012,November,1,Friday,Winter,Clear,19,17,2
2012-11-30,2012,November,2,Friday,Winter,Clear,12,10,2
2012-11-30,2012,November,3,Friday,Winter,Clear,4,4,0
2012-11-30,2012,November,4,Friday,Winter,Clear,3,3,0
2012-11-30,2012,November,5,Friday,Winter,Clear,40,39,1
2012-11-30,2012,November,6,Friday,Winter,Clear,106,104,2
2012-11-30,2012,November,7,Friday,Winter,Clear,352,346,6
2012-11-30,2012,November,8,Friday,Winter,Cloudy,729,709,20
2012-11-30,2012,November,9,Friday,Winter,Clear,330,313,17
2012-11-30,2012,November,10,Friday,Winter,Cloudy,169,159,10
2012-11-30,2012,November,11,Friday,Winter,Cloudy,201,170,31
2012-11-30,2012,November,12,Friday,Winter,Cloudy,268,243,25
2012-11-30,2012,November,13,Friday,Winter,Cloudy,262,241,21
2012-11-30,2012,November,14,Friday,Winter,Cloudy,251,225,26
2012-11-30,2012,November,15,Friday,Winter,Cloudy,296,262,34
2012-11-30,2012,November,16,Friday,Winter,Clear,405,368,37
2012-11-30,2012,November,17,Friday,Winter,Clear,582,551,31
2012-11-30,2012,November,18,Friday,Winter,Cloudy,509,489,20
2012-11-30,2012,November,19,Friday,Winter,Clear,377,359,18
2012-11-30,2012,November,20,Friday,Winter,Clear,245,233,12
2012-11-30,2012,November,21,Friday,Winter,Clear,183,169,14
2012-11-30,2012,November,22,Friday,Winter,Clear,163,145,18
2012-11-30,2012,November,23,Friday,Winter,Cloudy,110,99,11
2012-12-01,2012,December,0,Saturday,Winter,Clear,108,99,9
2012-12-01,2012,December,1,Saturday,Winter,Clear,69,64,5
2012-12-01,2012,December,2,Saturday,Winter,Cloudy,50,47,3
2012-12-01,2012,December,3,Saturday,Winter,Cloudy,15,14,1
2012-12-01,2012,December,4,Saturday,Winter,Clear,5,5,0
2012-12-01,2012,December,5,Saturday,Winter,Clear,13,12,1
2012-12-01,2012,December,6,Saturday,Winter,Clear,27,20,7
2012-12-01,2012,December,7,Saturday,Winter,Cloudy,63,56,7
2012-12-01,2012,December,8,Saturday,Winter,Cloudy,144,133,11
2012-12-01,2012,December,9,Saturday,Winter,Cloudy,193,159,34
2012-12-01,2012,December,10,Saturday,Winter,Cloudy,256,211,45
2012-12-01,2012,December,11,Saturday,Winter,Cloudy,392,318,74
2012-12-01,2012,December,12,Saturday,Winter,Cloudy,446,327,119
2012-12-01,2012,December,13,Saturday,Winter,Cloudy,509,386,123
2012-12-01,2012,December,14,Saturday,Winter,Cloudy,479,369,110
2012-12-01,2012,December,15,Saturday,Winter,Cloudy,484,371,113
2012-12-01,2012,December,16,Saturday,Winter,Cloudy,443,354,89
2012-12-01,2012,December,17,Saturday,Winter,Cloudy,320,270,50
2012-12-01,2012,December,18,Saturday,Winter,Cloudy,297,255,42
2012-12-01,2012,December,19,Saturday,Winter,Cloudy,249,219,30
2012-12-01,2012,December,20,Saturday,Winter,Clear,198,170,28
2012-12-01,2012,December,21,Saturday,Winter,Cloudy,158,135,23
2012-12-01,2012,December,22,Saturday,Winter,Cloudy,147,130,17
2012-12-01,2012,December,23,Saturday,Winter,Cloudy,126,116,10
2012-12-02,2012,December,0,Sunday,Winter,Cloudy,117,108,9
2012-12-02,2012,December,1,Sunday,Winter,Cloudy,94,84,10
2012-12-02,2012,December,2,Sunday,Winter,Cloudy,74,72,2
2012-12-02,2012,December,3,Sunday,Winter,Cloudy,25,21,4
2012-12-02,2012,December,4,Sunday,Winter,Cloudy,7,6,1
2012-12-02,2012,December,5,Sunday,Winter,Cloudy,8,7,1
2012-12-02,2012,December,6,Sunday,Winter,Cloudy,16,15,1
2012-12-02,2012,December,7,Sunday,Winter,Cloudy,31,26,5
2012-12-02,2012,December,8,Sunday,Winter,Cloudy,93,81,12
2012-12-02,2012,December,9,Sunday,Winter,Cloudy,172,135,37
2012-12-02,2012,December,10,Sunday,Winter,Cloudy,293,230,63
2012-12-02,2012,December,11,Sunday,Winter,Cloudy,355,274,81
2012-12-02,2012,December,12,Sunday,Winter,Cloudy,520,409,111
2012-12-02,2012,December,13,Sunday,Winter,Clear,431,347,84
2012-12-02,2012,December,14,Sunday,Winter,Clear,473,331,142
2012-12-02,2012,December,15,Sunday,Winter,Clear,417,311,106
2012-12-02,2012,December,16,Sunday,Winter,Cloudy,443,358,85
2012-12-02,2012,December,17,Sunday,Winter,Light Snow/Rain,303,244,59
2012-12-02,2012,December,18,Sunday,Winter,Cloudy,203,178,25
2012-12-02,2012,December,19,Sunday,Winter,Cloudy,174,158,16
2012-12-02,2012,December,20,Sunday,Winter,Cloudy,154,142,12
2012-12-02,2012,December,21,Sunday,Winter,Cloudy,99,91,8
2012-12-02,2012,December,22,Sunday,Winter,Cloudy,96,85,11
2012-12-02,2012,December,23,Sunday,Winter,Cloudy,51,44,7
2012-12-03,2012,December,0,Monday,Winter,Cloudy,21,18,3
2012-12-03,2012,December,1,Monday,Winter,Clear,13,11,2
2012-12-03,2012,December,2,Monday,Winter,Clear,10,9,1
2012-12-03,2012,December,3,Monday,Winter,Clear,8,6,2
2012-12-03,2012,December,4,Monday,Winter,Clear,5,4,1
2012-12-03,2012,December,5,Monday,Winter,Clear,38,38,0
2012-12-03,2012,December,6,Monday,Winter,Clear,138,136,2
2012-12-03,2012,December,7,Monday,Winter,Cloudy,396,387,9
2012-12-03,2012,December,8,Monday,Winter,Clear,731,712,19
2012-12-03,2012,December,9,Monday,Winter,Clear,308,289,19
2012-12-03,2012,December,10,Monday,Winter,Clear,136,105,31
2012-12-03,2012,December,11,Monday,Winter,Clear,233,182,51
2012-12-03,2012,December,12,Monday,Winter,Clear,268,228,40
2012-12-03,2012,December,13,Monday,Winter,Clear,321,240,81
2012-12-03,2012,December,14,Monday,Winter,Clear,260,209,51
2012-12-03,2012,December,15,Monday,Winter,Clear,268,210,58
2012-12-03,2012,December,16,Monday,Winter,Clear,442,397,45
2012-12-03,2012,December,17,Monday,Winter,Clear,708,665,43
2012-12-03,2012,December,18,Monday,Winter,Clear,692,666,26
2012-12-03,2012,December,19,Monday,Winter,Clear,471,444,27
2012-12-03,2012,December,20,Monday,Winter,Cloudy,300,284,16
2012-12-03,2012,December,21,Monday,Winter,Clear,221,207,14
2012-12-03,2012,December,22,Monday,Winter,Clear,144,139,5
2012-12-03,2012,December,23,Monday,Winter,Clear,102,93,9
2012-12-04,2012,December,0,Tuesday,Winter,Clear,55,49,6
2012-12-04,2012,December,1,Tuesday,Winter,Clear,25,22,3
2012-12-04,2012,December,2,Tuesday,Winter,Clear,8,5,3
2012-12-04,2012,December,3,Tuesday,Winter,Cloudy,4,3,1
2012-12-04,2012,December,4,Tuesday,Winter,Cloudy,7,7,0
2012-12-04,2012,December,5,Tuesday,Winter,Cloudy,46,45,1
2012-12-04,2012,December,6,Tuesday,Winter,Cloudy,153,150,3
2012-12-04,2012,December,7,Tuesday,Winter,Clear,502,495,7
2012-12-04,2012,December,8,Tuesday,Winter,Cloudy,721,700,21
2012-12-04,2012,December,9,Tuesday,Winter,Clear,336,317,19
2012-12-04,2012,December,10,Tuesday,Winter,Clear,156,130,26
2012-12-04,2012,December,11,Tuesday,Winter,Clear,207,183,24
2012-12-04,2012,December,12,Tuesday,Winter,Clear,312,273,39
2012-12-04,2012,December,13,Tuesday,Winter,Cloudy,272,233,39
2012-12-04,2012,December,14,Tuesday,Winter,Cloudy,270,231,39
2012-12-04,2012,December,15,Tuesday,Winter,Cloudy,300,244,56
2012-12-04,2012,December,16,Tuesday,Winter,Clear,435,391,44
2012-12-04,2012,December,17,Tuesday,Winter,Clear,743,700,43
2012-12-04,2012,December,18,Tuesday,Winter,Clear,731,693,38
2012-12-04,2012,December,19,Tuesday,Winter,Clear,460,414,46
2012-12-04,2012,December,20,Tuesday,Winter,Cloudy,306,272,34
2012-12-04,2012,December,21,Tuesday,Winter,Cloudy,280,252,28
2012-12-04,2012,December,22,Tuesday,Winter,Cloudy,181,155,26
2012-12-04,2012,December,23,Tuesday,Winter,Clear,96,91,5
2012-12-05,2012,December,0,Wednesday,Winter,Clear,37,31,6
2012-12-05,2012,December,1,Wednesday,Winter,Clear,11,11,0
2012-12-05,2012,December,2,Wednesday,Winter,Clear,9,7,2
2012-12-05,2012,December,3,Wednesday,Winter,Clear,7,7,0
2012-12-05,2012,December,4,Wednesday,Winter,Clear,10,9,1
2012-12-05,2012,December,5,Wednesday,Winter,Clear,49,48,1
2012-12-05,2012,December,6,Wednesday,Winter,Light Snow/Rain,124,119,5
2012-12-05,2012,December,7,Wednesday,Winter,Light Snow/Rain,398,389,9
2012-12-05,2012,December,8,Wednesday,Winter,Cloudy,759,737,22
2012-12-05,2012,December,9,Wednesday,Winter,Cloudy,388,362,26
2012-12-05,2012,December,10,Wednesday,Winter,Cloudy,141,127,14
2012-12-05,2012,December,11,Wednesday,Winter,Clear,172,161,11
2012-12-05,2012,December,12,Wednesday,Winter,Clear,232,208,24
2012-12-05,2012,December,13,Wednesday,Winter,Clear,214,200,14
2012-12-05,2012,December,14,Wednesday,Winter,Clear,218,179,39
2012-12-05,2012,December,15,Wednesday,Winter,Clear,285,265,20
2012-12-05,2012,December,16,Wednesday,Winter,Clear,377,354,23
2012-12-05,2012,December,17,Wednesday,Winter,Clear,605,576,29
2012-12-05,2012,December,18,Wednesday,Winter,Clear,609,580,29
2012-12-05,2012,December,19,Wednesday,Winter,Clear,414,400,14
2012-12-05,2012,December,20,Wednesday,Winter,Clear,293,274,19
2012-12-05,2012,December,21,Wednesday,Winter,Clear,198,184,14
2012-12-05,2012,December,22,Wednesday,Winter,Clear,105,101,4
2012-12-05,2012,December,23,Wednesday,Winter,Clear,74,69,5
2012-12-06,2012,December,0,Thursday,Winter,Clear,44,43,1
2012-12-06,2012,December,1,Thursday,Winter,Clear,16,16,0
2012-12-06,2012,December,2,Thursday,Winter,Clear,9,9,0
2012-12-06,2012,December,3,Thursday,Winter,Clear,2,2,0
2012-12-06,2012,December,4,Thursday,Winter,Clear,9,8,1
2012-12-06,2012,December,5,Thursday,Winter,Clear,32,32,0
2012-12-06,2012,December,6,Thursday,Winter,Clear,124,122,2
2012-12-06,2012,December,7,Thursday,Winter,Clear,389,381,8
2012-12-06,2012,December,8,Thursday,Winter,Clear,659,646,13
2012-12-06,2012,December,9,Thursday,Winter,Clear,276,257,19
2012-12-06,2012,December,10,Thursday,Winter,Clear,145,122,23
2012-12-06,2012,December,11,Thursday,Winter,Clear,178,162,16
2012-12-06,2012,December,12,Thursday,Winter,Clear,235,206,29
2012-12-06,2012,December,13,Thursday,Winter,Clear,245,212,33
2012-12-06,2012,December,14,Thursday,Winter,Clear,212,175,37
2012-12-06,2012,December,15,Thursday,Winter,Clear,270,232,38
2012-12-06,2012,December,16,Thursday,Winter,Clear,331,292,39
2012-12-06,2012,December,17,Thursday,Winter,Clear,617,586,31
2012-12-06,2012,December,18,Thursday,Winter,Clear,565,542,23
2012-12-06,2012,December,19,Thursday,Winter,Clear,373,360,13
2012-12-06,2012,December,20,Thursday,Winter,Cloudy,227,222,5
2012-12-06,2012,December,21,Thursday,Winter,Cloudy,191,184,7
2012-12-06,2012,December,22,Thursday,Winter,Clear,133,131,2
2012-12-06,2012,December,23,Thursday,Winter,Clear,93,93,0
2012-12-07,2012,December,0,Friday,Winter,Clear,48,45,3
2012-12-07,2012,December,1,Friday,Winter,Cloudy,28,26,2
2012-12-07,2012,December,2,Friday,Winter,Cloudy,11,11,0
2012-12-07,2012,December,3,Friday,Winter,Cloudy,5,5,0
2012-12-07,2012,December,4,Friday,Winter,Clear,10,10,0
2012-12-07,2012,December,5,Friday,Winter,Cloudy,26,25,1
2012-12-07,2012,December,6,Friday,Winter,Cloudy,84,84,0
2012-12-07,2012,December,7,Friday,Winter,Light Snow/Rain,215,212,3
2012-12-07,2012,December,8,Friday,Winter,Cloudy,441,430,11
2012-12-07,2012,December,9,Friday,Winter,Cloudy,301,291,10
2012-12-07,2012,December,10,Friday,Winter,Cloudy,166,150,16
2012-12-07,2012,December,11,Friday,Winter,Cloudy,203,183,20
2012-12-07,2012,December,12,Friday,Winter,Cloudy,240,204,36
2012-12-07,2012,December,13,Friday,Winter,Cloudy,220,197,23
2012-12-07,2012,December,14,Friday,Winter,Cloudy,215,175,40
2012-12-07,2012,December,15,Friday,Winter,Cloudy,303,269,34
2012-12-07,2012,December,16,Friday,Winter,Clear,375,336,39
2012-12-07,2012,December,17,Friday,Winter,Cloudy,568,539,29
2012-12-07,2012,December,18,Friday,Winter,Cloudy,498,473,25
2012-12-07,2012,December,19,Friday,Winter,Cloudy,352,337,15
2012-12-07,2012,December,20,Friday,Winter,Light Snow/Rain,241,229,12
2012-12-07,2012,December,21,Friday,Winter,Cloudy,171,162,9
2012-12-07,2012,December,22,Friday,Winter,Cloudy,165,150,15
2012-12-07,2012,December,23,Friday,Winter,Cloudy,122,116,6
2012-12-08,2012,December,0,Saturday,Winter,Cloudy,103,98,5
2012-12-08,2012,December,1,Saturday,Winter,Cloudy,100,84,16
2012-12-08,2012,December,2,Saturday,Winter,Cloudy,70,67,3
2012-12-08,2012,December,3,Saturday,Winter,Cloudy,29,23,6
2012-12-08,2012,December,4,Saturday,Winter,Cloudy,12,9,3
2012-12-08,2012,December,5,Saturday,Winter,Cloudy,6,4,2
2012-12-08,2012,December,6,Saturday,Winter,Cloudy,20,19,1
2012-12-08,2012,December,7,Saturday,Winter,Cloudy,39,36,3
2012-12-08,2012,December,8,Saturday,Winter,Cloudy,111,106,5
2012-12-08,2012,December,9,Saturday,Winter,Cloudy,170,153,17
2012-12-08,2012,December,10,Saturday,Winter,Cloudy,287,244,43
2012-12-08,2012,December,11,Saturday,Winter,Cloudy,404,341,63
2012-12-08,2012,December,12,Saturday,Winter,Cloudy,486,364,122
2012-12-08,2012,December,13,Saturday,Winter,Cloudy,547,399,148
2012-12-08,2012,December,14,Saturday,Winter,Cloudy,542,378,164
2012-12-08,2012,December,15,Saturday,Winter,Clear,541,374,167
2012-12-08,2012,December,16,Saturday,Winter,Clear,507,368,139
2012-12-08,2012,December,17,Saturday,Winter,Clear,345,268,77
2012-12-08,2012,December,18,Saturday,Winter,Clear,304,264,40
2012-12-08,2012,December,19,Saturday,Winter,Clear,246,212,34
2012-12-08,2012,December,20,Saturday,Winter,Cloudy,182,162,20
2012-12-08,2012,December,21,Saturday,Winter,Cloudy,209,175,34
2012-12-08,2012,December,22,Saturday,Winter,Cloudy,160,137,23
2012-12-08,2012,December,23,Saturday,Winter,Cloudy,162,144,18
2012-12-09,2012,December,0,Sunday,Winter,Cloudy,118,103,15
2012-12-09,2012,December,1,Sunday,Winter,Cloudy,102,85,17
2012-12-09,2012,December,2,Sunday,Winter,Cloudy,78,70,8
2012-12-09,2012,December,3,Sunday,Winter,Cloudy,48,34,14
2012-12-09,2012,December,4,Sunday,Winter,Cloudy,12,11,1
2012-12-09,2012,December,5,Sunday,Winter,Cloudy,8,8,0
2012-12-09,2012,December,6,Sunday,Winter,Light Snow/Rain,6,6,0
2012-12-09,2012,December,7,Sunday,Winter,Light Snow/Rain,23,22,1
2012-12-09,2012,December,8,Sunday,Winter,Light Snow/Rain,69,68,1
2012-12-09,2012,December,9,Sunday,Winter,Cloudy,103,94,9
2012-12-09,2012,December,10,Sunday,Winter,Cloudy,219,180,39
2012-12-09,2012,December,11,Sunday,Winter,Cloudy,250,210,40
2012-12-09,2012,December,12,Sunday,Winter,Cloudy,315,255,60
2012-12-09,2012,December,13,Sunday,Winter,Cloudy,285,220,65
2012-12-09,2012,December,14,Sunday,Winter,Cloudy,232,190,42
2012-12-09,2012,December,15,Sunday,Winter,Light Snow/Rain,225,200,25
2012-12-09,2012,December,16,Sunday,Winter,Light Snow/Rain,253,220,33
2012-12-09,2012,December,17,Sunday,Winter,Light Snow/Rain,229,209,20
2012-12-09,2012,December,18,Sunday,Winter,Light Snow/Rain,198,181,17
2012-12-09,2012,December,19,Sunday,Winter,Light Snow/Rain,122,110,12
2012-12-09,2012,December,20,Sunday,Winter,Light Snow/Rain,108,102,6
2012-12-09,2012,December,21,Sunday,Winter,Cloudy,96,86,10
2012-12-09,2012,December,22,Sunday,Winter,Light Snow/Rain,78,75,3
2012-12-09,2012,December,23,Sunday,Winter,Light Snow/Rain,51,48,3
2012-12-10,2012,December,0,Monday,Winter,Light Snow/Rain,20,20,0
2012-12-10,2012,December,1,Monday,Winter,Cloudy,4,4,0
2012-12-10,2012,December,2,Monday,Winter,Cloudy,5,3,2
2012-12-10,2012,December,3,Monday,Winter,Cloudy,4,4,0
2012-12-10,2012,December,4,Monday,Winter,Cloudy,12,9,3
2012-12-10,2012,December,5,Monday,Winter,Cloudy,27,27,0
2012-12-10,2012,December,6,Monday,Winter,Cloudy,123,121,2
2012-12-10,2012,December,7,Monday,Winter,Cloudy,294,291,3
2012-12-10,2012,December,8,Monday,Winter,Cloudy,584,575,9
2012-12-10,2012,December,9,Monday,Winter,Cloudy,284,273,11
2012-12-10,2012,December,10,Monday,Winter,Cloudy,133,121,12
2012-12-10,2012,December,11,Monday,Winter,Light Snow/Rain,134,126,8
2012-12-10,2012,December,12,Monday,Winter,Light Snow/Rain,173,150,23
2012-12-10,2012,December,13,Monday,Winter,Light Snow/Rain,220,190,30
2012-12-10,2012,December,14,Monday,Winter,Cloudy,210,179,31
2012-12-10,2012,December,15,Monday,Winter,Cloudy,236,207,29
2012-12-10,2012,December,16,Monday,Winter,Cloudy,345,308,37
2012-12-10,2012,December,17,Monday,Winter,Cloudy,616,578,38
2012-12-10,2012,December,18,Monday,Winter,Cloudy,564,544,20
2012-12-10,2012,December,19,Monday,Winter,Clear,427,409,18
2012-12-10,2012,December,20,Monday,Winter,Clear,300,287,13
2012-12-10,2012,December,21,Monday,Winter,Cloudy,245,224,21
2012-12-10,2012,December,22,Monday,Winter,Cloudy,126,115,11
2012-12-10,2012,December,23,Monday,Winter,Clear,84,76,8
2012-12-11,2012,December,0,Tuesday,Winter,Light Snow/Rain,31,29,2
2012-12-11,2012,December,1,Tuesday,Winter,Clear,8,7,1
2012-12-11,2012,December,2,Tuesday,Winter,Cloudy,1,1,0
2012-12-11,2012,December,3,Tuesday,Winter,Light Snow/Rain,3,3,0
2012-12-11,2012,December,4,Tuesday,Winter,Cloudy,8,8,0
2012-12-11,2012,December,5,Tuesday,Winter,Light Snow/Rain,41,40,1
2012-12-11,2012,December,6,Tuesday,Winter,Cloudy,118,118,0
2012-12-11,2012,December,7,Tuesday,Winter,Clear,380,372,8
2012-12-11,2012,December,8,Tuesday,Winter,Cloudy,724,708,16
2012-12-11,2012,December,9,Tuesday,Winter,Clear,334,322,12
2012-12-11,2012,December,10,Tuesday,Winter,Clear,154,142,12
2012-12-11,2012,December,11,Tuesday,Winter,Cloudy,173,145,28
2012-12-11,2012,December,12,Tuesday,Winter,Cloudy,226,213,13
2012-12-11,2012,December,13,Tuesday,Winter,Cloudy,254,226,28
2012-12-11,2012,December,14,Tuesday,Winter,Cloudy,204,185,19
2012-12-11,2012,December,15,Tuesday,Winter,Cloudy,270,250,20
2012-12-11,2012,December,16,Tuesday,Winter,Cloudy,358,334,24
2012-12-11,2012,December,17,Tuesday,Winter,Clear,601,580,21
2012-12-11,2012,December,18,Tuesday,Winter,Clear,546,523,23
2012-12-11,2012,December,19,Tuesday,Winter,Clear,433,412,21
2012-12-11,2012,December,20,Tuesday,Winter,Clear,257,248,9
2012-12-11,2012,December,21,Tuesday,Winter,Clear,207,193,14
2012-12-11,2012,December,22,Tuesday,Winter,Clear,106,100,6
2012-12-11,2012,December,23,Tuesday,Winter,Clear,64,60,4
2012-12-12,2012,December,0,Wednesday,Winter,Clear,34,33,1
2012-12-12,2012,December,1,Wednesday,Winter,Clear,21,18,3
2012-12-12,2012,December,2,Wednesday,Winter,Clear,9,4,5
2012-12-12,2012,December,3,Wednesday,Winter,Clear,10,7,3
2012-12-12,2012,December,4,Wednesday,Winter,Clear,4,4,0
2012-12-12,2012,December,5,Wednesday,Winter,Clear,37,37,0
2012-12-12,2012,December,6,Wednesday,Winter,Cloudy,128,126,2
2012-12-12,2012,December,7,Wednesday,Winter,Cloudy,369,366,3
2012-12-12,2012,December,8,Wednesday,Winter,Cloudy,688,670,18
2012-12-12,2012,December,9,Wednesday,Winter,Cloudy,285,272,13
2012-12-12,2012,December,10,Wednesday,Winter,Cloudy,136,116,20
2012-12-12,2012,December,11,Wednesday,Winter,Cloudy,172,148,24
2012-12-12,2012,December,12,Wednesday,Winter,Cloudy,232,218,14
2012-12-12,2012,December,13,Wednesday,Winter,Cloudy,238,220,18
2012-12-12,2012,December,14,Wednesday,Winter,Cloudy,225,191,34
2012-12-12,2012,December,15,Wednesday,Winter,Cloudy,228,207,21
2012-12-12,2012,December,16,Wednesday,Winter,Cloudy,329,310,19
2012-12-12,2012,December,17,Wednesday,Winter,Cloudy,561,540,21
2012-12-12,2012,December,18,Wednesday,Winter,Cloudy,540,515,25
2012-12-12,2012,December,19,Wednesday,Winter,Cloudy,402,384,18
2012-12-12,2012,December,20,Wednesday,Winter,Clear,268,243,25
2012-12-12,2012,December,21,Wednesday,Winter,Cloudy,202,186,16
2012-12-12,2012,December,22,Wednesday,Winter,Cloudy,122,118,4
2012-12-12,2012,December,23,Wednesday,Winter,Cloudy,79,76,3
2012-12-13,2012,December,0,Thursday,Winter,Cloudy,32,31,1
2012-12-13,2012,December,1,Thursday,Winter,Cloudy,23,19,4
2012-12-13,2012,December,2,Thursday,Winter,Cloudy,8,5,3
2012-12-13,2012,December,3,Thursday,Winter,Cloudy,2,2,0
2012-12-13,2012,December,4,Thursday,Winter,Cloudy,8,8,0
2012-12-13,2012,December,5,Thursday,Winter,Cloudy,33,31,2
2012-12-13,2012,December,6,Thursday,Winter,Clear,114,112,2
2012-12-13,2012,December,7,Thursday,Winter,Clear,385,380,5
2012-12-13,2012,December,8,Thursday,Winter,Clear,679,655,24
2012-12-13,2012,December,9,Thursday,Winter,Clear,325,300,25
2012-12-13,2012,December,10,Thursday,Winter,Clear,167,139,28
2012-12-13,2012,December,11,Thursday,Winter,Clear,189,164,25
2012-12-13,2012,December,12,Thursday,Winter,Clear,282,252,30
2012-12-13,2012,December,13,Thursday,Winter,Clear,271,230,41
2012-12-13,2012,December,14,Thursday,Winter,Clear,242,211,31
2012-12-13,2012,December,15,Thursday,Winter,Clear,280,240,40
2012-12-13,2012,December,16,Thursday,Winter,Clear,406,356,50
2012-12-13,2012,December,17,Thursday,Winter,Clear,550,507,43
2012-12-13,2012,December,18,Thursday,Winter,Clear,466,446,20
2012-12-13,2012,December,19,Thursday,Winter,Clear,348,328,20
2012-12-13,2012,December,20,Thursday,Winter,Clear,241,235,6
2012-12-13,2012,December,21,Thursday,Winter,Clear,213,200,13
2012-12-13,2012,December,22,Thursday,Winter,Clear,148,141,7
2012-12-13,2012,December,23,Thursday,Winter,Clear,120,115,5
2012-12-14,2012,December,0,Friday,Winter,Clear,47,43,4
2012-12-14,2012,December,1,Friday,Winter,Clear,26,26,0
2012-12-14,2012,December,2,Friday,Winter,Clear,9,6,3
2012-12-14,2012,December,3,Friday,Winter,Clear,12,12,0
2012-12-14,2012,December,4,Friday,Winter,Clear,10,9,1
2012-12-14,2012,December,5,Friday,Winter,Clear,34,34,0
2012-12-14,2012,December,6,Friday,Winter,Clear,113,112,1
2012-12-14,2012,December,7,Friday,Winter,Clear,308,305,3
2012-12-14,2012,December,8,Friday,Winter,Clear,636,623,13
2012-12-14,2012,December,9,Friday,Winter,Clear,343,330,13
2012-12-14,2012,December,10,Friday,Winter,Clear,190,162,28
2012-12-14,2012,December,11,Friday,Winter,Clear,211,180,31
2012-12-14,2012,December,12,Friday,Winter,Clear,273,244,29
2012-12-14,2012,December,13,Friday,Winter,Clear,313,274,39
2012-12-14,2012,December,14,Friday,Winter,Clear,299,251,48
2012-12-14,2012,December,15,Friday,Winter,Clear,309,252,57
2012-12-14,2012,December,16,Friday,Winter,Clear,417,372,45
2012-12-14,2012,December,17,Friday,Winter,Clear,622,582,40
2012-12-14,2012,December,18,Friday,Winter,Clear,455,432,23
2012-12-14,2012,December,19,Friday,Winter,Clear,319,302,17
2012-12-14,2012,December,20,Friday,Winter,Clear,221,209,12
2012-12-14,2012,December,21,Friday,Winter,Clear,172,165,7
2012-12-14,2012,December,22,Friday,Winter,Clear,138,134,4
2012-12-14,2012,December,23,Friday,Winter,Clear,134,123,11
2012-12-15,2012,December,0,Saturday,Winter,Clear,94,90,4
2012-12-15,2012,December,1,Saturday,Winter,Cloudy,95,86,9
2012-12-15,2012,December,2,Saturday,Winter,Clear,69,63,6
2012-12-15,2012,December,3,Saturday,Winter,Cloudy,23,18,5
2012-12-15,2012,December,4,Saturday,Winter,Cloudy,6,5,1
2012-12-15,2012,December,5,Saturday,Winter,Cloudy,3,3,0
2012-12-15,2012,December,6,Saturday,Winter,Cloudy,11,11,0
2012-12-15,2012,December,7,Saturday,Winter,Cloudy,48,47,1
2012-12-15,2012,December,8,Saturday,Winter,Cloudy,119,111,8
2012-12-15,2012,December,9,Saturday,Winter,Clear,220,203,17
2012-12-15,2012,December,10,Saturday,Winter,Clear,273,250,23
2012-12-15,2012,December,11,Saturday,Winter,Clear,393,327,66
2012-12-15,2012,December,12,Saturday,Winter,Clear,453,364,89
2012-12-15,2012,December,13,Saturday,Winter,Clear,456,368,88
2012-12-15,2012,December,14,Saturday,Winter,Clear,426,334,92
2012-12-15,2012,December,15,Saturday,Winter,Clear,447,352,95
2012-12-15,2012,December,16,Saturday,Winter,Clear,413,328,85
2012-12-15,2012,December,17,Saturday,Winter,Clear,309,274,35
2012-12-15,2012,December,18,Saturday,Winter,Clear,272,232,40
2012-12-15,2012,December,19,Saturday,Winter,Clear,257,225,32
2012-12-15,2012,December,20,Saturday,Winter,Cloudy,201,178,23
2012-12-15,2012,December,21,Saturday,Winter,Clear,184,169,15
2012-12-15,2012,December,22,Saturday,Winter,Clear,156,134,22
2012-12-15,2012,December,23,Saturday,Winter,Cloudy,119,108,11
2012-12-16,2012,December,0,Sunday,Winter,Cloudy,110,102,8
2012-12-16,2012,December,1,Sunday,Winter,Light Snow/Rain,96,82,14
2012-12-16,2012,December,2,Sunday,Winter,Cloudy,87,79,8
2012-12-16,2012,December,3,Sunday,Winter,Cloudy,38,37,1
2012-12-16,2012,December,4,Sunday,Winter,Cloudy,11,10,1
2012-12-16,2012,December,5,Sunday,Winter,Cloudy,9,9,0
2012-12-16,2012,December,6,Sunday,Winter,Cloudy,6,6,0
2012-12-16,2012,December,7,Sunday,Winter,Cloudy,27,22,5
2012-12-16,2012,December,8,Sunday,Winter,Cloudy,88,76,12
2012-12-16,2012,December,9,Sunday,Winter,Cloudy,132,113,19
2012-12-16,2012,December,10,Sunday,Winter,Cloudy,257,215,42
2012-12-16,2012,December,11,Sunday,Winter,Cloudy,295,248,47
2012-12-16,2012,December,12,Sunday,Winter,Cloudy,417,350,67
2012-12-16,2012,December,13,Sunday,Winter,Cloudy,356,289,67
2012-12-16,2012,December,14,Sunday,Winter,Cloudy,310,260,50
2012-12-16,2012,December,15,Sunday,Winter,Cloudy,338,292,46
2012-12-16,2012,December,16,Sunday,Winter,Cloudy,400,334,66
2012-12-16,2012,December,17,Sunday,Winter,Cloudy,243,214,29
2012-12-16,2012,December,18,Sunday,Winter,Light Snow/Rain,107,99,8
2012-12-16,2012,December,19,Sunday,Winter,Clear,109,99,10
2012-12-16,2012,December,20,Sunday,Winter,Cloudy,122,108,14
2012-12-16,2012,December,21,Sunday,Winter,Cloudy,106,92,14
2012-12-16,2012,December,22,Sunday,Winter,Cloudy,89,83,6
2012-12-16,2012,December,23,Sunday,Winter,Cloudy,33,29,4
2012-12-17,2012,December,0,Monday,Winter,Cloudy,28,26,2
2012-12-17,2012,December,1,Monday,Winter,Cloudy,15,14,1
2012-12-17,2012,December,2,Monday,Winter,Cloudy,5,4,1
2012-12-17,2012,December,3,Monday,Winter,Cloudy,3,3,0
2012-12-17,2012,December,4,Monday,Winter,Light Snow/Rain,5,3,2
2012-12-17,2012,December,5,Monday,Winter,Cloudy,24,24,0
2012-12-17,2012,December,6,Monday,Winter,Cloudy,108,107,1
2012-12-17,2012,December,7,Monday,Winter,Cloudy,319,314,5
2012-12-17,2012,December,8,Monday,Winter,Cloudy,592,582,10
2012-12-17,2012,December,9,Monday,Winter,Cloudy,282,271,11
2012-12-17,2012,December,10,Monday,Winter,Cloudy,135,120,15
2012-12-17,2012,December,11,Monday,Winter,Cloudy,170,148,22
2012-12-17,2012,December,12,Monday,Winter,Cloudy,232,211,21
2012-12-17,2012,December,13,Monday,Winter,Cloudy,210,194,16
2012-12-17,2012,December,14,Monday,Winter,Cloudy,181,169,12
2012-12-17,2012,December,15,Monday,Winter,Cloudy,211,196,15
2012-12-17,2012,December,16,Monday,Winter,Light Snow/Rain,302,287,15
2012-12-17,2012,December,17,Monday,Winter,Cloudy,495,478,17
2012-12-17,2012,December,18,Monday,Winter,Cloudy,507,493,14
2012-12-17,2012,December,19,Monday,Winter,Cloudy,340,333,7
2012-12-17,2012,December,20,Monday,Winter,Cloudy,200,192,8
2012-12-17,2012,December,21,Monday,Winter,Cloudy,120,114,6
2012-12-17,2012,December,22,Monday,Winter,Cloudy,54,49,5
2012-12-17,2012,December,23,Monday,Winter,Light Snow/Rain,47,41,6
2012-12-18,2012,December,0,Tuesday,Winter,Cloudy,18,18,0
2012-12-18,2012,December,1,Tuesday,Winter,Cloudy,15,15,0
2012-12-18,2012,December,2,Tuesday,Winter,Cloudy,7,5,2
2012-12-18,2012,December,3,Tuesday,Winter,Clear,5,5,0
2012-12-18,2012,December,4,Tuesday,Winter,Clear,8,5,3
2012-12-18,2012,December,5,Tuesday,Winter,Clear,36,36,0
2012-12-18,2012,December,6,Tuesday,Winter,Clear,118,117,1
2012-12-18,2012,December,7,Tuesday,Winter,Clear,355,351,4
2012-12-18,2012,December,8,Tuesday,Winter,Clear,662,652,10
2012-12-18,2012,December,9,Tuesday,Winter,Clear,326,307,19
2012-12-18,2012,December,10,Tuesday,Winter,Clear,184,162,22
2012-12-18,2012,December,11,Tuesday,Winter,Clear,269,211,58
2012-12-18,2012,December,12,Tuesday,Winter,Light Snow/Rain,313,264,49
2012-12-18,2012,December,13,Tuesday,Winter,Clear,286,235,51
2012-12-18,2012,December,14,Tuesday,Winter,Clear,247,191,56
2012-12-18,2012,December,15,Tuesday,Winter,Clear,246,218,28
2012-12-18,2012,December,16,Tuesday,Winter,Clear,363,323,40
2012-12-18,2012,December,17,Tuesday,Winter,Clear,572,533,39
2012-12-18,2012,December,18,Tuesday,Winter,Clear,525,512,13
2012-12-18,2012,December,19,Tuesday,Winter,Clear,353,334,19
2012-12-18,2012,December,20,Tuesday,Winter,Clear,268,264,4
2012-12-18,2012,December,21,Tuesday,Winter,Clear,168,159,9
2012-12-18,2012,December,22,Tuesday,Winter,Clear,132,127,5
2012-12-18,2012,December,23,Tuesday,Winter,Clear,81,80,1
2012-12-19,2012,December,0,Wednesday,Winter,Clear,41,35,6
2012-12-19,2012,December,1,Wednesday,Winter,Clear,15,14,1
2012-12-19,2012,December,2,Wednesday,Winter,Clear,3,2,1
2012-12-19,2012,December,3,Wednesday,Winter,Clear,5,5,0
2012-12-19,2012,December,4,Wednesday,Winter,Clear,7,6,1
2012-12-19,2012,December,5,Wednesday,Winter,Clear,31,29,2
2012-12-19,2012,December,6,Wednesday,Winter,Clear,112,109,3
2012-12-19,2012,December,7,Wednesday,Winter,Clear,363,360,3
2012-12-19,2012,December,8,Wednesday,Winter,Clear,678,665,13
2012-12-19,2012,December,9,Wednesday,Winter,Clear,317,309,8
2012-12-19,2012,December,10,Wednesday,Winter,Clear,164,147,17
2012-12-19,2012,December,11,Wednesday,Winter,Clear,200,169,31
2012-12-19,2012,December,12,Wednesday,Winter,Clear,236,203,33
2012-12-19,2012,December,13,Wednesday,Winter,Clear,213,183,30
2012-12-19,2012,December,14,Wednesday,Winter,Clear,218,185,33
2012-12-19,2012,December,15,Wednesday,Winter,Clear,237,209,28
2012-12-19,2012,December,16,Wednesday,Winter,Clear,334,297,37
2012-12-19,2012,December,17,Wednesday,Winter,Clear,562,536,26
2012-12-19,2012,December,18,Wednesday,Winter,Clear,569,546,23
2012-12-19,2012,December,19,Wednesday,Winter,Clear,336,329,7
2012-12-19,2012,December,20,Wednesday,Winter,Clear,241,231,10
2012-12-19,2012,December,21,Wednesday,Winter,Clear,168,164,4
2012-12-19,2012,December,22,Wednesday,Winter,Clear,129,117,12
2012-12-19,2012,December,23,Wednesday,Winter,Clear,88,84,4
2012-12-20,2012,December,0,Thursday,Winter,Clear,42,40,2
2012-12-20,2012,December,1,Thursday,Winter,Clear,20,19,1
2012-12-20,2012,December,2,Thursday,Winter,Clear,8,6,2
2012-12-20,2012,December,3,Thursday,Winter,Cloudy,4,3,1
2012-12-20,2012,December,4,Thursday,Winter,Cloudy,6,6,0
2012-12-20,2012,December,5,Thursday,Winter,Cloudy,35,35,0
2012-12-20,2012,December,6,Thursday,Winter,Cloudy,118,114,4
2012-12-20,2012,December,7,Thursday,Winter,Cloudy,350,346,4
2012-12-20,2012,December,8,Thursday,Winter,Cloudy,599,585,14
2012-12-20,2012,December,9,Thursday,Winter,Cloudy,317,303,14
2012-12-20,2012,December,10,Thursday,Winter,Cloudy,161,138,23
2012-12-20,2012,December,11,Thursday,Winter,Cloudy,190,168,22
2012-12-20,2012,December,12,Thursday,Winter,Cloudy,212,181,31
2012-12-20,2012,December,13,Thursday,Winter,Cloudy,217,171,46
2012-12-20,2012,December,14,Thursday,Winter,Cloudy,214,171,43
2012-12-20,2012,December,15,Thursday,Winter,Cloudy,249,216,33
2012-12-20,2012,December,16,Thursday,Winter,Cloudy,302,281,21
2012-12-20,2012,December,17,Thursday,Winter,Cloudy,475,450,25
2012-12-20,2012,December,18,Thursday,Winter,Cloudy,381,359,22
2012-12-20,2012,December,19,Thursday,Winter,Light Snow/Rain,118,115,3
2012-12-20,2012,December,20,Thursday,Winter,Light Snow/Rain,50,49,1
2012-12-20,2012,December,21,Thursday,Winter,Light Snow/Rain,26,25,1
2012-12-20,2012,December,22,Thursday,Winter,Light Snow/Rain,21,20,1
2012-12-20,2012,December,23,Thursday,Winter,Light Snow/Rain,13,13,0
2012-12-21,2012,December,0,Friday,Spring,Light Snow/Rain,17,17,0
2012-12-21,2012,December,1,Friday,Spring,Light Snow/Rain,9,7,2
2012-12-21,2012,December,2,Friday,Spring,Light Snow/Rain,3,3,0
2012-12-21,2012,December,3,Friday,Spring,Light Snow/Rain,3,3,0
2012-12-21,2012,December,4,Friday,Spring,Cloudy,6,5,1
2012-12-21,2012,December,5,Friday,Spring,Cloudy,13,13,0
2012-12-21,2012,December,6,Friday,Spring,Cloudy,80,76,4
2012-12-21,2012,December,7,Friday,Spring,Cloudy,208,205,3
2012-12-21,2012,December,8,Friday,Spring,Cloudy,472,464,8
2012-12-21,2012,December,9,Friday,Spring,Cloudy,267,265,2
2012-12-21,2012,December,10,Friday,Spring,Clear,154,146,8
2012-12-21,2012,December,11,Friday,Spring,Cloudy,162,150,12
2012-12-21,2012,December,12,Friday,Spring,Cloudy,224,199,25
2012-12-21,2012,December,13,Friday,Spring,Cloudy,240,214,26
2012-12-21,2012,December,14,Friday,Spring,Cloudy,219,199,20
2012-12-21,2012,December,15,Friday,Spring,Cloudy,263,234,29
2012-12-21,2012,December,16,Friday,Spring,Cloudy,281,253,28
2012-12-21,2012,December,17,Friday,Spring,Cloudy,321,297,24
2012-12-21,2012,December,18,Friday,Spring,Cloudy,243,236,7
2012-12-21,2012,December,19,Friday,Spring,Clear,153,148,5
2012-12-21,2012,December,20,Friday,Spring,Clear,112,104,8
2012-12-21,2012,December,21,Friday,Spring,Clear,70,68,2
2012-12-21,2012,December,22,Friday,Spring,Clear,63,57,6
2012-12-21,2012,December,23,Friday,Spring,Clear,40,39,1
2012-12-22,2012,December,0,Saturday,Spring,Clear,31,30,1
2012-12-22,2012,December,1,Saturday,Spring,Clear,35,34,1
2012-12-22,2012,December,2,Saturday,Spring,Clear,23,23,0
2012-12-22,2012,December,3,Saturday,Spring,Clear,7,7,0
2012-12-22,2012,December,4,Saturday,Spring,Clear,5,2,3
2012-12-22,2012,December,5,Saturday,Spring,Clear,5,5,0
2012-12-22,2012,December,6,Saturday,Spring,Clear,13,13,0
2012-12-22,2012,December,7,Saturday,Spring,Clear,20,18,2
2012-12-22,2012,December,8,Saturday,Spring,Clear,29,29,0
2012-12-22,2012,December,9,Saturday,Spring,Clear,90,77,13
2012-12-22,2012,December,10,Saturday,Spring,Clear,118,105,13
2012-12-22,2012,December,11,Saturday,Spring,Clear,159,130,29
2012-12-22,2012,December,12,Saturday,Spring,Clear,146,128,18
2012-12-22,2012,December,13,Saturday,Spring,Clear,158,135,23
2012-12-22,2012,December,14,Saturday,Spring,Clear,161,141,20
2012-12-22,2012,December,15,Saturday,Spring,Clear,153,139,14
2012-12-22,2012,December,16,Saturday,Spring,Clear,147,124,23
2012-12-22,2012,December,17,Saturday,Spring,Clear,114,99,15
2012-12-22,2012,December,18,Saturday,Spring,Clear,82,75,7
2012-12-22,2012,December,19,Saturday,Spring,Clear,60,51,9
2012-12-22,2012,December,20,Saturday,Spring,Clear,61,55,6
2012-12-22,2012,December,21,Saturday,Spring,Clear,53,49,4
2012-12-22,2012,December,22,Saturday,Spring,Clear,39,38,1
2012-12-22,2012,December,23,Saturday,Spring,Clear,40,37,3
2012-12-23,2012,December,0,Sunday,Spring,Clear,27,24,3
2012-12-23,2012,December,1,Sunday,Spring,Clear,20,19,1
2012-12-23,2012,December,2,Sunday,Spring,Clear,18,17,1
2012-12-23,2012,December,3,Sunday,Spring,Clear,9,9,0
2012-12-23,2012,December,4,Sunday,Spring,Clear,4,3,1
2012-12-23,2012,December,5,Sunday,Spring,Clear,6,6,0
2012-12-23,2012,December,6,Sunday,Spring,Clear,9,5,4
2012-12-23,2012,December,7,Sunday,Spring,Clear,19,16,3
2012-12-23,2012,December,8,Sunday,Spring,Clear,48,43,5
2012-12-23,2012,December,9,Sunday,Spring,Clear,56,49,7
2012-12-23,2012,December,10,Sunday,Spring,Clear,93,67,26
2012-12-23,2012,December,11,Sunday,Spring,Clear,152,104,48
2012-12-23,2012,December,12,Sunday,Spring,Clear,196,144,52
2012-12-23,2012,December,13,Sunday,Spring,Clear,186,123,63
2012-12-23,2012,December,14,Sunday,Spring,Clear,175,118,57
2012-12-23,2012,December,15,Sunday,Spring,Clear,137,98,39
2012-12-23,2012,December,16,Sunday,Spring,Clear,190,137,53
2012-12-23,2012,December,17,Sunday,Spring,Clear,114,93,21
2012-12-23,2012,December,18,Sunday,Spring,Clear,93,85,8
2012-12-23,2012,December,19,Sunday,Spring,Clear,58,54,4
2012-12-23,2012,December,20,Sunday,Spring,Clear,52,52,0
2012-12-23,2012,December,21,Sunday,Spring,Clear,42,38,4
2012-12-23,2012,December,22,Sunday,Spring,Clear,58,53,5
2012-12-23,2012,December,23,Sunday,Spring,Clear,25,22,3
2012-12-24,2012,December,0,Monday,Spring,Clear,12,12,0
2012-12-24,2012,December,1,Monday,Spring,Clear,11,11,0
2012-12-24,2012,December,2,Monday,Spring,Clear,5,5,0
2012-12-24,2012,December,3,Monday,Spring,Clear,3,2,1
2012-12-24,2012,December,5,Monday,Spring,Clear,9,9,0
2012-12-24,2012,December,6,Monday,Spring,Clear,17,16,1
2012-12-24,2012,December,7,Monday,Spring,Clear,30,27,3
2012-12-24,2012,December,8,Monday,Spring,Clear,66,62,4
2012-12-24,2012,December,9,Monday,Spring,Cloudy,85,68,17
2012-12-24,2012,December,10,Monday,Spring,Cloudy,103,82,21
2012-12-24,2012,December,11,Monday,Spring,Cloudy,124,104,20
2012-12-24,2012,December,12,Monday,Spring,Cloudy,135,113,22
2012-12-24,2012,December,13,Monday,Spring,Light Snow/Rain,70,54,16
2012-12-24,2012,December,14,Monday,Spring,Light Snow/Rain,46,33,13
2012-12-24,2012,December,15,Monday,Spring,Light Snow/Rain,33,27,6
2012-12-24,2012,December,16,Monday,Spring,Light Snow/Rain,33,27,6
2012-12-24,2012,December,17,Monday,Spring,Light Snow/Rain,26,19,7
2012-12-24,2012,December,18,Monday,Spring,Light Snow/Rain,26,20,6
2012-12-24,2012,December,19,Monday,Spring,Cloudy,18,14,4
2012-12-24,2012,December,20,Monday,Spring,Light Snow/Rain,23,17,6
2012-12-24,2012,December,21,Monday,Spring,Light Snow/Rain,22,9,13
2012-12-24,2012,December,22,Monday,Spring,Cloudy,12,5,7
2012-12-24,2012,December,23,Monday,Spring,Light Snow/Rain,11,10,1
2012-12-25,2012,December,0,Tuesday,Spring,Light Snow/Rain,13,10,3
2012-12-25,2012,December,1,Tuesday,Spring,Cloudy,13,13,0
2012-12-25,2012,December,2,Tuesday,Spring,Cloudy,7,7,0
2012-12-25,2012,December,4,Tuesday,Spring,Cloudy,1,1,0
2012-12-25,2012,December,5,Tuesday,Spring,Cloudy,3,1,2
2012-12-25,2012,December,6,Tuesday,Spring,Cloudy,7,6,1
2012-12-25,2012,December,7,Tuesday,Spring,Cloudy,6,6,0
2012-12-25,2012,December,8,Tuesday,Spring,Cloudy,11,10,1
2012-12-25,2012,December,9,Tuesday,Spring,Cloudy,28,21,7
2012-12-25,2012,December,10,Tuesday,Spring,Clear,32,21,11
2012-12-25,2012,December,11,Tuesday,Spring,Clear,86,43,43
2012-12-25,2012,December,12,Tuesday,Spring,Clear,114,52,62
2012-12-25,2012,December,13,Tuesday,Spring,Clear,121,46,75
2012-12-25,2012,December,14,Tuesday,Spring,Clear,126,68,58
2012-12-25,2012,December,15,Tuesday,Spring,Clear,107,56,51
2012-12-25,2012,December,16,Tuesday,Spring,Cloudy,86,38,48
2012-12-25,2012,December,17,Tuesday,Spring,Cloudy,50,34,16
2012-12-25,2012,December,18,Tuesday,Spring,Cloudy,43,23,20
2012-12-25,2012,December,19,Tuesday,Spring,Cloudy,36,20,16
2012-12-25,2012,December,20,Tuesday,Spring,Cloudy,40,29,11
2012-12-25,2012,December,21,Tuesday,Spring,Cloudy,34,26,8
2012-12-25,2012,December,22,Tuesday,Spring,Cloudy,19,16,3
2012-12-25,2012,December,23,Tuesday,Spring,Cloudy,30,26,4
2012-12-26,2012,December,0,Wednesday,Spring,Cloudy,9,8,1
2012-12-26,2012,December,1,Wednesday,Spring,Cloudy,7,7,0
2012-12-26,2012,December,2,Wednesday,Spring,Cloudy,1,1,0
2012-12-26,2012,December,3,Wednesday,Spring,Cloudy,2,2,0
2012-12-26,2012,December,4,Wednesday,Spring,Clear,2,2,0
2012-12-26,2012,December,5,Wednesday,Spring,Cloudy,11,11,0
2012-12-26,2012,December,6,Wednesday,Spring,Cloudy,36,36,0
2012-12-26,2012,December,7,Wednesday,Spring,Light Snow/Rain,26,26,0
2012-12-26,2012,December,8,Wednesday,Spring,Light Snow/Rain,31,31,0
2012-12-26,2012,December,9,Wednesday,Spring,Light Snow/Rain,23,22,1
2012-12-26,2012,December,10,Wednesday,Spring,Light Snow/Rain,8,8,0
2012-12-26,2012,December,11,Wednesday,Spring,Light Snow/Rain,10,10,0
2012-12-26,2012,December,12,Wednesday,Spring,Light Snow/Rain,10,10,0
2012-12-26,2012,December,13,Wednesday,Spring,Light Snow/Rain,15,15,0
2012-12-26,2012,December,14,Wednesday,Spring,Light Snow/Rain,20,20,0
2012-12-26,2012,December,15,Wednesday,Spring,Light Snow/Rain,13,13,0
2012-12-26,2012,December,16,Wednesday,Spring,Light Snow/Rain,13,13,0
2012-12-26,2012,December,17,Wednesday,Spring,Light Snow/Rain,53,51,2
2012-12-26,2012,December,18,Wednesday,Spring,Light Snow/Rain,43,42,1
2012-12-26,2012,December,19,Wednesday,Spring,Light Snow/Rain,35,33,2
2012-12-26,2012,December,20,Wednesday,Spring,Light Snow/Rain,32,32,0
2012-12-26,2012,December,21,Wednesday,Spring,Cloudy,20,20,0
2012-12-26,2012,December,22,Wednesday,Spring,Light Snow/Rain,11,11,0
2012-12-26,2012,December,23,Wednesday,Spring,Light Snow/Rain,10,8,2
2012-12-27,2012,December,0,Thursday,Spring,Light Snow/Rain,3,3,0
2012-12-27,2012,December,1,Thursday,Spring,Light Snow/Rain,5,5,0
2012-12-27,2012,December,2,Thursday,Spring,Cloudy,2,2,0
2012-12-27,2012,December,3,Thursday,Spring,Cloudy,1,1,0
2012-12-27,2012,December,4,Thursday,Spring,Cloudy,3,3,0
2012-12-27,2012,December,5,Thursday,Spring,Clear,11,10,1
2012-12-27,2012,December,6,Thursday,Spring,Clear,45,45,0
2012-12-27,2012,December,7,Thursday,Spring,Clear,90,90,0
2012-12-27,2012,December,8,Thursday,Spring,Clear,208,206,2
2012-12-27,2012,December,9,Thursday,Spring,Clear,133,127,6
2012-12-27,2012,December,10,Thursday,Spring,Clear,75,67,8
2012-12-27,2012,December,11,Thursday,Spring,Cloudy,103,80,23
2012-12-27,2012,December,12,Thursday,Spring,Clear,109,87,22
2012-12-27,2012,December,13,Thursday,Spring,Clear,118,99,19
2012-12-27,2012,December,14,Thursday,Spring,Cloudy,119,94,25
2012-12-27,2012,December,15,Thursday,Spring,Cloudy,120,89,31
2012-12-27,2012,December,16,Thursday,Spring,Cloudy,174,151,23
2012-12-27,2012,December,17,Thursday,Spring,Cloudy,257,227,30
2012-12-27,2012,December,18,Thursday,Spring,Cloudy,197,188,9
2012-12-27,2012,December,19,Thursday,Spring,Clear,117,106,11
2012-12-27,2012,December,20,Thursday,Spring,Clear,91,79,12
2012-12-27,2012,December,21,Thursday,Spring,Cloudy,63,51,12
2012-12-27,2012,December,22,Thursday,Spring,Cloudy,44,33,11
2012-12-27,2012,December,23,Thursday,Spring,Cloudy,26,24,2
2012-12-28,2012,December,0,Friday,Spring,Cloudy,25,22,3
2012-12-28,2012,December,1,Friday,Spring,Clear,9,9,0
2012-12-28,2012,December,2,Friday,Spring,Clear,5,5,0
2012-12-28,2012,December,3,Friday,Spring,Cloudy,2,2,0
2012-12-28,2012,December,4,Friday,Spring,Cloudy,4,4,0
2012-12-28,2012,December,5,Friday,Spring,Cloudy,15,15,0
2012-12-28,2012,December,6,Friday,Spring,Clear,51,49,2
2012-12-28,2012,December,7,Friday,Spring,Clear,112,111,1
2012-12-28,2012,December,8,Friday,Spring,Cloudy,239,238,1
2012-12-28,2012,December,9,Friday,Spring,Cloudy,191,173,18
2012-12-28,2012,December,10,Friday,Spring,Cloudy,162,85,77
2012-12-28,2012,December,11,Friday,Spring,Cloudy,178,107,71
2012-12-28,2012,December,12,Friday,Spring,Cloudy,222,150,72
2012-12-28,2012,December,13,Friday,Spring,Cloudy,222,146,76
2012-12-28,2012,December,14,Friday,Spring,Cloudy,261,177,84
2012-12-28,2012,December,15,Friday,Spring,Cloudy,225,151,74
2012-12-28,2012,December,16,Friday,Spring,Clear,250,208,42
2012-12-28,2012,December,17,Friday,Spring,Clear,271,228,43
2012-12-28,2012,December,18,Friday,Spring,Clear,213,197,16
2012-12-28,2012,December,19,Friday,Spring,Cloudy,128,113,15
2012-12-28,2012,December,20,Friday,Spring,Cloudy,97,83,14
2012-12-28,2012,December,21,Friday,Spring,Cloudy,92,75,17
2012-12-28,2012,December,22,Friday,Spring,Cloudy,62,49,13
2012-12-28,2012,December,23,Friday,Spring,Cloudy,59,54,5
2012-12-29,2012,December,0,Saturday,Spring,Cloudy,26,25,1
2012-12-29,2012,December,1,Saturday,Spring,Cloudy,37,31,6
2012-12-29,2012,December,2,Saturday,Spring,Cloudy,19,18,1
2012-12-29,2012,December,3,Saturday,Spring,Cloudy,6,5,1
2012-12-29,2012,December,4,Saturday,Spring,Cloudy,3,3,0
2012-12-29,2012,December,5,Saturday,Spring,Cloudy,3,3,0
2012-12-29,2012,December,6,Saturday,Spring,Cloudy,7,7,0
2012-12-29,2012,December,7,Saturday,Spring,Cloudy,18,17,1
2012-12-29,2012,December,8,Saturday,Spring,Cloudy,44,35,9
2012-12-29,2012,December,9,Saturday,Spring,Cloudy,49,33,16
2012-12-29,2012,December,10,Saturday,Spring,Light Snow/Rain,41,35,6
2012-12-29,2012,December,11,Saturday,Spring,Light Snow/Rain,45,38,7
2012-12-29,2012,December,12,Saturday,Spring,Light Snow/Rain,48,43,5
2012-12-29,2012,December,13,Saturday,Spring,Light Snow/Rain,84,71,13
2012-12-29,2012,December,14,Saturday,Spring,Cloudy,98,88,10
2012-12-29,2012,December,15,Saturday,Spring,Cloudy,129,110,19
2012-12-29,2012,December,16,Saturday,Spring,Clear,147,125,22
2012-12-29,2012,December,17,Saturday,Spring,Clear,118,100,18
2012-12-29,2012,December,18,Saturday,Spring,Clear,110,102,8
2012-12-29,2012,December,19,Saturday,Spring,Cloudy,97,90,7
2012-12-29,2012,December,20,Saturday,Spring,Cloudy,66,64,2
2012-12-29,2012,December,21,Saturday,Spring,Cloudy,60,56,4
2012-12-29,2012,December,22,Saturday,Spring,Cloudy,54,51,3
2012-12-29,2012,December,23,Saturday,Spring,Cloudy,32,32,0
2012-12-30,2012,December,0,Sunday,Spring,Cloudy,41,41,0
2012-12-30,2012,December,1,Sunday,Spring,Cloudy,28,27,1
2012-12-30,2012,December,2,Sunday,Spring,Cloudy,19,19,0
2012-12-30,2012,December,3,Sunday,Spring,Cloudy,15,14,1
2012-12-30,2012,December,4,Sunday,Spring,Cloudy,7,7,0
2012-12-30,2012,December,5,Sunday,Spring,Cloudy,2,2,0
2012-12-30,2012,December,6,Sunday,Spring,Cloudy,8,7,1
2012-12-30,2012,December,7,Sunday,Spring,Clear,13,13,0
2012-12-30,2012,December,8,Sunday,Spring,Clear,33,32,1
2012-12-30,2012,December,9,Sunday,Spring,Clear,74,65,9
2012-12-30,2012,December,10,Sunday,Spring,Clear,122,91,31
2012-12-30,2012,December,11,Sunday,Spring,Clear,136,103,33
2012-12-30,2012,December,12,Sunday,Spring,Clear,144,97,47
2012-12-30,2012,December,13,Sunday,Spring,Clear,169,120,49
2012-12-30,2012,December,14,Sunday,Spring,Clear,160,121,39
2012-12-30,2012,December,15,Sunday,Spring,Clear,138,101,37
2012-12-30,2012,December,16,Sunday,Spring,Clear,133,102,31
2012-12-30,2012,December,17,Sunday,Spring,Clear,123,97,26
2012-12-30,2012,December,18,Sunday,Spring,Cloudy,125,113,12
2012-12-30,2012,December,19,Sunday,Spring,Clear,102,86,16
2012-12-30,2012,December,20,Sunday,Spring,Clear,72,63,9
2012-12-30,2012,December,21,Sunday,Spring,Clear,47,42,5
2012-12-30,2012,December,22,Sunday,Spring,Clear,36,30,6
2012-12-30,2012,December,23,Sunday,Spring,Clear,49,39,10
2012-12-31,2012,December,0,Monday,Spring,Clear,34,30,4
2012-12-31,2012,December,1,Monday,Spring,Clear,19,13,6
2012-12-31,2012,December,2,Monday,Spring,Clear,11,8,3
2012-12-31,2012,December,3,Monday,Spring,Clear,1,1,0
2012-12-31,2012,December,4,Monday,Spring,Clear,3,3,0
2012-12-31,2012,December,5,Monday,Spring,Clear,9,9,0
2012-12-31,2012,December,6,Monday,Spring,Clear,40,40,0
2012-12-31,2012,December,7,Monday,Spring,Clear,85,83,2
2012-12-31,2012,December,8,Monday,Spring,Clear,196,187,9
2012-12-31,2012,December,9,Monday,Spring,Cloudy,157,144,13
2012-12-31,2012,December,10,Monday,Spring,Cloudy,120,87,33
2012-12-31,2012,December,11,Monday,Spring,Cloudy,157,114,43
2012-12-31,2012,December,12,Monday,Spring,Cloudy,224,172,52
2012-12-31,2012,December,13,Monday,Spring,Cloudy,203,165,38
2012-12-31,2012,December,14,Monday,Spring,Cloudy,247,185,62
2012-12-31,2012,December,15,Monday,Spring,Cloudy,315,246,69
2012-12-31,2012,December,16,Monday,Spring,Cloudy,214,184,30
2012-12-31,2012,December,17,Monday,Spring,Cloudy,164,150,14
2012-12-31,2012,December,18,Monday,Spring,Cloudy,122,112,10
2012-12-31,2012,December,19,Monday,Spring,Cloudy,119,108,11
2012-12-31,2012,December,20,Monday,Spring,Cloudy,89,81,8
2012-12-31,2012,December,21,Monday,Spring,Clear,90,83,7
2012-12-31,2012,December,22,Monday,Spring,Clear,61,48,13
2012-12-31,2012,December,23,Monday,Spring,Clear,49,37,12
